iso3,area,year,1,2,3,4,5,N,3+,fi_0,fi_1,fi_2
AFG,Badakhshan,2017,304816,334314,294983,49164,0,983277,344147,0.350000050850371,0.133333401133828,0.0555556120559675
AFG,Badakhshan,2018,97660,292981,410173,179929,0,980743,590102,0.601688719674777,0.261716881996609,0.128008277624436
AFG,Badakhshan,2019,207132,207132,466046,258915,0,1139225,724961,0.636363317167373,0.287878747979255,0.146464677497617
AFG,Badakhshan,2020,210817,368930,310697,316226,0,1206670,626923,0.519548012298309,0.260537678072713,0.145082564228644
AFG,Badakhshan,2021,158113,474963,490423,420363,0,1543862,910786,0.589940033500404,0.287406732812475,0.156308947590163
AFG,Badakhshan,2022,140121,490423,490423,350302,0,1471269,840725,0.571428474330663,0.269841205109331,0.142857099702517
AFG,Badghis,2017,77090,128483,179876,128483,0,513932,308359,0.599999610843458,0.283333203614486,0.149999956760384
AFG,Badghis,2018,51441,77162,154324,231486,0,514413,385810,0.750000485990828,0.400000259195109,0.23333348453048
AFG,Badghis,2019,81001,108002,270005,81001,0,540009,351006,0.650000277773148,0.266666543211934,0.122222037040123
AFG,Badghis,2020,109917,216004,189003,137396,0,652320,326399,0.500366384596517,0.236997690295152,0.125805160384815
AFG,Badghis,2021,137396,219833,292226,219170,0,868625,511396,0.588741977262916,0.280353432148511,0.14952188164564
AFG,Badghis,2022,146113,219170,255698,146113,0,767094,401811,0.523809337577924,0.238095113940838,0.121693038923522
AFG,Baghlan,2017,342712,489589,97918,48959,0,979178,146877,0.150000306379433,0.0666668028353034,0.0333334014176517
AFG,Baghlan,2018,232814,232814,271616,64683,0,801927,336299,0.419363607909448,0.166674356477169,0.0734824436084027
AFG,Baghlan,2019,398326,497907,149372,49791,0,1095396,199163,0.181818264810169,0.0757576864135588,0.0353536275668546
AFG,Baghlan,2020,321412,394845,197422,80353,0,994032,277775,0.279442714117855,0.120092713313052,0.0579943323979733
AFG,Baghlan,2021,469429,361588,269283,161570,0,1261870,430853,0.341440084953284,0.156493405290033,0.0806178308559695
AFG,Baghlan,2022,323139,484709,269283,161570,0,1238701,430853,0.347826473055241,0.159420500454374,0.0821257286643203
AFG,Baghlan Urban,2020,52776,94997,82450,30919,0,261142,113369,0.434127792541989,0.184175659219888,0.0877028164327795
AFG,Baghlan Urban,2021,118381,84442,67908,54326,0,325057,122234,0.376038663988162,0.181055425151076,0.0974912775981512
AFG,Baghlan Urban,2022,81489,108652,67908,40745,0,298794,108653,0.363638493410176,0.166667782262473,0.0858592281713228
AFG,Balkh,2017,556836,584677,208813,41763,0,1392089,250576,0.179999985633103,0.0700000742289705,0.0300000774216144
AFG,Balkh,2018,267805,267805,312439,44634,0,892683,357073,0.399999775956303,0.149999869307843,0.0611110302064426
AFG,Balkh,2019,442695,368912,590260,147565,0,1549432,737825,0.476190629856618,0.190476251942647,0.0846561119745099
AFG,Balkh,2020,363351,363351,323504,138645,0,1188851,462149,0.388735846628383,0.168452284320463,0.0820665406252667
AFG,Balkh,2021,231074,393979,542405,339003,0,1506461,881408,0.585085176449971,0.270039295186976,0.140020367086982
AFG,Balkh,2022,203402,474604,474604,271202,0,1423812,745806,0.523809323140977,0.238095104316207,0.121693032507101
AFG,Balkh Urban,2020,198545,204710,175466,87733,0,666454,263199,0.39492448090941,0.175521991515293,0.0877609957576467
AFG,Balkh Urban,2021,146222,204710,260065,162541,0,773538,422606,0.546328687149177,0.252151801204336,0.130745426282297
AFG,Balkh Urban,2022,65016,260065,227557,97524,0,650162,325081,0.5,0.216666512858846,0.105555401747735
AFG,Bamyan,2017,64814,208329,124998,64814,0,462955,189812,0.410000972016719,0.183333873342622,0.0922225462277951
AFG,Bamyan,2018,69656,139311,208967,53112,0,471046,262079,0.55637665960437,0.223043326271037,0.0994040685811765
AFG,Bamyan,2019,146078,146078,146078,48693,0,486927,194771,0.400000410739187,0.166667008949322,0.0777780287850586
AFG,Bamyan,2020,194771,194771,173445,74334,0,637321,247779,0.388782105093038,0.168472402447118,0.0820763790931101
AFG,Bamyan,2021,148667,198223,230563,164688,0,742141,395251,0.532582083458534,0.251497132395776,0.133145558293879
AFG,Bamyan,2022,164688,263500,197625,131750,0,757563,329375,0.434782321734298,0.202898416809339,0.106280123090606
AFG,CLS 4: Tala wa barfak,2017,7647,8602,14337,1274,0,31860,15611,0.489987445072191,0.176658296714794,0.0677721978098626
AFG,"CLS 5: Burka, Jalga, Nahreen",2017,49213,76896,23069,4614,0,153792,27683,0.180002861007075,0.0700014738521293,0.0300008380727794
AFG,"CLS1: Firing wa gharu, Gozargah-I-Noor, Khost wa firing",2017,27358,36151,11725,3908,0,79142,15633,0.197531020191554,0.082303538786822,0.0384077565220321
AFG,"CLS2: Andara, Deh Salah, Khinjan, Pul-I-hisar",2017,14623,45086,48742,13404,0,121855,62146,0.509999589676255,0.206666393117503,0.0933331509672242
AFG,"CLS3:Baghlan-I-Jadid, Dahna-I-ghuri, Dushi, Puli Khumri",2017,189413,248943,81177,21647,0,541180,102824,0.189999630437193,0.0766664202914619,0.0344442801943079
AFG,"Cluster 1: Ali Abad, Kunduz",2017,163927,152490,34310,30498,0,381225,64808,0.169999344219293,0.0833331147397644,0.0455554826910326
AFG,"Cluster 1: Farkhar, Warsaj",2017,19688,53694,8949,7159,0,89490,16108,0.179997765113421,0.0866651767422803,0.0466656733837425
AFG,"Cluster 1:Arkhanj khwah, Eshkashim, Shignan",2017,3049,30495,9148,18297,0,60989,27445,0.449999180180033,0.250001366366613,0.150001548548828
AFG,"Cluster 2: Char Darah, Khan Abad",2017,84642,98007,37866,2227,0,222742,40093,0.179997485880525,0.0633318667636399,0.0233324254568564
AFG,"Cluster 2: Daewaz-I-Bala, Darwaz-I-Payin, Kufab, Shiki",2017,10363,20726,36271,36271,0,103631,72542,0.700002894886665,0.350001447443333,0.194445248579629
AFG,"Cluster 2: Darqd,DashtQala,Khwjabahwdin,Khwajaghr,yangi",2017,30715,61430,81906,30715,0,204766,112621,0.549998534913023,0.23333300775845,0.111111111111111
AFG,"Cluster 3: Chahab, Rustaq",2017,20560,102800,115650,17990,0,257000,133640,0.52,0.196666666666667,0.0811111111111111
AFG,"Cluster 3: Dasht-I-Archi, Imam Sahib, Qala-I-Zal",2017,169202,116561,63921,26320,0,376004,90241,0.240000106381847,0.103333120569639,0.0499997635958956
AFG,"Cluster 3: Wakhan, Zebak",2017,3608,6013,6013,8418,0,24052,14431,0.599991684683186,0.316661123122124,0.183329637636972
AFG,"Cluster 4: Hazar Sumuch, Kalafgan",2017,7754,15508,23261,5169,0,51692,28430,0.549988392788052,0.216661507905801,0.0944418650640116
AFG,"Cluster 4: Kiran wa menjan,Yamgan",2017,1859,6322,13760,15247,0,37188,29007,0.78000968054211,0.396669176436843,0.22333369187193
AFG,"Cluster 5: Baharak, Bangi, Eshkamesh, Taluqan",2017,111596,204592,37199,18599,0,371986,55798,0.150000268827321,0.0666664874484524,0.0333330943757143
AFG,"Cluster 5: Kohistan. Raghistan, Yawan",2017,9347,14020,28040,42061,0,93468,70101,0.75,0.400001426513174,0.233334759846507
AFG,"Cluster 6: Argo, Darayim, Khash, Yaftal-I-sufla:",2017,68170,65735,73039,36519,0,243463,109558,0.449998562409894,0.199998904693253,0.0999992241577205
AFG,"Cluster 6: Chal , Namak Ab",2017,6823,11514,17057,7249,0,42643,24306,0.569988040241071,0.246660256861228,0.119996247918767
AFG,"Cluster 7:Shuhada, Tagab, Tashkan, Wardooj",2017,37391,28948,36185,18092,0,120616,54277,0.449998341845195,0.199998341845195,0.0999987103240403
AFG,"Cluster 8: Baharak, Jurm, Kishm, Faiz Abad",2017,22679,102055,68036,34018,0,226788,102054,0.449997354357373,0.199998824158833,0.0999994120794163
AFG,"Cluster 9: Khwahan, Shahri Buzurg",2017,21793,18161,21793,10896,0,72643,32689,0.449995181917046,0.199996329079654,0.0999973997647552
AFG,Daykundi,2017,114216,109457,204637,47590,0,475900,252227,0.53,0.21,0.0922222222222222
AFG,Daykundi,2018,74826,343915,687830,275132,0,1381703,962962,0.696938488227933,0.298687923526257,0.14381270392005
AFG,Daykundi,2019,126903,101522,203044,101522,0,532991,304566,0.571428035370203,0.25396801572009,0.126984007860045
AFG,Daykundi,2020,154951,228425,154951,129126,0,667453,284077,0.425613488889854,0.206358100620318,0.111777325311462
AFG,Daykundi,2021,132990,199484,274637,171648,0,778759,446285,0.573072028702076,0.264494749552386,0.137145409840814
AFG,Daykundi,2022,137319,205978,240308,137319,0,720924,377627,0.523809721967919,0.238095370200835,0.12169320976352
AFG,Farah,2017,210630,236959,52658,26329,0,526576,78987,0.150001139436663,0.0666671730829611,0.0333335865414806
AFG,Farah,2018,75372,150744,200992,80056,0,507164,281048,0.554156052085716,0.237335457564023,0.114189668211641
AFG,Farah,2019,165917,193570,221223,55306,0,636016,276529,0.434783087217932,0.173913339706339,0.0772948758801316
AFG,Farah,2020,225210,197059,140757,84454,0,647480,225211,0.347826959906097,0.159420625604909,0.0821257456257765
AFG,Farah,2021,253694,281513,261952,112265,0,909424,374217,0.411487930822147,0.17831140003636,0.0868696376314385
AFG,Farah,2022,261952,261952,187109,74844,0,785857,261953,0.333334181664094,0.142857627617578,0.0687833650255567
AFG,Faryab,2017,362731,362731,145093,165820,0,1036375,310913,0.30000048245085,0.153333494150283,0.0866667202723167
AFG,Faryab,2018,234078,280893,327709,93631,0,936311,421340,0.45000005340106,0.18333331553298,0.0833333036660777
AFG,Faryab,2019,326768,272307,381230,108923,0,1089228,490153,0.450000367232572,0.183333516949619,0.0833334353423811
AFG,Faryab,2020,333470,290841,436261,145420,0,1205992,581681,0.482325753404666,0.200968994819203,0.0937854940626103
AFG,Faryab,2021,242367,313677,518220,388665,0,1462929,906885,0.61991046728857,0.295195460613605,0.157437578993922
AFG,Faryab,2022,129555,518220,453443,259110,0,1360328,712553,0.523809698837339,0.238095273100801,0.121693117803615
AFG,Faryab Urban,2020,40937,54582,48914,27951,0,172384,76865,0.445894050491925,0.202679289647918,0.103591722871934
AFG,Faryab Urban,2021,41926,48914,62633,53685,0,207158,116318,0.56149412525705,0.273548048671385,0.14877157639204
AFG,Faryab Urban,2022,35790,62633,53685,26843,0,178951,80528,0.450000279406094,0.200000745082918,0.100000682992675
AFG,Ghazni,2017,420116,445578,318270,89116,0,1273080,407386,0.320000314198636,0.130000209465758,0.0588890285327273
AFG,Ghazni,2018,374781,437244,312317,124927,0,1249269,437244,0.349999879929783,0.149999986658865,0.0722222355633575
AFG,Ghazni,2019,535439,669299,200790,66930,0,1472458,267720,0.181818428776916,0.0757576786570483,0.0353535833732892
AFG,Ghazni,2020,476876,535439,401579,200790,0,1614684,602369,0.37305689534299,0.165803133409798,0.0829016011113561
AFG,Ghazni,2021,476876,613127,633917,452798,0,2176718,1086715,0.499244734503964,0.235754470721517,0.124811196387303
AFG,Ghazni,2022,452798,724476,543357,181119,0,1901750,724476,0.380952280794006,0.158730116997502,0.0740740545988344
AFG,Ghor,2017,71335,356677,199739,85602,0,713353,285341,0.399999719633898,0.173333071658305,0.0844442450729941
AFG,Ghor,2018,109574,182624,328722,109574,0,730494,438296,0.599999452425345,0.249999771843894,0.116666560193817
AFG,Ghor,2019,112688,150251,375627,150251,0,788817,525878,0.666666666666667,0.28571434608196,0.137566197933812
AFG,Ghor,2020,262939,338064,267565,191118,0,1059686,458683,0.432848032341656,0.204400485930109,0.10821203429863
AFG,Ghor,2021,191118,267565,406488,304866,0,1170037,711354,0.607975645214639,0.289512212006971,0.154406513070384
AFG,Ghor,2022,152433,355677,254055,254055,20324,1036544,528434,0.509803732403063,0.264705598604594,0.155773094694163
AFG,Helmand,2018,194976,324959,584927,194976,0,1299838,779903,0.600000153865328,0.250000128221107,0.116666760695478
AFG,Helmand Urban,2020,29398,35126,40144,15054,0,119722,55198,0.461051435826331,0.195597578835413,0.0931417042073396
AFG,Helmand Urban,2021,30108,41794,40476,23882,0,136260,64358,0.472317628063995,0.215861832770683,0.110902359867573
AFG,Helmand Urban,2022,23882,41794,41794,17912,0,125382,59706,0.476192754940901,0.206350725516156,0.100530113307067
AFG,Hilmand,2017,278745,432536,182626,67283,0,961190,249909,0.259999583849187,0.109999757245359,0.0522220719455397
AFG,Hilmand,2019,497239,710341,355171,71034,0,1633785,426205,0.260869698277313,0.101449293103642,0.0434782490420166
AFG,Hilmand,2020,396806,859747,538348,201880,0,1996781,740228,0.370710658805347,0.157271127880323,0.0748909814791351
AFG,Hilmand,2021,471054,721233,540925,270462,0,2003674,811387,0.404949607570892,0.179977547911154,0.0899887462287334
AFG,Hilmand,2022,360616,721233,631079,270462,0,1983390,901541,0.454545500380661,0.196969666412892,0.0959595552171899
AFG,Hirat,2017,787585,846654,196896,137827,0,1968962,334723,0.169999725743818,0.0799998510213334,0.0422221341893738
AFG,Hirat,2018,215646,431291,575055,215646,0,1437638,790701,0.55000006955854,0.233333426078053,0.111111188398378
AFG,Hirat,2019,628535,628535,733291,209512,0,2199873,942803,0.428571558449056,0.17460326118826,0.0793651370884693
AFG,Hirat,2020,585164,520992,512019,223282,0,1841457,735301,0.399303920754055,0.173518939984299,0.0847847353722864
AFG,Hirat,2021,446564,595419,725977,622266,0,2390226,1348243,0.564065071671047,0.274800932352561,0.149453138647884
AFG,Hirat,2022,414844,725977,622266,311133,0,2074220,933399,0.45,0.2,0.1
AFG,Hirat Urban,2020,252882,195634,221272,130423,0,800211,351695,0.43950283112829,0.200829531211143,0.103162235404856
AFG,Hirat Urban,2021,195634,260846,269988,154279,0,880747,424267,0.481712682529716,0.218960344646836,0.111913081862454
AFG,Hirat Urban,2022,115709,308558,269988,154279,0,848534,424267,0.5,0.227272762984944,0.116161651873833
AFG,Jawzjan,2017,233287,244667,73969,17070,0,568993,91039,0.160000210898904,0.0633335266573285,0.0277779242353499
AFG,Jawzjan,2018,169106,197290,169106,45321,0,580823,214427,0.369177873465755,0.149068936090111,0.0670294086532769
AFG,Jawzjan,2019,236346,265890,88630,29543,0,620409,118173,0.190475960213343,0.079364849102232,0.0370368579437113
AFG,Jawzjan,2020,115294,184470,211166,70389,0,581319,281555,0.484338203292856,0.201807728057515,0.0941770162146582
AFG,Jawzjan,2021,93851,216214,223252,191359,0,724676,414611,0.572132925610894,0.278731460680359,0.151590810544605
AFG,Jawzjan,2022,95679,255145,159466,127572,0,637862,287038,0.450000156773722,0.216666509892944,0.11666647505434
AFG,Jawzjan Urban,2020,38908,46489,53130,19924,0,158451,73054,0.461051050482484,0.195597797847074,0.0931420088509662
AFG,Jawzjan Urban,2021,39848,53130,62948,40623,0,196549,103571,0.526947478745758,0.244542921442829,0.12744348172155
AFG,Jawzjan Urban,2022,24374,56873,48748,32499,0,162494,81247,0.5,0.233333743604892,0.122222632493781
AFG,Kabul,2017,2621649,1334658,714995,95333,0,4766635,810328,0.17000001048958,0.0633333578090204,0.0255555777002248
AFG,Kabul,2018,431829,158337,90269,57577,0,738012,147846,0.200330075933725,0.0927821408504649,0.0482643461985261
AFG,Kabul,2019,1760448,1760448,1257463,251493,0,5029852,1508956,0.300000079525203,0.116666719683469,0.0500000353445345
AFG,Kabul,2020,260821,298082,183092,109855,0,851850,292947,0.343895051945765,0.157618516561993,0.0811973939073781
AFG,Kabul,2021,223561,402737,302053,201369,0,1129720,503422,0.445616612966045,0.207954478395827,0.108928564403372
AFG,Kabul,2022,251711,302053,402737,151026,0,1107527,553763,0.499999548543738,0.212120938511356,0.101009927723859
AFG,Kabul Urban,2020,1718993,1783785,1114866,644622,0,5262266,1759488,0.334359380540626,0.152286106403591,0.0779840218390075
AFG,Kabul Urban,2021,1560812,2576436,2069123,886767,0,7093138,2955890,0.416725291401352,0.180580959607252,0.0879753392958409
AFG,Kabul Urban,2022,1182356,1773534,2364712,886767,0,6207369,3251479,0.523809523809524,0.222222222222222,0.105820105820106
AFG,Kandahar,2017,391495,548093,221847,143548,0,1304983,365395,0.279999816089558,0.129999905490467,0.0677777241372323
AFG,Kandahar,2018,169273,253909,253909,169273,0,846364,423182,0.5,0.233333412101649,0.122222300990538
AFG,Kandahar,2019,615616,478813,410411,136804,0,1641644,547215,0.333333536381822,0.138889024254548,0.0648149050585876
AFG,Kandahar,2020,344497,301435,301435,131450,0,1078817,432885,0.401258971632816,0.174368467188287,0.0851998068254394
AFG,Kandahar,2021,280507,405493,347565,173783,0,1207348,521348,0.431812534579922,0.191916774064589,0.0959584330468284
AFG,Kandahar,2022,289638,347565,405493,173783,0,1216479,579276,0.476190711060364,0.206349362929131,0.100529204915717
AFG,Kandahar Urban,2020,130815,183141,177378,104652,0,595986,282030,0.473215813794284,0.216270180843174,0.111111111111111
AFG,Kandahar Urban,2021,169954,237936,210583,140389,0,758862,350972,0.462497792747562,0.215832391133039,0.113055103855803
AFG,Kandahar Urban,2022,140389,245680,210583,140389,0,737041,350972,0.476190605407298,0.22222237297518,0.116402238440225
AFG,Kapisa,2017,82301,228614,137168,9145,0,457228,146313,0.320000087483706,0.113333683268158,0.0422225527162233
AFG,Kapisa,2018,211450,187955,56387,14097,0,469889,70484,0.150001383305419,0.0600006951996465,0.0266670544651089
AFG,Kapisa,2019,196749,239938,71981,23994,0,532662,95975,0.18017992648246,0.0750751258146191,0.0350351421518503
AFG,Kapisa,2020,219734,263931,95975,48830,0,628470,144805,0.23040877050615,0.102701799608573,0.0514998506072066
AFG,Kapisa,2021,195319,227186,194731,97365,0,714601,292096,0.408753975994996,0.18166827828863,0.0908340614008532
AFG,Kapisa,2022,194731,227186,194731,97365,0,714013,292096,0.409090590787563,0.181817884735059,0.0909088645600446
AFG,Khost,2017,330934,90845,129778,97334,0,648891,227112,0.350000231163632,0.166666923515146,0.0888890943676724
AFG,Khost,2018,292981,390641,195320,97660,0,976602,292980,0.29999938562485,0.133333060277711,0.0666665301388556
AFG,Khost,2019,281463,250189,87566,31274,0,650492,118840,0.182692485072837,0.0769233134304496,0.0363249834142635
AFG,Khost,2020,250189,286435,159131,63652,0,759407,222783,0.293364427770616,0.125727486490556,0.0605353914304187
AFG,Khost,2021,327784,286435,211534,84613,0,910366,296147,0.325305426608639,0.139416454480945,0.0671263596790253
AFG,Khost,2022,211534,338454,253840,84613,0,888441,338453,0.380951576975849,0.158729729942675,0.0740738239480418
AFG,Kunar,2017,249787,99915,99915,49957,0,499574,149872,0.299999599658909,0.133332932992243,0.0666663552902629
AFG,Kunar,2018,182438,319266,319266,91219,0,912189,410485,0.449999945186798,0.183333351604401,0.0833333637851123
AFG,Kunar,2019,171742,147207,122673,49069,0,490691,171742,0.350000305691362,0.150000033965707,0.0722221882565154
AFG,Kunar,2020,171742,196276,174788,74909,0,617715,249697,0.404226868377812,0.175164922334734,0.0853367293618866
AFG,Kunar,2021,149818,225022,232346,132769,0,739955,365115,0.493428654445203,0.224285711068015,0.114634898969081
AFG,Kunar,2022,132769,265539,232346,66385,0,697039,298731,0.428571428571429,0.174603334007614,0.0793652387695189
AFG,Kunar c_1,2017,39323,36786,34249,12685,0,123043,46934,0.381443885470933,0.16151264192193,0.0767473340395002
AFG,Kunar c_2,2017,79547,47139,13258,5892,0,145836,19150,0.131311884582682,0.0572378105086079,0.0280573917124563
AFG,Kunar c_3,2017,30091,25893,5598,5598,0,67180,11196,0.166656743078297,0.0833283715391486,0.0462935397439714
AFG,Kunar c_4,2017,44731,28628,7157,7157,0,87673,14314,0.16326577167429,0.0816328858371448,0.0453516032428583
AFG,Kunar c_5,2017,14157,11740,4834,2417,0,33148,7251,0.218746229033426,0.0972205462370782,0.0486102731185391
AFG,Kunduz,2017,492022,393618,185875,21868,0,1093383,207743,0.190000210356298,0.0700001737725939,0.0277779048045277
AFG,Kunduz,2018,364875,281721,241475,91219,0,979290,332694,0.339729804245933,0.144292633778894,0.0687971217242424
AFG,Kunduz,2019,445470,501154,167051,55684,0,1169359,222735,0.19047614975384,0.0793651336615473,0.0370371003829163
AFG,Kunduz,2020,327627,491441,208356,41671,0,1069095,250027,0.233867897614337,0.0909485748849884,0.0389779309706912
AFG,Kunduz,2021,502580,333369,314113,188468,0,1338530,502581,0.375472346529402,0.172091523287985,0.0886532240592292
AFG,Kunduz,2022,314113,565403,376935,125645,0,1382096,502580,0.363636100531367,0.15151504188807,0.0707070195477658
AFG,Kunduz Urban,2020,121302,136465,73652,15163,0,346582,88815,0.256259701888731,0.100003270029411,0.0430566696096931
AFG,Kunduz Urban,2021,106139,136465,76365,63637,0,382606,140002,0.365916896232678,0.177414015113894,0.0960991492844104
AFG,Kunduz Urban,2022,63637,101820,76365,38182,0,280004,114547,0.409090584420223,0.181817640700371,0.0909086219403215
AFG,Laghman,2017,227909,75970,151939,50646,0,506464,202585,0.3999988153156,0.166666008508667,0.0777773828829778
AFG,Laghman,2018,94183,141275,188366,47092,0,470916,235458,0.5,0.200000283136129,0.0888891720250179
AFG,Laghman,2019,145486,145486,169733,48495,0,509200,218228,0.428570306362922,0.17460264467138,0.0793647988129528
AFG,Laghman,2020,169733,193981,148046,74023,0,585783,222069,0.379097720486938,0.168487875771972,0.0842439378859862
AFG,Laghman,2021,127063,246744,196799,164000,0,734606,360799,0.491146274329369,0.238131733201199,0.128988116683562
AFG,Laghman,2022,98400,229599,262399,98400,0,688798,360799,0.523809592943069,0.222222383533828,0.105820251768701
AFG,Laghman c_1,2017,79238,120058,19209,16808,0,235313,36017,0.153059966937653,0.0748294116063853,0.0408160856202401
AFG,Laghman c_2,2017,29632,43855,29632,13038,0,116157,42670,0.367347641554104,0.159864091990438,0.078231282756193
AFG,Laghman c_3,2017,55417,31261,35524,17052,0,139254,52576,0.377554684246054,0.166669060374089,0.0827680194305211
AFG,Logar,2017,177846,195631,44462,26677,0,444616,71139,0.160000989618007,0.073333693194427,0.0377779177237586
AFG,Logar,2018,223171,357074,223171,89268,0,892684,312439,0.349999551913107,0.149999701275405,0.072222023072492
AFG,Logar,2019,234752,170728,64023,21341,0,490844,85364,0.173912689163971,0.0724636204849878,0.0338163562263276
AFG,Logar,2020,130312,170728,108594,65156,0,474790,173750,0.365951262663493,0.167727486537908,0.0864049837237984
AFG,Logar,2021,152031,251647,144355,86613,0,634646,230968,0.36393201879473,0.166802175280918,0.0859283933265334
AFG,Logar,2022,173225,202096,202096,57742,0,635159,259838,0.40909126691112,0.166666929068155,0.0757577586434613
AFG,Nangarhar,2017,922469,368988,461235,92247,0,1844939,553482,0.300000162607002,0.116666729902723,0.050000027101167
AFG,Nangarhar,2018,275132,412698,550264,137566,0,1375660,687830,0.5,0.2,0.0888888888888889
AFG,Nangarhar,2019,500544,500544,500544,166848,0,1668480,667392,0.4,0.166666666666667,0.0777777777777778
AFG,Nangarhar,2020,427313,489945,427313,213657,0,1558228,640970,0.411345451371686,0.182820271915706,0.0914101716108868
AFG,Nangarhar,2021,427313,734585,663684,474060,0,2299642,1137744,0.494748312998284,0.233631147804745,0.123687078249571
AFG,Nangarhar,2022,379248,758496,568872,284436,0,1991052,853308,0.428571428571429,0.19047619047619,0.0952380952380952
AFG,Nangarhar Urban,2020,67159,83196,124794,41598,0,316747,166392,0.525315156891778,0.218881315371574,0.102144613840068
AFG,Nangarhar Urban,2021,83196,124009,128045,91461,0,426711,219506,0.514413736697671,0.242917728079817,0.128603564369223
AFG,Nangarhar Urban,2022,91461,146338,91461,73169,0,402429,164630,0.409090796140437,0.196969734619854,0.106060668810868
AFG,Nangarhar c_1,2017,127449,195157,27880,39828,0,390314,67708,0.173470590345209,0.0918371704149309,0.0532881503382177
AFG,Nangarhar c_2,2017,25340,39530,25340,10136,0,100346,35476,0.35353676280071,0.151515755486018,0.072952030419194
AFG,Nangarhar c_3,2017,111468,55734,78028,30654,0,275884,108682,0.39394093169593,0.168350949432853,0.0808085201670912
AFG,Nangarhar c_4,2017,50031,63675,18193,18193,0,150092,36386,0.242424646216987,0.121212323108493,0.0673401795047186
AFG,Nangarhar c_5,2017,110001,144573,31429,22000,0,308003,53429,0.17346908958679,0.0816323217630997,0.0430836351882575
AFG,Nangarhar c_6,2017,116991,70194,70194,29248,0,286627,99442,0.346938704309085,0.149660243684882,0.0725627538384187
AFG,Nangarhar c_7,2017,99165,151847,27890,21692,0,300594,49582,0.164946738790528,0.0790368403893624,0.0423820095470228
AFG,Nangarhar c_8,2017,10505,14802,13847,6685,0,45839,20532,0.447915530443509,0.197917348400561,0.0983805638575594
AFG,Nimroz,2017,51338,42782,59894,17113,0,171127,77007,0.449999123458017,0.183333625513994,0.0833338203011019
AFG,Nimroz,2018,219148,219148,219148,73049,0,730493,292197,0.399999726212298,0.166666438510248,0.0777776104630708
AFG,Nimroz,2019,18020,63070,81090,36040,0,198220,117130,0.590909090909091,0.257575757575758,0.126262626262626
AFG,Nimroz,2020,72080,64244,72080,27533,0,235937,99613,0.422201689434044,0.179632698559361,0.0858101009073515
AFG,Nimroz,2021,55066,85400,85400,48800,0,274666,134200,0.488593418916065,0.222087917689121,0.113511602374439
AFG,Nimroz,2022,36600,85400,85400,61000,0,268400,146400,0.545454545454545,0.257575757575758,0.136363636363636
AFG,Nuristan,2017,53578,61232,30616,7654,0,153080,38270,0.25,0.1,0.0444444444444444
AFG,Nuristan,2018,49884,99768,224478,124710,0,498840,349188,0.7,0.316666666666667,0.161111111111111
AFG,Nuristan,2019,40248,32199,56348,40248,0,169043,96596,0.571428571428571,0.269840612546315,0.142856485562188
AFG,Nuristan,2020,48298,64397,40954,32763,0,186412,73717,0.395452009527284,0.190402620718266,0.102524396378869
AFG,Nuristan,2021,57335,65526,76216,65328,0,264405,141544,0.535330269851175,0.260801926337752,0.141839644148602
AFG,Nuristan,2022,43552,65328,76216,43552,0,228648,119768,0.523809523809524,0.238095238095238,0.121693121693122
AFG,Nuristan c_1,2017,14373,20533,4107,1232,0,40245,5339,0.132662442539446,0.0544249803288193,0.0249444375422758
AFG,Nuristan c_2,2017,12504,12504,10420,5418,0,40846,15838,0.387749106399647,0.173464557933049,0.0872980898442388
AFG,Nuristan c_3,2017,18096,19001,4072,3167,0,44336,7239,0.163275893179358,0.078235895585228,0.0419523637675929
AFG,Paktika,2017,244591,48918,146755,48918,0,489182,195673,0.400000408845787,0.166666666666667,0.0777776869231583
AFG,Paktika,2018,169106,169106,140921,84553,0,563686,225474,0.399999290385073,0.183333155929601,0.0944444247329187
AFG,Paktika,2019,381054,266738,114316,38105,0,800213,152421,0.19047553588857,0.0793647024812977,0.0370368056171711
AFG,Paktika,2020,310199,342949,304843,114316,0,1072307,419159,0.390894585226059,0.165834038199881,0.0789685748163125
AFG,Paktika,2021,310199,360807,360807,154632,0,1186445,515439,0.434439860254795,0.188257357062485,0.0917151658947528
AFG,Paktika,2022,154632,412351,360807,154632,0,1082422,515439,0.476190432197424,0.20634927967096,0.100529183627088
AFG,Paktya,2017,363840,139472,90960,12128,0,606400,103088,0.17,0.0633333333333333,0.0255555555555556
AFG,Paktya,2018,186024,223228,223228,111614,0,744094,334842,0.449999596825132,0.19999982081117,0.0999999104055849
AFG,Paktya,2019,270554,210431,120246,60123,0,661354,180369,0.27272686035013,0.121211937933391,0.0606059689666956
AFG,Paktya,2020,244781,330677,152988,60123,0,788569,213111,0.270250288814295,0.115497819467922,0.0554421997314122
AFG,Paktya,2021,244781,315132,284716,81347,0,925976,366063,0.395326660734187,0.161058889935232,0.0732085208831906
AFG,Paktya,2022,203369,366063,244042,81347,0,894821,325389,0.363635855662753,0.151514846730985,0.0707068788059288
AFG,Panjsher,2017,39808,47770,55732,15923,0,159233,71655,0.450000942015788,0.183333019328071,0.0833328099912288
AFG,Panjsher,2018,380863,253909,143882,67709,0,846363,211591,0.250000295381533,0.110000082706829,0.054444461510933
AFG,Panjsher,2019,83500,58450,16700,8350,0,167000,25050,0.15,0.0666666666666667,0.0333333333333333
AFG,Panjsher,2020,67970,76467,33985,8496,0,186918,42481,0.227270781840165,0.0909079560734297,0.0404033378867263
AFG,Panjsher,2021,59474,87505,67765,33883,0,248627,101648,0.408837334641853,0.181705928961859,0.0908531879303356
AFG,Panjsher,2022,67765,79059,67765,22588,0,237177,90353,0.380951778629462,0.15872955640724,0.074073605600693
AFG,Parwan,2017,242580,346543,69309,34654,0,693086,103963,0.150000144282239,0.0666665704785072,0.0333332050824541
AFG,Parwan,2018,452783,129367,64683,13596,0,660429,78279,0.11852750257787,0.0463713737585721,0.0200319287412677
AFG,Parwan,2019,362281,253596,108684,36228,0,760789,144912,0.190475940109544,0.0793649750456434,0.0370369883546336
AFG,Parwan,2020,258195,295080,184425,73770,0,811470,258195,0.318181818181818,0.136363636363636,0.0656565656565657
AFG,Parwan,2021,258195,295080,392254,196127,0,1141656,588381,0.515375034160903,0.229055570738179,0.11452778536909
AFG,Parwan,2022,245159,392254,245159,147095,0,1029667,392254,0.380952288458307,0.174603051277743,0.0899469871758971
AFG,Samangan,2017,133374,133374,113166,24250,0,404164,137416,0.340000593818351,0.133333663232417,0.0577779757172281
AFG,Samangan,2018,280893,280893,327709,46816,0,936311,374525,0.400000640812721,0.150000373807421,0.061111342515705
AFG,Samangan,2019,148001,126858,126858,42286,0,444003,169144,0.380952380952381,0.158730158730159,0.0740740740740741
AFG,Samangan,2020,105715,172196,148001,86098,0,512010,234099,0.457215679381262,0.208457517105786,0.106854032798839
AFG,Samangan,2021,129147,193975,228901,143063,0,695086,371964,0.535133782006831,0.246984785575694,0.128066167351954
AFG,Samangan,2022,85838,200289,171676,114451,0,572254,286127,0.5,0.233333449831718,0.122222338720607
AFG,Sari pul,2017,145976,175172,204367,58391,0,583906,262758,0.450000513781328,0.183333732941033,0.0833336187674044
AFG,Sari pul,2018,389951,389951,389951,129984,0,1299837,519935,0.400000153865446,0.166666794887872,0.0777778718066616
AFG,Sari pul,2019,213495,182996,213495,60999,0,670985,274494,0.409091112319948,0.166666915057714,0.0757577789866142
AFG,Sari pul,2020,182996,248401,217351,62100,0,710848,279451,0.393123424417034,0.160161290927643,0.0728005299460801
AFG,Sari pul,2021,155251,279818,288926,247651,0,971646,536577,0.552235073267425,0.269037626186217,0.146318721015679
AFG,Sari pul,2022,123826,330202,247651,123826,0,825505,371477,0.449999697155075,0.2,0.100000067298872
AFG,Takhar,2017,460085,337396,204482,20448,0,1022411,224930,0.219999589206298,0.0799997913428814,0.0311109937414819
AFG,Takhar,2018,201229,281721,281721,77162,0,841833,358883,0.42631139430267,0.172656967989296,0.0779211025887029
AFG,Takhar,2019,429328,321996,268330,53666,0,1073320,321996,0.3,0.116666666666667,0.05
AFG,Takhar,2020,330572,377797,283348,94449,0,1086166,377797,0.347826207043859,0.144927509545809,0.0676327968693961
AFG,Takhar,2021,389596,584394,268185,201139,0,1443314,469324,0.325171099289552,0.154843413606926,0.0825831693203589
AFG,Takhar,2022,335232,469324,469324,201139,0,1475019,670463,0.454545331280478,0.196969666153453,0.0959595925355688
AFG,Takhar Urban,2020,72548,65293,29720,22290,0,189851,52010,0.27395167789477,0.130453179949891,0.0695750293066083
AFG,Takhar Urban,2021,59440,59440,37150,22427,0,178457,59577,0.333845127957996,0.153172286134288,0.0789844799214003
AFG,Takhar Urban,2022,16820,44853,39247,22427,0,123347,61674,0.500004053604871,0.227274815493418,0.116162803581225
AFG,Uruzgan,2017,108917,90764,127070,36306,0,363057,163376,0.45000096403595,0.183333930117493,0.0833337158872819
AFG,Uruzgan,2018,143764,488797,575055,230022,0,1437638,805077,0.559999805236089,0.239999916529752,0.115555515366177
AFG,Uruzgan,2019,64270,128540,149963,107117,0,449890,257080,0.571428571428571,0.269841516815222,0.142857389831095
AFG,Uruzgan,2020,128540,152628,192810,109020,0,582998,301830,0.517720472454451,0.234906466231445,0.119857472352678
AFG,Uruzgan,2021,109020,174432,231874,173905,0,689231,405779,0.588741655555249,0.280353031131798,0.14952155211952
AFG,Uruzgan,2022,86953,231874,173905,115937,0,608669,289842,0.476189850312732,0.222222039674547,0.116402072938384
AFG,Wardak,2017,185931,278897,123954,30989,0,619771,154943,0.250000403374795,0.100000376483142,0.044444731288743
AFG,Wardak,2018,190278,253704,126852,63426,0,634260,190278,0.3,0.133333333333333,0.0666666666666667
AFG,Wardak,2019,194660,194660,194660,97330,0,681310,291990,0.428571428571429,0.19047619047619,0.0952380952380952
AFG,Wardak,2020,198077,259546,198077,99039,0,754739,297116,0.393667214759009,0.174963353777487,0.087481750497707
AFG,Wardak,2021,212505,297507,307190,175537,0,992739,482727,0.486257717285208,0.22102620460497,0.112968934097146
AFG,Wardak,2022,131653,351075,263306,175537,0,921571,438843,0.47619011448928,0.222221981088091,0.116401955646029
AFG,Zabul,2017,116911,142189,41077,15799,0,315976,56876,0.180001012735144,0.0766672152315366,0.0366669901792823
AFG,Zabul,2018,53796,143456,125524,35864,0,358640,161388,0.45,0.183333333333333,0.0833333333333333
AFG,Zabul,2019,113294,169942,113294,37765,0,434295,151059,0.347825786619694,0.144927602973401,0.0676329837245805
AFG,Zabul,2020,113294,153740,134522,56647,0,458203,191169,0.417214640672366,0.180281083566309,0.0875667189724496
AFG,Zabul,2021,134522,153276,204368,102184,0,594350,306552,0.515776899133507,0.22923417739267,0.114617088696335
AFG,Zabul,2022,102184,178822,178822,76638,0,536466,255460,0.476190476190476,0.206349206349206,0.100529100529101
AGO,Bibala,2021,8470,24598,46582,12704,0,92354,59286,0.641942958615761,0.259833539063459,0.117179548259956
AGO,Bondo,2019,542,542,616,355,0,2055,971,0.472506082725061,0.215085158150852,0.110083806434171
AGO,Cahama,2021,4499,21805,44993,22497,0,93794,67490,0.719555621894791,0.319803683249106,0.159902433939153
AGO,Camucuio,2021,6396,12793,36362,16528,0,72079,52890,0.733778215569028,0.321027391242017,0.157965565560011
AGO,Chiange,2019,8125,12187,12187,14624,0,47123,26811,0.568957833754218,0.293098203990974,0.16666312982337
AGO,Chibia,2021,22880,70762,129731,23587,0,246960,153318,0.620821185617104,0.238776859950329,0.100816596479862
AGO,Chicomba,2021,16309,55367,73390,32618,0,177684,106008,0.596609711622881,0.260060932141705,0.127480996225509
AGO,Chimbemba,2019,6214,8156,9710,17866,0,41946,27576,0.657416678586754,0.361115084473688,0.215022489232187
AGO,Chinguanja,2019,325,578,2637,542,0,4082,3179,0.778784909358158,0.303854319777887,0.130791006587185
AGO,Cuangar,2019,4788,3990,3325,2128,0,14231,5453,0.383177570093458,0.177570093457944,0.0924195223260644
AGO,Cuanhama,2021,139858,139858,192390,48098,0,520204,240488,0.462295560972234,0.184918480698598,0.0821861338158791
AGO,Cuchi,2019,2240,6108,13438,3054,0,24840,16492,0.663929146537842,0.262292002147075,0.114752191805332
AGO,Curoca,2021,7917,10231,18473,18473,0,55094,36946,0.670599339310996,0.335299669655498,0.186277594253054
AGO,Cuvelai,2021,11057,28578,33170,7371,0,80176,40541,0.505650069846338,0.199195104104304,0.0868284219162288
AGO,Dinde,2019,5026,10453,5227,1407,0,22113,6634,0.300004522226744,0.121210750840381,0.0545430792344373
AGO,Evale,2019,3323,27693,17724,27693,0,76433,45417,0.594206690827261,0.318841338165452,0.186795406870505
AGO,Humbe,2019,15114,8996,14394,7197,0,45701,21591,0.472440427999387,0.209973523555283,0.104986761777642
AGO,Humpata,2021,16545,26747,55151,16545,0,114988,71696,0.623508540021567,0.255797706427337,0.117240253089211
AGO,Impulo,2019,5974,5817,5345,3301,0,20437,8646,0.423056221558937,0.194858997569767,0.100846503890003
AGO,Jamba,2021,26006,31531,58513,19504,0,135554,78017,0.575541850480251,0.239808489605618,0.111910300610007
AGO,Kafima,2019,5023,26119,17580,20092,0,68814,37672,0.547446740488854,0.279807403532227,0.158152572312482
AGO,Kahama,2019,2446,8969,8153,25275,0,44843,33428,0.745445219989742,0.436359446662058,0.270704953331004
AGO,Kapelongo,2019,25712,14340,9889,8406,0,58347,18295,0.31355510994567,0.152541404585211,0.0828624912639515
AGO,Kutato,2019,1653,3758,8267,2255,0,15933,10522,0.660390384736082,0.267306847423586,0.120553428593346
AGO,Matala,2019,70580,35290,23997,23997,0,153864,47994,0.31192481672126,0.15596240836063,0.0866457824225723
AGO,Mocamedes,2021,167269,148683,76840,19210,0,412002,96050,0.233129936262445,0.0932519745049781,0.0414453220022125
AGO,Mongua,2019,20469,26534,27292,30324,0,104619,57616,0.550722144161195,0.280191297310559,0.157808598608071
AGO,Mukope,2019,3911,15645,31290,35201,0,86047,66491,0.772728857484863,0.393939746107747,0.222222222222222
AGO,Município dos Gambos (ex-chiange),2021,9828,19068,54056,24571,0,107523,78627,0.731257498395692,0.31992534930511,0.157423682994956
AGO,Namacunde,2021,27384,79619,73023,18256,0,198282,91279,0.460349401357662,0.184140096764541,0.0818402297961713
AGO,Naulila,2019,6085,18256,21299,21299,0,66939,42598,0.636370426806495,0.318185213403248,0.176769563001804
AGO,Ombadja,2021,39163,94898,176233,97907,0,408201,274140,0.671580912344654,0.303810296071462,0.154570093328205
AGO,Ombala yo mungu,2019,11866,11866,17799,26106,0,67637,43905,0.649126957138844,0.34503304404394,0.200782609124197
AGO,Otchinjau,2019,5273,7617,8496,10254,0,31640,18750,0.592604298356511,0.305562579013906,0.173872734934682
AGO,Oximolo,2019,934,1557,1557,2698,0,6746,4255,0.630744144678328,0.343561616760549,0.203396251276477
AGO,Quilengues,2019,19360,18965,4741,4741,0,47807,9482,0.198339155353819,0.0991695776769092,0.0550942098205051
AGO,Quilengues,2021,18082,27123,40684,13561,0,99450,54245,0.54544997486174,0.227269984917044,0.106058879392213
AGO,Savate,2019,1329,2924,6646,2658,0,13557,9304,0.686287526738954,0.294116200732709,0.141607861457386
AGO,Tômbwa (porto alexandre),2021,10933,21155,36444,14577,0,83109,51021,0.613904631267372,0.263100265915845,0.126677014523096
AGO,Virei,2021,4122,10306,21304,10652,0,46384,31956,0.688944463608141,0.306197539381396,0.153098769690698
BDI,Buragane,2017,107150,214300,45241,11906,0,378597,57147,0.15094414377293,0.0607972769638076,0.0272541339031565
BDI,Buragane,2018,197376,247378,26317,0,0,471071,26317,0.0558663131460013,0.0186221043820004,0.00620736812733348
BDI,Buragane,2020,225445,78950,26317,0,0,330712,26317,0.0795767918914342,0.0265255972971447,0.00884186576571492
BDI,Buragane,2021,457334,182934,30489,0,0,670757,30489,0.0454546132205851,0.015151537740195,0.00505051258006501
BDI,Buragane,2022,466906,124508,31127,0,0,622541,31127,0.0499999196840047,0.0166666398946683,0.00555554663155608
BDI,Crête Congo Nil,2020,1212389,378872,194206,0,0,1785467,194206,0.108770422528112,0.0362568075093706,0.0120856025031235
BDI,Crête Congo Nil,2021,968564,387425,129142,0,0,1485131,129142,0.0869566388419607,0.0289855462806536,0.00966184876021786
BDI,Crête Congo Nil,2022,988835,263689,65922,0,0,1318446,65922,0.0499997724593954,0.0166665908197985,0.00555553027326615
BDI,Crête congo mil,2022,1275978,318994,159497,0,0,1754469,159497,0.0909089872776321,0.0303029957592107,0.0101009985864036
BDI,Crête congo nil,2017,410008,1054305,410008,58573,0,1932894,468581,0.242424571652662,0.0909092790396162,0.0370371520056914
BDI,Crête congo nil,2018,712090,1165238,245995,0,0,2123323,245995,0.115853782019975,0.0386179273399918,0.0128726424466639
BDI,Dépression du Nord,2021,452838,452838,150946,50315,0,1106937,201261,0.18181793543806,0.0757573978163768,0.0353534121634745
BDI,Dépressions de l'est,2017,234429,488395,162798,26048,0,911670,188846,0.207142935492009,0.0785715591533486,0.0325397957106799
BDI,Dépressions de l`Est,2018,323874,554185,165536,35986,0,1079581,201522,0.186666864274195,0.0733333889104508,0.0318518635161851
BDI,Dépressions de l`Est,2020,503805,215916,71972,0,0,791693,71972,0.0909089760803746,0.0303029920267915,0.0101009973422638
BDI,Dépressions de l`Est,2021,614287,283517,141758,0,0,1039562,141758,0.136363199116551,0.045454399705517,0.0151514665685057
BDI,Dépressions de l`Est,2022,675385,241209,48242,0,0,964836,48242,0.0500002072891144,0.0166667357630381,0.00555557858767938
BDI,Dépressions de l`est,2017,271917,743241,226598,45320,0,1287076,271918,0.211268021468818,0.0821598724550842,0.0352114232397914
BDI,Dépressions de l`est,2018,359861,590171,129550,0,0,1079582,129550,0.120000148205509,0.0400000494018364,0.0133333498006121
BDI,Dépressions de l’Est,2020,359861,287888,107958,35986,0,791693,143944,0.181817952160749,0.0757574800669788,0.0353534906979235
BDI,Dépressions de l’Est,2021,567034,330770,141759,0,0,1039563,141759,0.136364029885635,0.0454546766285449,0.0151515588761816
BDI,Dépressions de l’est,2022,520860,260430,130215,0,0,911505,130215,0.142857142857143,0.0476190476190476,0.0158730158730159
BDI,Dépressions du Nord,2020,651152,300532,100177,50089,0,1101950,150266,0.136363718862017,0.0606061981033622,0.0303031494673584
BDI,Dépressions du nord,2017,271917,543835,362556,130239,0,1308547,492795,0.376597095862816,0.158708857992873,0.0750206144678028
BDI,Dépressions du nord,2018,601064,841489,180319,20035,0,1642907,200354,0.121950907750713,0.0447152516849706,0.01761504996259
BDI,Dépressions du nord,2020,601064,400709,100177,0,0,1101950,100177,0.090908843413948,0.0303029478046493,0.0101009826015498
BDI,Dépressions du nord,2021,553468,352207,150946,0,0,1056621,150946,0.14285727805902,0.0476190926863401,0.0158730308954467
BDI,Dépressions du nord,2022,716654,308210,102737,0,0,1127601,102737,0.0911111288478815,0.0303703762826272,0.0101234587608757
BDI,Haute Altitude,2020,1371878,242096,80699,0,0,1694673,80699,0.0476192162145736,0.0158730720715245,0.00529102402384151
BDI,Haute Altitude,2021,898224,552753,138188,0,0,1589165,138188,0.0869563575840143,0.0289854525280047,0.00966181750933492
BDI,Haute altitude,2017,605008,1236906,255448,40334,0,2137696,295782,0.138364856368726,0.0524109446182557,0.0216631987585388
BDI,Haute altitude,2018,887224,1404772,221806,0,0,2513802,221806,0.0882352707174232,0.0294117569058078,0.00980391896860258
BDI,Haute altitude,2020,1109030,443612,221806,0,0,1774448,221806,0.125,0.0416666666666667,0.0138888888888889
BDI,Haute altitude,2021,1036412,345470,138188,0,0,1520070,138188,0.0909089712973745,0.0303029904324582,0.0101009968108194
BDI,Haute altitude,2022,970109,373119,149248,0,0,1492476,149248,0.10000026801101,0.0333334226703366,0.0111111408901122
BDI,Haute altitude nord,2022,1193748,280882,140441,0,0,1615071,140441,0.0869565486594707,0.0289855162198236,0.00966183873994119
BDI,Imbo,2017,228296,570739,380493,76099,0,1255627,456592,0.363636653241767,0.141414342529005,0.0606061973641677
BDI,Imbo,2018,630812,689688,159806,42054,0,1522360,201860,0.13259675766573,0.0534069909000937,0.0239410447521538
BDI,Imbo,2020,420542,462596,84108,42054,0,1009300,126162,0.124999504607153,0.0555553353809571,0.0277776676904786
BDI,Imbo,2021,563650,620015,112730,56365,0,1352760,169095,0.125,0.0555555555555556,0.0277777777777778
BDI,Imbo,2022,690537,345269,115090,0,0,1150896,115090,0.100000347555296,0.0333334491850987,0.0111111497283662
BDI,Plaine imbo,2022,607645,405097,50637,0,0,1063379,50637,0.0476189580572872,0.0158729860190957,0.00529099533969858
BDI,Plateaux Humides,2020,2278545,1226909,525818,0,0,4031272,525818,0.130434761038203,0.0434782536794011,0.014492751226467
BDI,Plateaux Humides,2021,2100737,1575553,525184,0,0,4201474,525184,0.124999940497073,0.0416666468323577,0.0138888822774526
BDI,Plateaux Secs de l'Est,2020,1089376,1198313,217875,0,0,2505564,217875,0.0869564696810778,0.0289854898936926,0.0096618299645642
BDI,Plateaux Secs de l’Est,2021,649369,1038990,278301,0,0,1966660,278301,0.141509462743942,0.0471698209146472,0.0157232736382157
BDI,Plateaux humides,2017,1019678,2476360,553539,174802,0,4224379,728341,0.172413744126652,0.0712643601974791,0.032950194836001
BDI,Plateaux humides,2018,1855208,2833408,607159,0,0,5295775,607159,0.114649697164249,0.0382165657214163,0.0127388552404721
BDI,Plateaux humides,2020,2361174,1011932,505966,0,0,3879072,505966,0.130434805025532,0.043478268341844,0.014492756113948
BDI,Plateaux humides,2021,1750614,1400491,525184,0,0,3676289,525184,0.142857103998081,0.0476190346660269,0.0158730115553423
BDI,Plateaux humides,2022,2278676,1429803,357451,0,0,4065930,357451,0.0879137122380366,0.0293045707460122,0.00976819024867073
BDI,Plateaux secs de l'est,2017,443227,1329680,443227,35458,0,2251592,478685,0.21259846366482,0.0761154774044321,0.0288713743678053
BDI,Plateaux secs de l'est,2022,1874762,468691,234345,0,0,2577798,234345,0.0909089851105479,0.0303029950368493,0.0101009983456164
BDI,Plateaux secs de l`Est,2018,1088081,1681580,375883,0,0,3145544,375883,0.119496977311397,0.0398323257704656,0.0132774419234885
BDI,Plateaux secs de l`Est,2020,1088081,1088081,197833,0,0,2373995,197833,0.0833333684359066,0.0277777894786355,0.00925926315954517
BDI,Plateaux secs de l`Est,2021,742135,927669,278300,0,0,1948104,278300,0.142856849531647,0.0476189498438824,0.0158729832812941
BDI,Plateaux secs de l`Est,2022,852377,852377,189417,0,0,1894171,189417,0.099999947206456,0.0333333157354853,0.0111111052451618
BDI,Plateaux secs de l`est,2017,354581,1418325,531872,177291,0,2482069,709163,0.285714458381294,0.119047724566346,0.0555556227038366
BEN,Abomey,2020,84549,28955,2316,0,0,115820,2316,0.0199965463650492,0.00666551545501641,0.00222183848500547
BEN,Abomey,2021,100764,15057,0,0,0,115821,0,0,0,0
BEN,Abomey,2022,97627,35717,15477,0,0,148821,15477,0.103997419718991,0.0346658065729971,0.0115552688576657
BEN,Abomey-calavi,2022,736842,101633,42347,0,0,880822,42347,0.0480766829166392,0.0160255609722131,0.00534185365740436
BEN,Adja-ouere,2020,128452,14597,2919,0,0,145968,2919,0.0199975337060178,0.00666584456867259,0.00222194818955753
BEN,Adja-ouere,2021,128452,17516,0,0,0,145968,0,0,0,0
BEN,Adja-ouere,2022,127540,40513,18006,0,0,186059,18006,0.0967757539275176,0.0322585846425059,0.010752861547502
BEN,Adjarra,2020,96614,23236,2446,0,0,122296,2446,0.0200006541505855,0.00666688471686182,0.00222229490562061
BEN,Adjarra,2021,111289,9784,1223,0,0,122296,1223,0.0100003270752927,0.00333344235843091,0.0011111474528103
BEN,Adjarra,2022,98825,34653,12834,2567,0,148879,15401,0.103446422934061,0.0402295376334697,0.0172414436481229
BEN,Adjohoun,2020,86043,7564,946,0,0,94553,946,0.0100049707571415,0.0033349902523805,0.00111166341746017
BEN,Adjohoun,2021,86043,8510,0,0,0,94553,0,0,0,0
BEN,Adjohoun,2022,91291,9923,1985,0,0,103199,1985,0.0192346825066134,0.00641156083553781,0.00213718694517927
BEN,Agbangnizoun,2020,60235,22145,6201,0,0,88581,6201,0.0700037254038677,0.0233345751346226,0.00777819171154085
BEN,Agbangnizoun,2021,77065,10630,886,0,0,88581,886,0.0100021449294996,0.00333404830983318,0.00111134943661106
BEN,Agbangnizoun,2022,76764,28085,13106,0,0,117955,13106,0.111110169132296,0.0370367230440987,0.0123455743480329
BEN,Aguegues,2020,30766,20697,4475,0,0,55938,4475,0.0799992849225929,0.026666428307531,0.00888880943584365
BEN,Aguegues,2021,32445,19579,3916,0,0,55940,3916,0.0700035752592063,0.0233345250864021,0.0077781750288007
BEN,Aguegues,2022,52247,5283,2348,0,0,59878,2348,0.0392130665686897,0.0130710221895632,0.00435700739652108
BEN,Akpo-misserete,2020,111705,15770,3943,0,0,131418,3943,0.0300035002815444,0.0100011667605148,0.00333372225350493
BEN,Akpo-misserete,2021,122219,7885,1314,0,0,131418,1314,0.00999863032461307,0.00333287677487102,0.00111095892495701
BEN,Akpo-misserete,2022,114472,34480,8275,0,0,157227,8275,0.0526309094493948,0.0175436364831316,0.00584787882771054
BEN,Allada,2020,89636,51221,19208,0,0,160065,19208,0.120001249492394,0.0400004164974646,0.0133334721658215
BEN,Allada,2021,134455,22409,3201,0,0,160065,3201,0.0199981257614094,0.00666604192046981,0.00222201397348994
BEN,Allada,2022,115177,49361,36198,0,0,200736,36198,0.180326398852224,0.0601087996174079,0.020036266539136
BEN,Aplahoue,2022,139100,77278,55199,6624,0,278201,61823,0.222224219179658,0.0820114473588041,0.0326282875411024
BEN,Athieme,2022,43730,25509,16034,2915,0,88188,18949,0.214870503923436,0.0826416292466095,0.0348926283747348
BEN,Avrankou,2020,133422,22505,4822,0,0,160749,4822,0.0299970761870991,0.00999902539569971,0.00333300846523324
BEN,Avrankou,2021,138244,19290,3215,0,0,160749,3215,0.0200001244175703,0.00666670813919008,0.00222223604639669
BEN,Avrankou,2022,131578,43859,13495,0,0,188932,13495,0.071427815298626,0.0238092717662087,0.00793642392206955
BEN,Banikoara,2020,260001,40238,9286,0,0,309525,9286,0.0300008076892012,0.0100002692297337,0.00333342307657791
BEN,Banikoara,2021,281668,46429,12381,0,0,340478,12381,0.0363635829627759,0.0121211943209253,0.0040403981069751
BEN,Banikoara,2022,275477,44544,9545,0,0,329566,9545,0.028962332279422,0.00965411075980734,0.00321803691993578
BEN,Bante,2020,111672,17491,5382,0,0,134545,5382,0.0400014864915084,0.0133338288305028,0.0044446096101676
BEN,Bante,2021,115708,14800,4036,0,0,134544,4036,0.0299976215959091,0.00999920719863638,0.00333306906621213
BEN,Bante,2022,114791,38725,6915,0,0,160431,6915,0.0431026422574191,0.0143675474191397,0.00478918247304656
BEN,Bassila,2020,143531,17941,1631,0,0,163103,1631,0.00999981606714775,0.00333327202238258,0.00111109067412753
BEN,Bassila,2021,141900,19572,1631,0,0,163103,1631,0.00999981606714775,0.00333327202238258,0.00111109067412753
BEN,Bassila,2022,83933,53717,41967,3357,0,182974,45324,0.247707324537913,0.0886847311639905,0.0336386590444544
BEN,Bembereke,2020,143345,21419,0,0,0,164764,0,0,0,0
BEN,Bembereke,2021,138402,26362,0,0,0,164764,0,0,0,0
BEN,Bembereke,2022,150738,20324,3387,0,0,174449,3387,0.0194154165400776,0.00647180551335921,0.00215726850445307
BEN,Bohicon,2022,181762,62065,33249,0,0,277076,33249,0.119999566905831,0.039999855635277,0.013333285211759
BEN,Bonou,2020,37856,14474,3340,0,0,55670,3340,0.0599964074007545,0.0199988024669181,0.00666626748897272
BEN,Bonou,2021,47877,6681,1113,0,0,55671,1113,0.019992455677103,0.00666415189236766,0.00222138396412255
BEN,Bonou,2022,44402,12853,2921,0,0,60176,2921,0.0485409465567668,0.0161803155189223,0.00539343850630742
BEN,Bopa,2020,78560,33841,8460,0,0,120861,8460,0.0699977660287438,0.0233325886762479,0.00777752955874931
BEN,Bopa,2021,82185,31424,7252,0,0,120861,7252,0.0600028131489893,0.0200009377163298,0.00666697923877659
BEN,Bopa,2022,101875,27332,12424,0,0,141631,12424,0.0877209085581547,0.0292403028527182,0.00974676761757274
BEN,Boukombe,2020,84869,15525,3105,0,0,103499,3105,0.030000289857873,0.010000096619291,0.00333336553976367
BEN,Boukombe,2021,91079,16560,3105,0,0,110744,3105,0.0280376363505021,0.00934587878350069,0.00311529292783356
BEN,Boukombe,2022,86939,34035,13827,0,0,134801,13827,0.102573423045823,0.0341911410152744,0.0113970470050915
BEN,Come,2020,81332,13053,6025,0,0,100410,6025,0.0600039836669655,0.0200013278889885,0.00666710929632949
BEN,Come,2021,87357,11045,2008,0,0,100410,2008,0.0199980081665173,0.00666600272217243,0.00222200090739081
BEN,Come,2022,87734,12386,7225,0,0,107345,7225,0.0673063486888071,0.0224354495629357,0.00747848318764524
BEN,Copargo,2020,73910,10686,4452,0,0,89048,4452,0.0499955080406073,0.0166651693468691,0.00555505644895637
BEN,Copargo,2021,72129,11576,5343,0,0,89048,5343,0.0600013475878178,0.0200004491959393,0.00666681639864642
BEN,Copargo,2022,60414,31122,12815,0,0,104351,12815,0.122806681296777,0.0409355604322591,0.013645186810753
BEN,Cotonou,2022,534469,262853,96380,17524,0,911226,113904,0.125000823066945,0.0480773521972961,0.0202993915157528
BEN,Cove,2020,55324,7720,1287,0,0,64331,1287,0.020005906949993,0.00666863564999767,0.00222287854999922
BEN,Cove,2021,57254,7076,0,0,0,64330,0,0,0,0
BEN,Cove,2022,56209,16532,5952,0,0,78693,5952,0.0756356982196638,0.0252118994065546,0.00840396646885153
BEN,Dangbo,2020,108939,9683,2421,0,0,121043,2421,0.0200011566137654,0.00666705220458845,0.00222235073486282
BEN,Dangbo,2021,110149,8473,2421,0,0,121043,2421,0.0200011566137654,0.00666705220458845,0.00222235073486282
BEN,Dangbo,2022,97812,38109,7622,0,0,143543,7622,0.0530990713584083,0.0176996904528028,0.00589989681760092
BEN,Dassa-zoume,2020,115412,16890,8445,0,0,140747,8445,0.0600012788904915,0.0200004262968305,0.00666680876561016
BEN,Dassa-zoume,2021,123856,11260,5630,0,0,140746,5630,0.0400011367996249,0.0133337122665416,0.00444457075551387
BEN,Dassa-zoume,2022,101275,37617,20255,0,0,159147,20255,0.127272270290989,0.0424240900969963,0.0141413633656654
BEN,Djakotomey,2020,104312,48791,15142,0,0,168245,15142,0.0899997028143481,0.029999900938116,0.00999996697937201
BEN,Djakotomey,2021,139643,23554,5047,0,0,168244,5047,0.0299980980005231,0.00999936600017435,0.00333312200005812
BEN,Djakotomey,2022,121062,51884,38048,0,0,210994,38048,0.180327402674958,0.0601091342249859,0.0200363780749953
BEN,Djidja,2020,93049,46525,15508,0,0,155082,15508,0.0999987103596807,0.0333329034532269,0.0111109678177423
BEN,Djidja,2021,131820,20161,3102,0,0,155083,3102,0.020002192374406,0.00666739745813532,0.00222246581937844
BEN,Djidja,2022,129126,47825,19130,0,0,196081,19130,0.0975617219414426,0.0325205739804809,0.010840191326827
BEN,Djougou,2020,285756,40342,10085,0,0,336183,10085,0.0299985424605051,0.00999951415350171,0.00333317138450057
BEN,Djougou,2021,272308,50427,13447,0,0,336182,13447,0.0399991671178112,0.0133330557059371,0.00444435190197902
BEN,Djougou,2022,304108,76027,17279,0,0,397414,17279,0.0434785890783918,0.0144928630261306,0.00483095434204353
BEN,Dogbo,2020,71152,45278,12937,0,0,129367,12937,0.100002318983976,0.0333341063279919,0.0111113687759973
BEN,Dogbo,2021,72446,46572,10349,0,0,129367,10349,0.079997217219229,0.0266657390730763,0.00888857969102545
BEN,Dogbo,2022,81119,46544,33246,0,0,160909,33246,0.206613676052924,0.0688712253509748,0.0229570751169916
BEN,Glazoue,2020,128082,18744,9372,0,0,156198,9372,0.0600007682556755,0.0200002560852252,0.00666675202840839
BEN,Glazoue,2021,135892,15620,4686,0,0,156198,4686,0.0300003841278377,0.0100001280426126,0.00333337601420419
BEN,Glazoue,2022,107577,44957,35324,0,0,187858,35324,0.18803564394383,0.0626785479812766,0.0208928493270922
BEN,Gogounou,2020,128348,17703,1475,0,0,147526,1475,0.00999823759879614,0.00333274586626538,0.00111091528875513
BEN,Gogounou,2021,129823,20654,1475,0,0,151952,1475,0.00970701274086554,0.00323567091362185,0.00107855697120728
BEN,Gogounou,2022,133450,24264,3033,0,0,160747,3033,0.0188681592813552,0.00628938642711839,0.0020964621423728
BEN,Grand-popo,2020,56433,15917,0,0,0,72350,0,0,0,0
BEN,Grand-popo,2021,61498,10853,0,0,0,72351,0,0,0,0
BEN,Grand-popo,2022,64704,18593,3719,0,0,87016,3719,0.0427392663418222,0.0142464221139407,0.00474880737131358
BEN,Houeyogbe,2020,81860,35814,10232,0,0,127906,10232,0.0799962472440699,0.0266654157480233,0.00888847191600776
BEN,Houeyogbe,2021,86976,31977,8953,0,0,127906,8953,0.0699967163385611,0.0233322387795204,0.00777741292650679
BEN,Houeyogbe,2022,111758,23666,0,0,0,135424,0,0,0,0
BEN,Ifangni,2020,119801,19503,0,0,0,139304,0,0,0,0
BEN,Ifangni,2021,125374,13930,0,0,0,139304,0,0,0,0
BEN,Ifangni,2022,118853,37231,14320,0,0,170404,14320,0.0840355860191075,0.0280118620063692,0.00933728733545639
BEN,Kalale,2020,175958,36039,0,0,0,211997,0,0,0,0
BEN,Kalale,2021,171718,38159,2120,0,0,211997,2120,0.0100001415114365,0.00333338050381216,0.00111112683460405
BEN,Kalale,2022,189590,28330,10896,0,0,228816,10896,0.0476190476190476,0.0158730158730159,0.00529100529100529
BEN,Kandi,2020,186801,24757,13504,0,0,225062,13504,0.0600012441016253,0.0200004147005418,0.00666680490018059
BEN,Kandi,2021,202556,24757,18005,0,0,245318,18005,0.0733945328104746,0.0244648442701582,0.00815494809005273
BEN,Kandi,2022,198055,32389,9254,0,0,239698,9254,0.0386069136997388,0.0128689712332463,0.00428965707774876
BEN,Karimama,2020,72465,9162,1666,0,0,83293,1666,0.0200016808135137,0.00666722693783791,0.00222240897927931
BEN,Karimama,2021,68300,22489,5831,0,0,96620,5831,0.0603498240529911,0.0201166080176637,0.0067055360058879
BEN,Karimama,2022,61637,23117,10274,0,0,95028,10274,0.108115502799175,0.0360385009330583,0.0120128336443528
BEN,Kerou,2020,108168,12578,5031,0,0,125777,5031,0.039999363953664,0.013333121317888,0.00444437377262934
BEN,Kerou,2021,115715,13835,6289,0,0,135839,6289,0.0462974550754938,0.0154324850251646,0.00514416167505487
BEN,Kerou,2022,120203,13835,0,0,0,134038,0,0,0,0
BEN,Ketou,2020,179746,17777,0,0,0,197523,0,0,0,0
BEN,Ketou,2021,177771,19752,0,0,0,197523,0,0,0,0
BEN,Ketou,2022,176647,26395,10152,0,0,213194,10152,0.047618600898712,0.0158728669662373,0.00529095565541244
BEN,Klouekanme,2020,93628,54885,12914,0,0,161427,12914,0.0799990088399091,0.0266663362799697,0.0088887787599899
BEN,Klouekanme,2021,132370,24214,4843,0,0,161427,4843,0.030001177002608,0.0100003923342027,0.00333346411140089
BEN,Klouekanme,2022,111178,49781,38166,0,0,199125,38166,0.191668549905838,0.0638895166352794,0.0212965055450931
BEN,Kobli,2020,69587,13578,1697,0,0,84862,1697,0.0199971718790507,0.00666572395968356,0.00222190798656119
BEN,Kobli,2021,76376,23761,7638,0,0,107775,7638,0.0708698677800974,0.0236232892600325,0.00787442975334416
BEN,Kobli,2022,75527,23546,6104,0,0,105177,6104,0.0580355020584348,0.0193451673528116,0.00644838911760387
BEN,Kouande,2020,116213,16802,7001,0,0,140016,7001,0.0500014284081819,0.0166671428027273,0.00555571426757577
BEN,Kouande,2021,126014,18202,8401,0,0,152617,8401,0.0550462923527523,0.0183487641175841,0.00611625470586137
BEN,Kouande,2022,132372,16802,0,0,0,149174,0,0,0,0
BEN,Kpomasse,2020,56895,23777,4246,0,0,84918,4246,0.0500011776066323,0.0166670592022108,0.00555568640073692
BEN,Kpomasse,2021,70482,13587,849,0,0,84918,849,0.00999788030806189,0.00333262676935397,0.00111087558978466
BEN,Kpomasse,2022,74197,26187,13094,0,0,113478,13094,0.115388004723383,0.0384626682411275,0.0128208894137092
BEN,Lalo,2020,128365,21916,6262,0,0,156543,6262,0.0400017886459312,0.0133339295486437,0.00444464318288124
BEN,Lalo,2021,131496,20351,4696,0,0,156543,4696,0.029998147473857,0.00999938249128567,0.00333312749709523
BEN,Lalo,2022,97492,46425,35592,4642,0,184151,40234,0.218483744318521,0.0812304395125015,0.0326784963306079
BEN,Lokossa,2022,96162,40632,10835,0,0,147629,10835,0.0733934389584702,0.0244644796528234,0.00815482655094113
BEN,Malanville,2020,112198,80444,19052,0,0,211694,19052,0.0899978270522547,0.0299992756840849,0.00999975856136163
BEN,Malanville,2021,177823,82561,21169,0,0,281553,21169,0.0751865545740944,0.0250621848580315,0.00835406161934382
BEN,Malanville,2022,148186,58754,26113,0,0,233053,26113,0.112047474179693,0.0373491580598977,0.0124497193532992
BEN,Materi,2020,105858,28610,8583,0,0,143051,8583,0.0599995805691676,0.0199998601897225,0.00666662006324085
BEN,Materi,2021,121610,31471,10014,0,0,163095,10014,0.0613997976639382,0.0204665992213127,0.00682219974043758
BEN,Materi,2022,108734,48511,20580,2940,0,180765,23520,0.130113683511742,0.0487926313169032,0.019878479425405
BEN,N'dali,2020,122642,18539,1426,0,0,142607,1426,0.00999950914050502,0.00333316971350168,0.00111105657116723
BEN,N'dali,2021,119790,19965,2852,0,0,142607,2852,0.01999901828101,0.00666633942700335,0.00222211314233445
BEN,N'dali,2022,131932,19057,4398,0,0,155387,4398,0.0283035260349965,0.00943450867833216,0.00314483622611072
BEN,Natitingou,2021,119926,10428,0,0,0,130354,0,0,0,0
BEN,Natitingou,2022,118622,42865,16074,0,0,177561,16074,0.0905266359166709,0.030175545305557,0.0100585151018523
BEN,Nikki,2020,165162,24679,0,0,0,189841,0,0,0,0
BEN,Nikki,2021,157568,30375,1898,0,0,189841,1898,0.00999784029793353,0.00333261343264451,0.00111087114421484
BEN,Nikki,2022,160019,48786,13660,0,0,222465,13660,0.0614029173128357,0.0204676391042786,0.00682254636809286
BEN,Ouake,2020,59683,28909,4663,0,0,93255,4663,0.0500026808214037,0.0166675602738012,0.00555585342460041
BEN,Ouake,2021,55020,32639,5595,0,0,93254,5595,0.0599974263838549,0.0199991421279516,0.00666638070931721
BEN,Ouake,2022,64226,30675,9586,0,0,104487,9586,0.0917434704795812,0.0305811568265271,0.0101937189421757
BEN,Ouesse,2020,103398,60613,14262,0,0,178273,14262,0.0800008974999018,0.0266669658333006,0.00888898861110021
BEN,Ouesse,2021,146184,26741,5348,0,0,178273,5348,0.0299989342188666,0.00999964473962219,0.0033332149132074
BEN,Ouesse,2022,128279,43981,31153,1833,0,205246,32986,0.160714459721505,0.0565484020801055,0.0208340776975489
BEN,Ouidah,2020,168823,32544,2034,0,0,203401,2034,0.00999995083603326,0.00333331694534442,0.00111110564844814
BEN,Ouidah,2021,170857,32544,0,0,0,203401,0,0,0,0
BEN,Ouidah,2022,183994,25090,10454,0,0,219538,10454,0.0476181799961738,0.0158727266653913,0.00529090888846375
BEN,Ouinhi,2020,56796,7745,0,0,0,64541,0,0,0,0
BEN,Ouinhi,2021,58732,5809,0,0,0,64541,0,0,0,0
BEN,Ouinhi,2022,63598,22987,7662,0,0,94247,7662,0.0812970174116948,0.0270990058038983,0.00903300193463276
BEN,Parakou,2022,296695,32966,13186,0,0,342847,13186,0.0384603044506733,0.0128201014835578,0.00427336716118593
BEN,Pehunco,2020,84440,10800,2946,0,0,98186,2946,0.0300042775955839,0.0100014258651946,0.00333380862173154
BEN,Pehunco,2021,87386,11782,3927,0,0,103095,3927,0.0380910810417576,0.0126970270139192,0.00423234233797307
BEN,Pehunco,2022,87781,13117,4036,0,0,104934,4036,0.0384622715230526,0.0128207571743509,0.00427358572478362
BEN,Perere,2020,84280,12890,1983,0,0,99153,1983,0.0199993948745878,0.00666646495819592,0.00222215498606531
BEN,Perere,2021,81305,14873,2975,0,0,99153,2975,0.0300041350236503,0.0100013783412168,0.00333379278040559
BEN,Perere,2022,83578,25481,10192,0,0,119251,10192,0.0854667885384609,0.0284889295128203,0.00949630983760676
BEN,Pobe,2020,108676,38813,7763,0,0,155252,7763,0.050002576456342,0.0166675254854473,0.00555584182848244
BEN,Pobe,2021,117991,34155,3105,0,0,155251,3105,0.0199998711763531,0.00666662372545104,0.00222220790848368
BEN,Pobe,2022,138842,19151,7979,0,0,165972,7979,0.0480743739907936,0.0160247913302645,0.00534159711008818
BEN,Porto-novo,2022,320352,34821,0,0,0,355173,0,0,0,0
BEN,Sakete,2020,117435,22914,2864,0,0,143213,2864,0.0199981845223548,0.0066660615074516,0.00222202050248387
BEN,Sakete,2021,123164,20050,0,0,0,143214,0,0,0,0
BEN,Sakete,2022,120717,44165,14722,0,0,179604,14722,0.0819692211754749,0.0273230737251583,0.00910769124171944
BEN,Savalou,2020,123387,43548,14516,0,0,181451,14516,0.0799995591096219,0.0266665197032073,0.0088888399010691
BEN,Savalou,2021,154234,21774,5444,0,0,181452,5444,0.0300024248837158,0.0100008082945719,0.00333360276485731
BEN,Savalou,2022,152948,46631,26113,0,0,225692,26113,0.115701930063981,0.038567310021327,0.012855770007109
BEN,Save,2020,74414,30641,4377,0,0,109432,4377,0.0399974413334308,0.0133324804444769,0.00444416014815898
BEN,Save,2021,89735,16415,3283,0,0,109433,3283,0.0300000913801139,0.010000030460038,0.00333334348667932
BEN,Save,2022,93368,26998,8999,0,0,129365,8999,0.0695628647624937,0.0231876215874979,0.00772920719583264
BEN,Segbana,2020,92813,14537,4473,0,0,111823,4473,0.0400007154163276,0.0133335718054425,0.00444452393514751
BEN,Segbana,2021,101759,15655,4473,0,0,121887,4473,0.0366979251273721,0.012232641709124,0.00407754723637468
BEN,Segbana,2022,97286,16093,5747,0,0,119126,5747,0.048243036784581,0.016081012261527,0.005360337420509
BEN,Seme-kpodji,2020,233987,38998,5571,0,0,278556,5571,0.0199995692069099,0.00666652306896997,0.00222217435632332
BEN,Seme-kpodji,2021,250700,25070,2786,0,0,278556,2786,0.0100015795746636,0.00333385985822121,0.00111128661940707
BEN,Seme-kpodji,2022,237639,79213,32272,0,0,349124,32272,0.0924370710693049,0.0308123570231016,0.0102707856743672
BEN,Sinende,2020,93228,18415,3453,0,0,115096,3453,0.0300010426079099,0.01000034753597,0.00333344917865666
BEN,Sinende,2021,70209,36831,8057,0,0,115097,8057,0.07000182454799,0.0233339415159967,0.00777798050533222
BEN,Sinende,2022,102913,14195,5915,0,0,123023,5915,0.0480804402428814,0.0160268134142938,0.00534227113809793
BEN,So-ava,2022,107079,45891,15297,0,0,168267,15297,0.0909090909090909,0.0303030303030303,0.0101010101010101
BEN,Tanguieta,2020,77114,15047,1881,0,0,94042,1881,0.0200017013674741,0.00666723378915804,0.00222241126305268
BEN,Tanguieta,2021,83696,15987,1881,0,0,101564,1881,0.0185203418534126,0.00617344728447088,0.00205781576149029
BEN,Tanguieta,2022,79935,28025,14496,0,0,122456,14496,0.118377213039786,0.0394590710132619,0.0131530236710873
BEN,Tchaourou,2020,182068,81230,16806,0,0,280104,16806,0.059999143175392,0.0199997143917973,0.00666657146393244
BEN,Tchaourou,2021,168062,92434,19607,0,0,280103,19607,0.0699992502757914,0.0233330834252638,0.00777769447508793
BEN,Tchaourou,2022,207310,80621,28793,0,0,316724,28793,0.0909088038797186,0.0303029346265729,0.0101009782088576
BEN,Toffo,2020,67583,44630,15302,0,0,127515,15302,0.120001568442928,0.0400005228143094,0.0133335076047698
BEN,Toffo,2021,112213,12752,2550,0,0,127515,2550,0.0199976473356076,0.00666588244520253,0.00222196081506751
BEN,Toffo,2022,85203,39325,30149,5243,0,159920,35392,0.221310655327664,0.0846985992996498,0.0355184536712801
BEN,Tori-bossito,2020,52088,15916,4341,0,0,72345,4341,0.0600041467965996,0.0200013822655332,0.0066671274218444
BEN,Tori-bossito,2021,62217,8681,1447,0,0,72345,1447,0.0200013822655332,0.0066671274218444,0.00222237580728147
BEN,Tori-bossito,2022,62468,17848,8924,0,0,89240,8924,0.1,0.0333333333333333,0.0111111111111111
BEN,Toucountouna,2020,29960,17477,2497,0,0,49934,2497,0.0500060079304682,0.0166686693101561,0.00555622310338536
BEN,Toucountouna,2021,45440,17976,2996,0,0,66412,2996,0.0451123290971511,0.0150374430323837,0.00501248101079457
BEN,Toucountouna,2022,43104,7184,2053,0,0,52341,2053,0.0392235532374238,0.0130745177458079,0.00435817258193598
BEN,Toviklin,2020,90099,15573,5562,0,0,111234,5562,0.0500026970170991,0.0166675656723664,0.00555585522412212
BEN,Toviklin,2021,93436,13348,4449,0,0,111233,4449,0.039997123155898,0.0133323743852993,0.00444412479509978
BEN,Toviklin,2022,72035,34302,26298,0,0,132635,26298,0.198273457232254,0.0660911524107513,0.0220303841369171
BEN,Za-kpota,2022,140536,39419,22280,0,0,202235,22280,0.110168862956462,0.0367229543188205,0.0122409847729402
BEN,Zagnanado,2020,59441,8294,1382,0,0,69117,1382,0.0199950808050118,0.00666502693500393,0.00222167564500131
BEN,Zagnanado,2021,60133,8294,691,0,0,69118,691,0.00999739575797911,0.0033324652526597,0.00111082175088657
BEN,Zagnanado,2022,58260,20604,10657,0,0,89521,10657,0.119044693423889,0.0396815644746298,0.0132271881582099
BEN,Ze,2020,83208,40262,10737,0,0,134207,10737,0.080003278517514,0.026667759505838,0.00888925316861267
BEN,Ze,2021,118102,13421,2684,0,0,134207,2684,0.0199989568353365,0.00666631894511215,0.00222210631503738
BEN,Ze,2022,113125,48285,20694,0,0,182104,20694,0.113638360497298,0.0378794534990994,0.0126264844996998
BEN,Zogbodomey,2022,98335,35976,14391,0,0,148702,14391,0.0967774475124746,0.0322591491708249,0.0107530497236083
BFA,Bale,2020,224708,80253,16051,0,0,321012,16051,0.0500012460593374,0.0166670820197791,0.00555569400659304
BFA,Bale,2021,279473,96303,22471,0,0,398247,22471,0.0564247816053856,0.0188082605351285,0.00626942017837618
BFA,Bale,2022,298528,47637,9527,0,0,355692,9527,0.0267844089830528,0.00892813632768425,0.00297604544256142
BFA,Bam,2020,247661,104941,62965,4198,0,419765,67163,0.160001429371196,0.05666742105702,0.0211115478634209
BFA,Bam,2021,329014,146918,92348,8395,0,576675,100743,0.174696319417349,0.0630846375052384,0.0242632331902718
BFA,Bam,2022,207532,177161,111359,10124,0,506176,121483,0.24000150145404,0.0866674832469339,0.0333338162571473
BFA,Bam IDPs,2022,45196,57944,26654,5794,0,135588,32448,0.239313213558722,0.0940152029186457,0.0408344887944853
BFA,Banwa,2020,345734,48242,8040,0,0,402016,8040,0.0199992040117806,0.00666640133726021,0.00222213377908674
BFA,Banwa,2021,332329,60302,12060,0,0,404691,12060,0.029800514466593,0.00993350482219768,0.00331116827406589
BFA,Banwa,2022,318196,51696,22728,0,0,392620,22728,0.0578880342315725,0.0192960114105242,0.00643200380350806
BFA,Bazega,2020,243421,83363,6669,0,0,333453,6669,0.0199998200645968,0.00666660668819894,0.00222220222939965
BFA,Bazega,2021,263896,100036,10004,0,0,373936,10004,0.0267532411963545,0.00891774706545149,0.0029725823551505
BFA,Bazega,2022,248902,59976,23991,0,0,332869,23991,0.0720733982437535,0.0240244660812512,0.00800815536041706
BFA,Bougouriba,2020,115663,31260,9378,0,0,156301,9378,0.0599996161252967,0.0199998720417656,0.00666662401392186
BFA,Bougouriba,2021,147644,46890,12504,0,0,207038,12504,0.0603947101498276,0.0201315700499425,0.00671052334998084
BFA,Bougouriba,2022,127958,31169,4921,0,0,164048,4921,0.0299973178581878,0.00999910595272928,0.00333303531757643
BFA,Boulgou,2020,698461,124725,8315,0,0,831501,8315,0.00999998797355626,0.00333332932451875,0.00111110977483958
BFA,Boulgou,2021,668637,166300,24945,0,0,859882,24945,0.0290097943671341,0.00966993145571137,0.00322331048523712
BFA,Boulgou,2022,597840,149460,39332,0,0,786632,39332,0.0500005084969846,0.0166668361656615,0.00555561205522051
BFA,Boulkiemde,2020,499714,220462,14697,0,0,734873,14697,0.0199993740415011,0.00666645801383368,0.00222215267127789
BFA,Boulkiemde,2021,610910,257206,22081,0,0,890197,22081,0.0248046218982989,0.00826820729943297,0.00275606909981099
BFA,Boulkiemde,2022,515226,184009,36802,0,0,736037,36802,0.0500002037941027,0.0166667345980343,0.00555557819934475
BFA,Comoe,2020,592907,85722,35717,0,0,714346,35717,0.049999580035445,0.0166665266784817,0.00555550889282722
BFA,Comoe,2021,581108,92865,42861,0,0,716834,42861,0.059792085754861,0.0199306952516203,0.00664356508387344
BFA,Comoe,2022,608137,121627,27028,0,0,756792,27028,0.0357139081808476,0.0119046360602825,0.00396821202009418
BFA,Ganzourgou,2020,384759,57001,33251,0,0,475011,33251,0.0700004841993133,0.0233334947331044,0.00777783157770148
BFA,Ganzourgou,2021,442511,99752,42751,0,0,585014,42751,0.0730768836301354,0.0243589612100451,0.00811965373668171
BFA,Ganzourgou,2022,437365,87473,25727,0,0,550565,25727,0.0467283608656562,0.0155761202885521,0.00519204009618402
BFA,Gnagna,2020,364871,157272,106945,0,0,629088,106945,0.170000063584109,0.0566666878613697,0.0188888959537899
BFA,Gnagna,2021,526948,188726,188726,0,0,904400,188726,0.208675364882795,0.0695584549609318,0.0231861516536439
BFA,Gnagna,2022,461982,288738,137151,14437,0,902308,151588,0.168000283716868,0.0613334545040792,0.0240000581225529
BFA,Gourma,2020,265430,144780,72390,0,0,482600,72390,0.15,0.05,0.0166666666666667
BFA,Gourma,2021,247492,168910,115824,4826,0,537052,120650,0.224652361410068,0.0778794852888237,0.0279567383088085
BFA,Gourma,2022,303528,177447,102733,14009,0,597717,116742,0.195313166598909,0.0729168932231586,0.0295139673122899
BFA,Gourma IDPs,2022,35265,27330,27330,6171,0,96096,33501,0.34862012987013,0.137612387612388,0.0601412476412476
BFA,Houet,2020,1300768,214244,15303,0,0,1530315,15303,0.0099999019809647,0.00333330066032157,0.00111110022010719
BFA,Houet,2021,1547509,244850,16120,0,0,1808479,16120,0.00891356769970788,0.00297118923323596,0.000990396411078653
BFA,Houet,2022,1499149,96603,32240,0,0,1627992,32240,0.0198035371181185,0.00660117903937284,0.00220039301312428
BFA,Houet Urbain,2022,867068,201644,30247,0,0,1098959,30247,0.0275233197962799,0.00917443993209331,0.0030581466440311
BFA,Ioba,2020,195406,69788,13958,0,0,279152,13958,0.0500014329111022,0.0166671443037007,0.00555571476790024
BFA,Ioba,2021,247037,83745,19541,0,0,350323,19541,0.0557799516446251,0.018593317214875,0.00619777240495835
BFA,Ioba,2022,218642,70988,25556,0,0,315186,25556,0.0810822815734201,0.02702742719114,0.00900914239704668
BFA,Kadiogo,2020,1939745,1112969,127196,0,0,3179910,127196,0.0399998742102764,0.0133332914034255,0.00444443046780849
BFA,Kadiogo,2021,2947341,1208366,127196,0,0,4282903,127196,0.0296985479241533,0.00989951597471777,0.00329983865823926
BFA,Kadiogo,2022,2785399,388660,64777,0,0,3238836,64777,0.0200000864508113,0.00666669548360378,0.00222223182786793
BFA,Kadiogo Urbain,2022,1729392,655073,340638,26203,0,2751306,366841,0.133333406026084,0.047619082234643,0.0179894364510689
BFA,Kenedougou,2020,400776,55279,4607,0,0,460662,4607,0.0100008248998181,0.00333360829993936,0.00111120276664645
BFA,Kenedougou,2021,392856,78313,4607,0,0,475776,4607,0.00968312819478074,0.00322770939826025,0.00107590313275342
BFA,Kenedougou,2022,380046,64053,8540,0,0,452639,8540,0.0188671325272458,0.00628904417574859,0.00209634805858286
BFA,Komandjari IDPs,2022,10455,9148,7841,2875,0,30319,10716,0.35344173620502,0.149422254471893,0.0708796464263333
BFA,Komonjdjari,2020,33582,47015,40298,13433,0,134328,53731,0.399998511107141,0.166666666666667,0.0777781086428576
BFA,Komonjdjari,2021,46232,47015,44328,29552,0,167127,73880,0.442059032950989,0.206294215377128,0.108058874721353
BFA,Komonjdjari,2022,36382,45105,31573,9021,0,122081,40594,0.332516935477265,0.135470165982695,0.0615775136544134
BFA,Kompienga,2020,74419,42124,23870,0,0,140413,23870,0.169998504411985,0.0566661681373282,0.0188887227124427
BFA,Kompienga,2021,57809,51953,32295,3770,0,145827,36065,0.247313597619097,0.0910553829766321,0.036096805727944
BFA,Kompienga,2022,66606,49012,33931,10054,0,159603,43985,0.275590057830993,0.112861287068539,0.0516190519949848
BFA,Kossi,2020,342422,44841,20382,0,0,407645,20382,0.0499993867212894,0.0166664622404298,0.0055554874134766
BFA,Kossi,2021,311463,81529,28535,0,0,421527,28535,0.0676943588429685,0.0225647862809895,0.0075215954269965
BFA,Kossi,2022,277278,113950,75967,3798,0,470993,79765,0.169354958566263,0.0591395908927167,0.0215051556557694
BFA,Koulpelogo,2020,285297,110043,12227,0,0,407567,12227,0.0299999754641568,0.0099999918213856,0.00333333060712854
BFA,Koulpelogo,2021,316657,122270,16303,0,0,455230,16303,0.035812666124816,0.0119375553749387,0.00397918512497956
BFA,Koulpelogo,2022,305072,84957,19308,0,0,409337,19308,0.0471689585842472,0.0157229861947491,0.00524099539824969
BFA,Kouritenga,2020,304017,172276,30402,0,0,506695,30402,0.0600005920721539,0.0200001973573846,0.00666673245246154
BFA,Kouritenga,2021,384418,197611,40536,0,0,622565,40536,0.0651112735216403,0.0217037578405468,0.00723458594684892
BFA,Kouritenga,2022,394669,179395,41005,0,0,615069,41005,0.0666673170002065,0.0222224390000688,0.00740747966668961
BFA,Kourweogo,2020,141258,49739,7958,0,0,198955,7958,0.039998994747556,0.0133329982491853,0.00444433274972844
BFA,Kourweogo,2021,150946,59687,11937,0,0,222570,11937,0.0536325650357191,0.017877521678573,0.00595917389285768
BFA,Kourweogo,2022,143205,48380,17417,0,0,209002,17417,0.0833341307738682,0.0277780435912894,0.00925934786376313
BFA,Leraba,2020,170513,21075,0,0,0,191588,0,0,0,0
BFA,Leraba,2021,181983,28738,3832,0,0,214553,3832,0.0178603888083597,0.0059534629361199,0.0019844876453733
BFA,Leraba,2022,178152,19156,0,0,0,197308,0,0,0,0
BFA,Loroum,2020,97270,64847,54039,0,0,216156,54039,0.25,0.0833333333333333,0.0277777777777778
BFA,Loroum,2021,78311,86463,64847,6350,0,235971,71197,0.301719279063953,0.109543121824292,0.0424943931434136
BFA,Loroum,2022,55029,95243,63495,44447,0,258214,107942,0.41803310432432,0.196721840540534,0.103825595135129
BFA,Mouhoun,2020,397036,44611,4461,0,0,446108,4461,0.0099998206712276,0.00333327355707586,0.00111109118569196
BFA,Mouhoun,2021,383653,53533,8922,0,0,446108,8922,0.0199996413424552,0.00666654711415173,0.00222218237138391
BFA,Mouhoun,2022,355239,62689,20896,0,0,438824,20896,0.0476181794979308,0.0158727264993103,0.00529090883310343
BFA,Nahouri,2020,165744,64856,9608,0,0,240208,9608,0.0399986678212216,0.0133328892737405,0.00444429642458018
BFA,Nahouri,2021,181748,76867,14413,0,0,273028,14413,0.0527894574915393,0.0175964858305131,0.0058654952768377
BFA,Nahouri,2022,175481,37603,6267,0,0,219351,6267,0.0285706470451468,0.00952354901504894,0.00317451633834965
BFA,Namentenga,2020,230741,150483,110355,10032,0,501611,120387,0.240000717687611,0.0866667597002458,0.0333332668807768
BFA,Namentenga,2021,312002,175564,125403,20064,0,633033,145467,0.229793707437053,0.0871629125179888,0.0360976441986437
BFA,Namentenga,2022,240844,218949,136843,27369,0,624005,164212,0.263158147771252,0.102339457750071,0.0438598693564599
BFA,Nayala,2020,211978,23818,2382,0,0,238178,2382,0.0100009236789292,0.00333364122630974,0.00111121374210325
BFA,Nayala,2021,204833,30973,4765,0,0,240571,4765,0.0198070424115957,0.00660234747053192,0.00220078249017731
BFA,Nayala,2022,197753,52416,11913,0,0,262082,11913,0.0454552391999451,0.0151517463999817,0.00505058213332723
BFA,Noumbiel,2020,80981,22981,5472,0,0,109434,5472,0.050002741378365,0.016667580459455,0.00555586015315167
BFA,Noumbiel,2021,88708,27358,8755,0,0,124821,8755,0.0701404411116719,0.023380147037224,0.00779338234574132
BFA,Noumbiel,2022,86596,23233,5280,0,0,115109,5280,0.0458695671059604,0.0152898557019868,0.00509661856732894
BFA,Oubritenga,2020,241494,90998,17500,0,0,349992,17500,0.0500011428832659,0.0166670476277553,0.0055556825425851
BFA,Oubritenga,2021,278793,104997,27999,0,0,411789,27999,0.0679935598085427,0.0226645199361809,0.00755483997872697
BFA,Oubritenga,2022,258640,83974,16795,0,0,359409,16795,0.0467294920271891,0.0155764973423964,0.00519216578079879
BFA,Oudalan,2020,135292,110121,62926,6293,0,314632,69219,0.21999987286735,0.0800003390204006,0.0311114783832117
BFA,Oudalan,2021,78658,141584,78658,15732,0,314632,94390,0.300001271326502,0.116667514217668,0.0500005650340009
BFA,Oudalan,2022,21957,50669,59114,37157,0,168897,96271,0.569998282977199,0.263332089971995,0.136665804865951
BFA,Oudalan IDPs,2022,54772,39834,22905,1992,0,119503,24897,0.208337865994996,0.0750023011974595,0.0287049976430159
BFA,Passore,2020,295468,117249,56280,0,0,468997,56280,0.120000767595528,0.0400002558651761,0.0133334186217254
BFA,Passore,2021,342231,140699,70350,0,0,553280,70350,0.127150809716599,0.0423836032388664,0.0141278677462888
BFA,Passore,2022,317786,156449,73335,0,0,547570,73335,0.133928082254324,0.0446426940847746,0.0148808980282582
BFA,Poni,2020,326416,58991,7865,0,0,393272,7865,0.0199988811814724,0.00666629372715745,0.00222209790905249
BFA,Poni,2021,326666,98318,15731,0,0,440715,15731,0.0356942695392714,0.0118980898464238,0.00396602994880793
BFA,Poni,2022,311472,83566,18992,0,0,414030,18992,0.0458710721445306,0.0152903573815102,0.00509678579383673
BFA,Sanguie,2020,253862,141990,34422,0,0,430274,34422,0.0800001859280366,0.0266667286426789,0.00888890954755962
BFA,Sanguie,2021,342872,172110,43027,0,0,558009,43027,0.0771080753177816,0.0257026917725939,0.00856756392419796
BFA,Sanguie,2022,317784,83627,37632,0,0,439043,37632,0.0857137000248267,0.0285712333416089,0.00952374444720297
BFA,Sanmatenga,2020,317629,272253,317629,0,0,907511,317629,0.350000165287253,0.116666721762418,0.0388889072541392
BFA,Sanmatenga,2021,198629,425633,363005,18150,0,1005417,381155,0.379101407674627,0.132384539615569,0.048139782354541
BFA,Sanmatenga,2022,317402,454008,359423,47293,0,1178126,406716,0.345222836946133,0.128455134114121,0.0517389481260918
BFA,Sanmatenga IDPs,2022,73751,177003,132752,55313,0,438819,188065,0.428570777473172,0.184873489981063,0.089635539431469
BFA,Seno,2020,170610,121864,101553,12186,0,406213,113739,0.27999842447189,0.10333248812815,0.041110616023285
BFA,Seno,2021,138104,162485,121864,43158,0,465611,165022,0.354420320825754,0.149037143309186,0.0702770720145739
BFA,Seno,2022,107894,172630,129473,94947,0,504944,224420,0.444445324630058,0.210826679130095,0.112061051434527
BFA,Seno IDPs,2022,42387,48442,32699,26643,0,150171,59342,0.39516284768697,0.190860197153023,0.103046231000363
BFA,Sissili,2020,285688,32465,6493,0,0,324646,6493,0.0200002464222569,0.00666674880741895,0.00222224960247298
BFA,Sissili,2021,313096,38957,10796,0,0,362849,10796,0.0297534236004509,0.00991780786681696,0.00330593595560565
BFA,Sissili,2022,323892,46784,17994,0,0,388670,17994,0.0462963439421617,0.0154321146473872,0.00514403821579575
BFA,Soum,2020,81838,218235,163676,81838,0,545587,245514,0.449999725066763,0.19999987780745,0.0999999389037251
BFA,Soum,2021,155341,141852,218235,125485,0,640913,343720,0.536297438185838,0.244029480860377,0.124852272374635
BFA,Soum,2022,62137,155341,143691,97088,0,458257,240779,0.525423506896785,0.2457623851536,0.129001605843203
BFA,Sourou,2020,231683,63475,22216,0,0,317374,22216,0.0699994328457908,0.0233331442819303,0.00777771476064342
BFA,Sourou,2021,222152,79343,28564,0,0,330059,28564,0.0865421030785405,0.0288473676928468,0.00961578923094894
BFA,Sourou,2022,146073,106511,73036,15216,0,340836,88252,0.258928047506719,0.101190406334229,0.043650840221625
BFA,Tapoa,2020,304765,166236,83118,0,0,554119,83118,0.150000270699976,0.0500000902333253,0.0166666967444418
BFA,Tapoa,2021,252036,226186,135712,32312,0,646246,168024,0.260000061895934,0.103333199225476,0.0455554076930457
BFA,Tapoa,2022,310199,258498,187412,64625,0,820734,252037,0.307087314525778,0.128609269263854,0.0603676438136811
BFA,Tuy,2020,325649,36590,3659,0,0,365898,3659,0.0100000546600419,0.00333335155334729,0.0011111171844491
BFA,Tuy,2021,309355,54885,7031,0,0,371271,7031,0.018937649318153,0.00631254977271768,0.00210418325757256
BFA,Tuy,2022,298808,59762,10546,0,0,369116,10546,0.0285709641413539,0.00952365471378465,0.00317455157126155
BFA,Yagha,2020,108291,75552,62960,5037,0,251840,67997,0.270000794155019,0.096667196103346,0.0366670196244529
BFA,Yagha,2021,102893,88144,67997,7555,0,266589,75552,0.283402540990063,0.103914014956856,0.0409356725146199
BFA,Yagha,2022,64985,72206,57765,39713,0,234669,97478,0.415385074296136,0.194871641901288,0.102563847613258
BFA,Yatenga,2020,526733,246906,49381,0,0,823020,49381,0.0599997569925397,0.0199999189975132,0.00666663966583774
BFA,Yatenga,2021,440540,329208,132162,0,0,901910,132162,0.146535685378807,0.0488452284596024,0.0162817428198675
BFA,Yatenga,2022,352432,352431,264324,88108,0,1057295,352432,0.333333648603275,0.138889020251365,0.0648148761173035
BFA,Ziro,2020,258065,22939,5735,0,0,286739,5735,0.0200007672482641,0.00666692241608804,0.00222230747202934
BFA,Ziro,2021,243728,28674,14337,0,0,286739,14337,0.0500001743746055,0.0166667247915352,0.00555557493051172
BFA,Ziro,2022,227121,33551,12905,0,0,273577,12905,0.0471713630897334,0.0157237876965778,0.00524126256552594
BFA,Zondoma,2020,216203,25436,12718,0,0,254357,12718,0.0500005897223194,0.0166668632407731,0.00555562108025771
BFA,Zondoma,2021,210140,50871,17805,0,0,278816,17805,0.0638593194077815,0.0212864398025938,0.00709547993419794
BFA,Zondoma,2022,212702,58942,15376,0,0,287020,15376,0.0535711797087311,0.0178570599029104,0.00595235330097012
BFA,Zoundweogo,2020,270778,73183,21955,0,0,365916,21955,0.0600001093147061,0.0200000364382354,0.00666667881274512
BFA,Zoundweogo,2021,276512,98797,29273,0,0,404582,29273,0.0723536884982525,0.0241178961660842,0.00803929872202806
BFA,Zoundweogo,2022,293169,83286,19989,0,0,396444,19989,0.050420740381996,0.0168069134606653,0.00560230448688844
CAF,Abba,2019,5839,18977,4379,0,0,29195,4379,0.149991436889878,0.0499971456299595,0.0166657152099865
CAF,Abba,2020,7299,17517,11678,2920,0,39414,14598,0.37037600852489,0.148153786302667,0.0658480066304697
CAF,Abba,2021,8731,10404,11890,2973,0,33998,14863,0.43717277486911,0.174873031746966,0.0777235262204966
CAF,Abba,2022,8731,10187,10187,2910,0,32015,13097,0.40908948930189,0.166661460773596,0.0757526853731758
CAF,Alindao,2019,12514,20857,37542,12514,0,83427,50056,0.599997602694571,0.249999001122738,0.116666200523944
CAF,Alindao,2020,29199,25028,37542,16685,0,108454,54227,0.5,0.217948008679563,0.106836897568452
CAF,Alindao,2021,20857,21261,34018,20857,0,96993,54875,0.565762477704577,0.260266204777664,0.134541209732203
CAF,Alindao,2022,17009,21261,29765,17009,0,85044,46774,0.549997648276186,0.25,0.12777830038307
CAF,Amada-gaza,2019,6388,5323,7452,2129,0,21292,9581,0.449981213601353,0.18332394013401,0.0833281148892646
CAF,Amada-gaza,2020,4258,7452,10646,4258,0,26614,14904,0.56000601187345,0.239998998021092,0.115553217604769
CAF,Amada-gaza,2021,6616,9924,9693,3231,0,29464,12924,0.438636980722237,0.182765408634266,0.0852905240293239
CAF,Amada-gaza,2022,6616,9924,6616,3308,0,26464,9924,0.375,0.166666666666667,0.0833333333333333
CAF,Arrondissement 1,2022,9601,4800,1600,0,0,16001,1600,0.0999937503906006,0.0333312501302002,0.0111104167100667
CAF,Arrondissement 2,2021,27735,27735,36980,0,0,92450,36980,0.4,0.133333333333333,0.0444444444444444
CAF,Arrondissement 2,2022,38283,38283,19141,0,0,95707,19141,0.199995820577387,0.0666652735257957,0.0222217578419319
CAF,Arrondissement 3,2021,33672,33672,53875,13469,0,134688,67344,0.5,0.200000494971094,0.0888893838599826
CAF,Arrondissement 3,2022,35441,49618,42530,14176,0,141765,56706,0.4,0.166665491012121,0.0777766021232321
CAF,Arrondissement 4,2021,21143,70475,42285,7048,0,140951,49333,0.350001064199615,0.133334752266154,0.0555567379995727
CAF,Arrondissement 4,2022,73129,58503,14625,0,0,146257,14625,0.0999952139042918,0.0333317379680973,0.0111105793226991
CAF,Arrondissement 5,2021,18883,94416,56650,18883,0,188832,75533,0.400001059142518,0.166666666666667,0.0777775424127737
CAF,Arrondissement 5,2022,97916,78332,19583,0,0,195831,19583,0.0999994893556178,0.0333331631185393,0.0111110543728464
CAF,Arrondissement 6,2021,30307,42429,36368,12123,0,121227,48491,0.400001649797487,0.166668041497906,0.0777787859873534
CAF,Arrondissement 6,2022,56603,56603,12578,0,0,125784,12578,0.0999968199453031,0.033332273315101,0.0111107577717003
CAF,Arrondissement 7,2021,16678,23349,20013,6671,0,66711,26684,0.399994003987348,0.166664168328062,0.0777766118864289
CAF,Arrondissement 7,2022,24084,27524,17203,0,0,68811,17203,0.25000363314005,0.0833345443800168,0.0277781814600056
CAF,Arrondissement 8,2021,28337,62342,17002,5667,0,113348,22669,0.199994706567385,0.0833303925374363,0.0388871244113507
CAF,Arrondissement 8,2022,76549,29442,11776,0,0,117767,11776,0.099994056059847,0.033331352019949,0.0111104506733163
CAF,Baboua,2019,13209,31701,7925,0,0,52835,7925,0.149995268288067,0.0499984227626889,0.0166661409208963
CAF,Baboua,2020,10567,23776,18492,2642,0,55477,21134,0.380950664239234,0.142858001213716,0.0582022980494419
CAF,Baboua,2021,15879,18813,24188,5375,0,64255,29563,0.460088709049879,0.181246595595674,0.0790046602512558
CAF,Baboua,2022,15879,18525,18525,5293,0,58222,23818,0.409089347669266,0.166666666666667,0.0757579227401631
CAF,Bakala,2019,1197,2693,1796,299,0,5985,2095,0.350041771094403,0.133333333333333,0.0555462730901328
CAF,Bakala,2020,1197,3292,1796,599,0,6884,2395,0.347908192911098,0.144973852411389,0.0676609206533669
CAF,Bakala,2021,2742,3222,4296,1645,0,11905,5941,0.499034019319614,0.212403751924961,0.10150730318727
CAF,Bakala,2022,2193,3838,3838,2193,0,12062,6031,0.5,0.227270215000276,0.116159103889165
CAF,Bakouma,2019,2193,10965,6579,2193,0,21930,8772,0.4,0.166666666666667,0.0777777777777778
CAF,Bakouma,2020,3290,8772,8772,3290,0,24124,12062,0.5,0.212126236666114,0.101015125555003
CAF,Bakouma,2021,4279,9985,12740,5662,0,32666,18402,0.56333802730668,0.24555603175575,0.120369803465377
CAF,Bakouma,2022,2853,8559,14265,7132,0,32809,21397,0.652168612271023,0.289849329960275,0.144922971677826
CAF,Bambari,2019,25609,59754,68290,17073,0,170726,85363,0.5,0.200000780978488,0.0888896698673768
CAF,Bambari,2020,34145,68290,68290,51218,0,221943,119508,0.538462578229546,0.256411180648485,0.136752829930808
CAF,Bambari,2021,46092,53774,61326,30663,0,191855,91989,0.479471475854161,0.21309843371296,0.10654921685648
CAF,Bambari,2022,38410,53774,61456,15364,0,169004,76820,0.454545454545455,0.181818181818182,0.0808080808080808
CAF,Bambio,2019,3793,6069,4552,759,0,15173,5311,0.350029657945034,0.133350908411872,0.0555665399796422
CAF,Bambio,2020,1517,10621,6069,1517,0,19724,7586,0.384607584668424,0.153839653890354,0.0683713017418148
CAF,Bambio,2021,5766,9270,4118,1647,0,20801,5765,0.277150137012644,0.118776340881047,0.0571874215449044
CAF,Bambio,2022,5766,5766,6590,1647,0,19769,8237,0.416662451312661,0.166658235958656,0.0740665801113978
CAF,Bambouti,2022,276,645,461,461,0,1843,922,0.500271296798698,0.250135648399349,0.138964249110749
CAF,Bamingui,2019,2740,3653,2283,457,0,9133,2740,0.300010949304719,0.116683090623745,0.0500139907782523
CAF,Bamingui,2020,1826,3653,3653,1370,0,10502,5023,0.478289849552466,0.202913730717958,0.0966270974840771
CAF,Bamingui,2021,1784,2675,4109,1370,0,9938,5479,0.551318172670558,0.229724290601731,0.107209141119385
CAF,Bamingui,2022,1783,3121,3567,1783,0,10254,5350,0.521747610688512,0.231876991092907,0.115933077606571
CAF,Bamingui-bangoran,2017,10053,20106,14577,4524,0,49260,19101,0.387758830694275,0.159866017052375,0.0736973880092029
CAF,Bamingui-bangoran,2018,14115,23063,19761,8469,0,65408,28230,0.431598581213307,0.1870260518591,0.0911152560339204
CAF,Bamingui-bangoran,2019,7688,35876,10250,2563,0,56377,12813,0.227273533533178,0.0909117784439281,0.0404065487698884
CAF,Bangassou,2019,9093,27278,40918,13639,0,90928,54557,0.600002199542495,0.25,0.116666177879446
CAF,Bangassou,2020,18186,36371,50010,22732,0,127299,72742,0.571426326993928,0.249999345373229,0.123015717152356
CAF,Bangassou,2021,17139,25709,42562,12769,0,98179,55331,0.563572658104075,0.231210340296805,0.105971971829233
CAF,Bangassou,2022,12854,21424,42849,12854,0,89981,55703,0.619052911170136,0.253968430372338,0.116401116778974
CAF,Bangui,2018,352730,440912,88182,44091,0,925915,132273,0.142856525707003,0.0634917892031126,0.0317458946015563
CAF,Bangui,2019,438171,306719,131451,0,0,876341,131451,0.149999828833753,0.0499999429445844,0.0166666476481948
CAF,Bangui,2020,306719,350536,350536,131451,0,1139242,481987,0.423076923076923,0.17948717948718,0.0854700854700855
CAF,Bangui,2021,227535,409563,404848,91014,0,1132960,495862,0.437669467589324,0.172667466930283,0.0754075852437666
CAF,Bangui,2022,182028,318549,318549,91014,0,910140,409563,0.45,0.183333333333333,0.0833333333333333
CAF,Bangui 1ere arrondissement,2018,6031,6785,1508,754,0,15078,2262,0.150019896538002,0.0666755095724455,0.0333377547862228
CAF,Bangui 2eme arrondissement,2018,33815,38042,8454,4227,0,84538,12681,0.150003548699993,0.0666682438666635,0.0333341219333318
CAF,Bangui 3eme arrondissement,2018,25371,69770,25371,6343,0,126855,31714,0.25000197075401,0.100001313836007,0.0444453203351158
CAF,Bangui 3eme arrondissement,2019,44399,63428,25371,19028,0,152226,44399,0.291665024371658,0.13888779402555,0.0740733441651813
CAF,Bangui 4eme arrondissement,2018,38683,64471,19341,6447,0,128942,25788,0.199996897830032,0.0833320407625134,0.0388882856891729
CAF,Bangui 5eme arrondissement,2018,34900,95974,34900,8725,0,174499,43625,0.250001432672967,0.100000573069187,0.0444446991418607
CAF,Bangui 5eme arrondissement,2019,52350,95974,17450,8725,0,174499,26175,0.15000085960378,0.0666670487127911,0.0333335243563955
CAF,Bangui 6eme arrondissement,2018,33181,55302,16590,5530,0,110603,22120,0.199994575192355,0.0833310729968144,0.0388878340651801
CAF,Bangui 7eme arrondissement,2018,18273,30455,9137,3046,0,60911,12183,0.200013133916698,0.0833401739149469,0.0388928108223474
CAF,Bangui 8eme arrondissement,2018,20707,56944,20707,5177,0,103535,25884,0.250002414642391,0.100001609761594,0.0444455176188407
CAF,Bangui Arrond 1-2-4-6-7-8,2019,125902,327345,75541,15108,0,543896,90649,0.166666053804404,0.0648144743357799,0.0277775734903568
CAF,Baoro,2019,25760,6869,1717,0,0,34346,1717,0.0499912653584115,0.0166637551194705,0.0055545850398235
CAF,Baoro,2020,15456,17174,8587,1717,0,42934,10304,0.239996273349793,0.0933292961289421,0.0399967909400993
CAF,Baoro,2021,32318,20199,20199,8079,0,80795,28278,0.349996905749118,0.149996905749118,0.0722198155826474
CAF,Baoro,2022,10266,11977,11977,3422,0,37642,15399,0.409090909090909,0.166666666666667,0.0757575757575758
CAF,Basse-kotto,2017,72424,112981,55042,40557,0,281004,95599,0.340205121635279,0.161511342661789,0.0859102045206157
CAF,Basse-kotto,2019,59077,103384,162461,29538,0,354460,191999,0.541666196467867,0.208332863134533,0.0879625972527851
CAF,Batangafo,2019,7853,19632,35337,15705,0,78527,51042,0.649992996039579,0.283329300750061,0.138886412741265
CAF,Batangafo,2020,7853,27484,35337,23558,0,94232,58895,0.625,0.291666666666667,0.152777777777778
CAF,Batangafo,2021,24202,24202,20168,12101,0,80673,32269,0.399997520855801,0.183332713547284,0.0944443755793278
CAF,Batangafo,2022,20168,28236,24202,16135,0,88741,40337,0.454547503408796,0.21212291950733,0.111112363194264
CAF,Bayanga,2019,3216,3859,4502,1286,0,12863,5788,0.449972790173366,0.183316489154941,0.0833225357830815
CAF,Bayanga,2020,2573,7718,5146,1930,0,17367,7076,0.407439396556688,0.172856567052456,0.0823144789287474
CAF,Bayanga,2021,3415,7203,4781,1366,0,16765,6147,0.366656725320608,0.149378665871359,0.0678993935778905
CAF,Bayanga,2022,5464,4781,5464,2049,0,17758,7513,0.423076923076923,0.17948717948718,0.0854700854700855
CAF,Berbérati,2020,51420,59990,51420,8570,0,171400,59990,0.35,0.133333333333333,0.0555555555555556
CAF,Berbérati,2021,52216,69486,60919,17405,0,200026,78324,0.391569096017518,0.159527594746016,0.0725122400754569
CAF,Berbérati,2022,43429,60800,52114,17371,0,173714,69485,0.399996546046951,0.166664747803862,0.0777766264600947
CAF,Bimbo,2019,141301,98910,42390,0,0,282601,42390,0.149999469216316,0.0499998230721052,0.0166666076907017
CAF,Bimbo,2020,98910,141301,70650,42390,0,353251,113040,0.319999094128538,0.14666625147558,0.075555341669238
CAF,Bimbo,2021,100749,129534,115141,28785,0,374209,143926,0.38461394568276,0.153845400119541,0.068375634412261
CAF,Bimbo,2022,56323,84484,98565,42242,0,281614,140807,0.5,0.216666548301339,0.105555437190228
CAF,Birao,2019,5406,14416,12614,3604,0,36040,16218,0.45,0.183333333333333,0.0833333333333333
CAF,Birao,2020,15010,19812,23114,16510,0,74446,39624,0.532251564892674,0.251341016754874,0.133062891223168
CAF,Birao,2021,14907,14907,19355,6452,0,55621,25807,0.463979432228834,0.19332626166376,0.0902197211684635
CAF,Birao,2022,9938,14907,22361,7453,0,54659,29814,0.545454545454545,0.227269678064607,0.106057556852485
CAF,Birao Camp,2019,0,6000,19500,4500,0,30000,24000,0.8,0.316666666666667,0.138888888888889
CAF,Birao Camp,2020,1500,3000,13500,12000,0,30000,25500,0.85,0.416666666666667,0.227777777777778
CAF,Boali,2019,13868,9707,4160,0,0,27735,4160,0.149990986118623,0.0499969953728742,0.0166656651242914
CAF,Boali,2020,9707,13868,6934,2774,0,33283,9708,0.291680437460565,0.125008763232481,0.0601908882412443
CAF,Boali,2021,7061,14122,9457,4728,0,35368,14185,0.401068762723366,0.178249641860816,0.0891232501445123
CAF,Boali,2022,6304,9457,12609,4728,0,33098,17337,0.52380808508067,0.222218865188229,0.105817068503636
CAF,Bocaranga,2019,16594,33188,29039,4148,0,82969,33187,0.399992768383372,0.149995781556967,0.0611084996939955
CAF,Bocaranga,2020,12445,33188,37336,8297,0,91266,45633,0.5,0.196970028999481,0.0858589178883703
CAF,Bocaranga,2021,16202,28857,37102,28354,0,110515,65456,0.592281590734289,0.282948016106411,0.151329884832124
CAF,Bocaranga,2022,8101,16202,28354,28354,0,81011,56708,0.7000037032008,0.3500018516004,0.194445473111333
CAF,Boda,2019,13806,27613,11045,2761,0,55225,13806,0.249995473064735,0.0999969820431568,0.0444424324732156
CAF,Boda,2020,16568,24851,19329,5523,0,66271,24852,0.375005658583694,0.152781759744081,0.0694471689477046
CAF,Boda,2021,17828,20166,23047,8643,0,69684,31690,0.454767234946329,0.192932858810248,0.0918734732666195
CAF,Boda,2022,12734,20375,12734,5093,0,50936,17827,0.349988220512015,0.14999214700801,0.0722169868942289
CAF,Boganangone,2019,8462,18616,5077,1692,0,33847,6769,0.199988182113629,0.0833259471543514,0.0388841289068783
CAF,Boganangone,2020,8462,15232,10154,3385,0,37233,13539,0.363629038755942,0.151514337639549,0.0707078845826731
CAF,Boganangone,2021,7694,15388,15863,3847,0,42792,19710,0.460600112170499,0.183500031158472,0.0811444506761388
CAF,Boganangone,2022,15388,13464,13464,5770,0,48086,19234,0.39999168157052,0.173328342275645,0.0844413019266407
CAF,Boganda,2019,3243,8108,4054,811,0,16216,4865,0.30001233349778,0.11667488899852,0.0500054815545689
CAF,Boganda,2020,3243,7297,4865,1622,0,17027,6487,0.38098314441769,0.158747871028367,0.0740849500466579
CAF,Boganda,2021,4596,6755,5910,1838,0,19099,7748,0.405675689826693,0.167303698273906,0.0771535449790856
CAF,Boganda,2022,3676,6434,6434,2757,0,19301,9191,0.47619294337081,0.206345094381984,0.100524440299581
CAF,Bogangolo,2019,3313,4260,1420,473,0,9466,1893,0.199978871751532,0.0833157264596098,0.0388759771814917
CAF,Bogangolo,2020,4733,4733,2840,473,0,12779,3313,0.259253462712262,0.0987557711871038,0.0411438905843789
CAF,Bogangolo,2021,4339,3857,3775,1618,0,13589,5393,0.396865111487232,0.171977334608875,0.0837850876117121
CAF,Bogangolo,2022,2157,4314,4314,1618,0,12403,5932,0.478271385955011,0.202907898626676,0.0966253684144517
CAF,Bossangoa,2019,14888,52106,66994,14888,0,148876,81882,0.550001343399876,0.216668010066543,0.094445489311015
CAF,Bossangoa,2020,22331,96769,66994,22331,0,208425,89325,0.428571428571429,0.178571028747351,0.0833329335092559
CAF,Bossangoa,2021,30644,91931,68488,22983,0,214046,91471,0.427342720723583,0.178238945522614,0.0832738964729285
CAF,Bossangoa,2022,30439,60878,76098,15219,0,182634,91317,0.5,0.194443531872488,0.083332420761377
CAF,Bossembélé,2019,11313,15084,9428,1886,0,37711,11314,0.300018562223224,0.11667683169367,0.0500060400885094
CAF,Bossembélé,2020,16970,15084,11313,3771,0,47138,15084,0.319996605710891,0.133331919046205,0.0622215622215622
CAF,Bossembélé,2021,11520,19200,15860,5947,0,52527,21807,0.415157918784625,0.176125294293094,0.0838679790076215
CAF,Bossembélé,2022,9912,13877,15860,5947,0,45596,21807,0.478265637336609,0.202897915021786,0.096616662280317
CAF,Bossemtélé,2019,5551,9992,5551,1110,0,22204,6661,0.299990992613943,0.116660661742629,0.0499959967173082
CAF,Bossemtélé,2020,6662,11103,7772,2221,0,27758,9993,0.360004323078032,0.146672430770709,0.0666714700867017
CAF,Bossemtélé,2021,5651,6781,7911,3349,0,23692,11260,0.475265912544319,0.205540548145647,0.0999259009135761
CAF,Bossemtélé,2022,4465,4465,12279,3349,0,24558,15628,0.63637103998697,0.257580693324646,0.116164906660875
CAF,Bouar,2019,26237,62969,10495,5247,0,104948,15742,0.149998094294317,0.0666647609609839,0.0333318511178023
CAF,Bouar,2020,41980,52475,36732,10495,0,141682,47227,0.333330980646801,0.135801772043496,0.0617282207886519
CAF,Bouar,2021,37344,37344,37344,10670,0,122702,48014,0.391305765187202,0.159421470989335,0.0724646342810676
CAF,Bouar,2022,30761,35887,30761,10253,0,107662,41014,0.380951496349687,0.158728242090988,0.0740723540132802
CAF,Bouca,2019,10012,16687,30036,10012,0,66747,40048,0.599997003610649,0.249998751504437,0.116666084035404
CAF,Bouca,2020,13349,23361,30036,13349,0,80095,43385,0.541669267744553,0.236111284516304,0.115740336128625
CAF,Bouca,2021,13737,27298,24040,13737,0,78812,37777,0.479330558798153,0.217877142228764,0.111359240273619
CAF,Bouca,2022,17061,27298,27298,10236,0,81893,37534,0.458329771775366,0.194440713288478,0.0925896528939524
CAF,Bozoum,2019,10627,26569,13284,2657,0,53137,15941,0.299998118072153,0.116666980321308,0.0500007318608293
CAF,Bozoum,2020,10627,26569,23912,5314,0,66422,29226,0.440004817680889,0.173336143647185,0.0755572952736543
CAF,Bozoum,2021,10772,13445,26891,10772,0,61880,37663,0.608645765998707,0.260908209437621,0.125653594771242
CAF,Bozoum,2022,5386,8079,26930,16158,0,56553,43088,0.761904761904762,0.349206349206349,0.17989417989418
CAF,Bria,2019,13248,26496,30912,17664,0,88320,48576,0.55,0.25,0.127777777777778
CAF,Bria,2020,17664,39744,30912,35328,0,123648,66240,0.535714285714286,0.273809523809524,0.154761904761905
CAF,Bria,2021,18328,36627,27492,13746,0,96193,41238,0.428700633102201,0.190533614712089,0.0952668073560446
CAF,Bria,2022,9156,32048,36627,18313,0,96144,54940,0.571434514894325,0.253969739834692,0.126984292080398
CAF,Carnot,2019,28873,28873,40422,17324,0,115492,57746,0.5,0.216667243907226,0.105556132796115
CAF,Carnot,2020,17324,63520,46196,23098,0,150138,69294,0.461535387443552,0.205126838863801,0.1025634194319
CAF,Carnot,2021,46732,58377,40864,17513,0,163486,58377,0.357076446912886,0.154732923104527,0.07538260156833
CAF,Carnot,2022,40891,40891,40891,11683,0,134356,52574,0.391303700616273,0.159419750513561,0.0724633725988336
CAF,Concentration of Alindao,2018,9152,34139,46484,22880,0,112655,69364,0.61572056278017,0.272939505570103,0.136112713841177
CAF,Concentration of Alindao,2019,11621,27116,42611,7747,0,89095,50358,0.565216903305461,0.217389677684868,0.0917859213947659
CAF,Concentration of Bambari,2018,15310,45929,69486,38274,0,168999,107760,0.637636909094137,0.288037207320753,0.146340116410945
CAF,Concentration of Bambari,2019,27794,62537,41692,13897,0,145920,55589,0.380955317982456,0.158730811403509,0.0740740740740741
CAF,Concentration of Bangassou,2018,19246,23096,23096,11548,0,76986,34644,0.450003896812407,0.200001731916626,0.100000865958313
CAF,Concentration of Batangafo,2018,8230,16460,37034,28804,0,90528,65838,0.727266702014846,0.348481501119359,0.186866678449393
CAF,Concentration of Batangafo,2019,18677,26147,29883,11206,0,85913,41089,0.47826289385774,0.202899056797768,0.0966184137182705
CAF,Concentration of Bria,2018,18304,24923,41539,33924,0,118690,75463,0.635799140618418,0.307206448170304,0.1659177502551
CAF,Concentration of Bria,2019,12462,24923,37385,24923,0,99693,62308,0.624998746150683,0.291665412817349,0.152776802561642
CAF,Concentration of Kaga Bandoro,2018,12623,50494,45834,31559,0,140510,77393,0.550800654757668,0.258467961948141,0.136067816446437
CAF,Concentration of Kaga Bandoro,2019,22917,28647,40105,22917,0,114586,63022,0.549997381879113,0.249998545488396,0.127776905070815
CAF,Concentration of Obo,2018,5854,11708,21497,10748,0,49807,32245,0.647398959985544,0.287730640271448,0.143864204719105
CAF,Concentration of Obo,2019,5854,9757,15611,9757,0,40979,25368,0.619048781082994,0.28571544774966,0.14814905195344
CAF,Concentration of Paoua,2018,31076,75222,93227,51793,0,251318,145020,0.577037856420949,0.261041124524838,0.132810489764628
CAF,Concentration of Rafai,2018,1692,6768,4230,4230,0,16920,8460,0.5,0.25,0.138888888888889
CAF,Concentration of Rafai,2019,5076,5076,5076,3384,0,18612,8460,0.454545454545455,0.212121212121212,0.111111111111111
CAF,Concentration of Rafai & Bangassou,2018,8535,25604,38407,29684,0,102230,68091,0.666056930450944,0.318807264664645,0.170794613453324
CAF,Concentration of Zemio,2019,2623,3935,11804,9181,0,27543,20985,0.761899575209672,0.365077636181002,0.195766619467741
CAF,Damara,2019,12617,18025,3605,1802,0,36049,5407,0.149990290992815,0.0666592693278593,0.0333280935516781
CAF,Damara,2020,12617,16222,7210,3605,0,39654,10815,0.272734150400968,0.121215177955986,0.060607588977993
CAF,Damara,2021,12851,18359,11768,3922,0,46900,15690,0.33454157782516,0.139388770433547,0.065046197583511
CAF,Damara,2022,9807,13730,13730,5884,0,43151,19614,0.454543347778731,0.196967239075186,0.0959576062354677
CAF,Dédé-mokouba,2019,6388,7666,8944,2555,0,25553,11499,0.450005870152233,0.183331376615922,0.0833300721376486
CAF,Dédé-mokouba,2020,6388,10221,11499,2555,0,30663,14054,0.458337409907706,0.180554196697431,0.0787014389401631
CAF,Dédé-mokouba,2021,9518,11895,9252,2719,0,33384,11971,0.358584950874671,0.146677050882658,0.0669915062438427
CAF,Dédé-mokouba,2022,6799,8159,9518,2719,0,27195,12237,0.449972421400993,0.18331801188944,0.0833241404669976
CAF,Dékoa,2019,11514,18422,11514,4606,0,46056,16120,0.350008685079034,0.150005790052689,0.0722260822573485
CAF,Dékoa,2020,6908,20725,23028,6908,0,57569,29936,0.520002084455176,0.213332406908811,0.0977763881409941
CAF,Dékoa,2021,9382,21186,23456,9382,0,63406,32838,0.517900514146926,0.221955861169816,0.106866858026054
CAF,Dékoa,2022,7062,14125,16479,11770,0,49436,28249,0.571425681689457,0.26983709577366,0.142853610953781
CAF,Gadzi,2019,17688,24763,21226,7075,0,70752,28301,0.400002826775215,0.166666666666667,0.0777771496055078
CAF,Gadzi,2020,14150,28301,31838,10613,0,84902,42451,0.5,0.208334314857129,0.0972232037460183
CAF,Gadzi,2021,25937,25937,28804,10802,0,91480,39606,0.432947092260603,0.183675849001603,0.0874653840548025
CAF,Gadzi,2022,22232,25937,25937,7410,0,81516,33347,0.409085332940772,0.1666625774899,0.0757547257252837
CAF,Gambo,2019,2375,3958,7124,2375,0,15832,9499,0.599987367357251,0.25,0.116669473920611
CAF,Gambo,2020,4750,4750,7124,3166,0,19790,10290,0.519959575543204,0.226646454438268,0.111099882095334
CAF,Gambo,2021,6668,9405,12003,4031,0,32107,16034,0.499392655807145,0.208313867173306,0.0973377214383848
CAF,Gambo,2022,2687,8062,13437,4031,0,28217,17468,0.61905943225715,0.253972191704764,0.116403428980953
CAF,Gamboula,2019,8406,8406,13449,3362,0,33623,16811,0.499985129227017,0.199992068921076,0.0888842624261831
CAF,Gamboula,2020,6725,15130,15130,5043,0,42028,20173,0.479989530788998,0.199993655023635,0.0933293148483022
CAF,Gamboula,2021,8778,14105,15868,3526,0,42277,19394,0.458736428791068,0.180712917189015,0.0787714885687779
CAF,Gamboula,2022,8778,15801,12289,3511,0,40379,15800,0.391292503529062,0.159414547165606,0.072460657492481
CAF,Grimari,2019,5798,20294,28992,2899,0,57983,31891,0.550006036252005,0.200001149762287,0.07777758615073
CAF,Grimari,2020,14496,26093,23194,5798,0,69581,28992,0.416665469021716,0.166664271376765,0.0740719449274946
CAF,Grimari,2021,12578,17724,17724,10062,0,58088,27786,0.478343203415508,0.217187715190745,0.110889225542855
CAF,Grimari,2022,10128,12660,25320,7596,0,55704,32916,0.590909090909091,0.242424242424242,0.111111111111111
CAF,Haut-mbomou,2017,25203,40955,25203,9451,0,100812,34654,0.343748760068246,0.145832506712164,0.0694438933636648
CAF,Haut-mbomou,2018,6829,26331,41378,15046,0,89584,56424,0.629844615109841,0.26593290468536,0.125967434660951
CAF,Haut-mbomou,2019,10244,13658,27317,20488,0,71707,47805,0.666671315213299,0.317463195132042,0.169314013973531
CAF,Haute-Kotto,2019,16062,32123,48185,32123,0,128493,80308,0.62499902718436,0.291665693851027,0.152777021143391
CAF,Haute-kotto,2017,12725,26121,16744,9377,0,64967,26121,0.402065664106393,0.182133493414605,0.0927855680576293
CAF,Ippy,2019,6667,13334,15556,8889,0,44446,24445,0.549993250236242,0.249996250131245,0.127775527856525
CAF,Ippy,2020,8889,15556,20001,11112,0,55558,31113,0.560009359588178,0.253338853090464,0.128892328737536
CAF,Ippy,2021,13881,13849,24928,11105,0,63763,36033,0.565108291642489,0.246422951659531,0.120843331294533
CAF,Ippy,2022,13881,22210,19433,11105,0,66629,30538,0.458328955860061,0.208332707980009,0.106481828899995
CAF,Kabo,2019,5024,15071,20095,10047,0,50237,30142,0.599996018870554,0.26666268553722,0.133330236899319
CAF,Kabo,2020,7536,15071,20095,12559,0,55261,32654,0.590904978194387,0.272723982555509,0.141411765178979
CAF,Kabo,2021,10263,12921,20674,15506,0,59364,36180,0.609460278956944,0.290220784762932,0.154785167216944
CAF,Kabo,2022,10263,17960,17960,10263,0,56446,28223,0.5,0.227273264122642,0.116162153011531
CAF,Kaga-bandoro,2019,18030,48079,36059,18030,0,120198,54089,0.449999168039402,0.200000554640399,0.100000739520532
CAF,Kaga-bandoro,2020,36059,42069,42069,30049,0,150246,72118,0.479999467539901,0.226666045463218,0.119999497121018
CAF,Kaga-bandoro,2021,24793,49450,43388,18595,0,136226,61983,0.45500124792624,0.197167452126124,0.0960560636980704
CAF,Kaga-bandoro,2022,18543,37087,49450,30906,0,135986,80356,0.590913770535202,0.272729055441982,0.141414884211937
CAF,Kembé,2019,6483,12966,17288,6483,0,43220,23771,0.55,0.233333333333333,0.111111111111111
CAF,Kembé,2020,12966,10805,17288,8644,0,49703,25932,0.521739130434783,0.231884057971015,0.115942028985507
CAF,Kembé,2021,12225,9780,19560,9726,0,51291,29286,0.570977364449904,0.253533758359166,0.126649899592521
CAF,Kembé,2022,9780,9780,24450,7335,0,51345,31785,0.619047619047619,0.253968253968254,0.116402116402116
CAF,Kouango,2019,17830,26745,26745,17830,0,89150,44575,0.5,0.233333333333333,0.122222222222222
CAF,Kouango,2020,35660,26745,31203,22288,0,115896,53491,0.461543107613723,0.217951151607188,0.115386016581916
CAF,Kouango,2021,28215,23512,32917,23857,0,108501,56774,0.523257850158063,0.247712002654353,0.131432480397006
CAF,Kouango,2022,23857,33780,24128,19303,0,101068,43431,0.429720584161159,0.206903602854844,0.111410139707919
CAF,Koui,2019,2651,7954,11930,3977,0,26512,15907,0.599992456246228,0.25,0.116668343056394
CAF,Koui,2020,3977,7954,11930,6628,0,30489,18558,0.60867853980124,0.27535613937267,0.140094241639061
CAF,Koui,2021,6628,7954,9279,9900,0,33761,19179,0.568081514173158,0.287106424572732,0.160866088089808
CAF,Koui,2022,2828,4243,11315,9900,0,28286,21215,0.750017676589125,0.366671380423767,0.200000785626183
CAF,Kémo,2017,55076,68845,13769,0,0,137690,13769,0.1,0.0333333333333333,0.0111111111111111
CAF,Kémo,2018,30932,100530,28079,7733,0,167274,35812,0.214091849301147,0.0867737962863326,0.0391978297749667
CAF,Kémo,2019,28079,84238,35099,7020,0,154436,42119,0.272727861379471,0.106061194712804,0.0454550032951442
CAF,Lobaye,2017,71763,172231,43058,0,0,287052,43058,0.150000696737873,0.0500002322459578,0.0166667440819859
CAF,Lobaye,2018,64486,209581,48365,16122,0,338554,64487,0.190477737672572,0.0793659701751173,0.0370375840256568
CAF,Lobaye,2019,73171,175611,29269,14634,0,292685,43903,0.150000854160616,0.0666666666666667,0.033333143519863
CAF,Mala,2019,4557,6379,4557,2734,0,18227,7291,0.400010972732759,0.183336076516523,0.0944447492425766
CAF,Mala,2020,7291,7291,5468,5468,0,25518,10936,0.428560231993103,0.214280115996551,0.119044508886973
CAF,Mala,2021,6498,7661,6703,6498,0,27360,13201,0.48249269005848,0.239997563352827,0.132776965562053
CAF,Mala,2022,1915,5746,7661,3831,0,19153,11492,0.600010442228372,0.266677108895038,0.133341455066511
CAF,Mambéré-kadéï,2017,148456,212080,42416,16966,0,419918,59382,0.141413323553646,0.0606054832927699,0.0291803002808485
CAF,Mambéré-kadéï,2018,71466,214399,214399,71466,0,571730,285865,0.5,0.208333187576887,0.0972220764657754
CAF,Mambéré-kadéï,2019,129746,172995,129746,43249,0,475736,172995,0.363636554727832,0.151515406303776,0.0707072830309247
CAF,Markounda,2019,3377,10132,6755,2252,0,22516,9007,0.400026647717179,0.166681470953988,0.0777866603501707
CAF,Markounda,2020,4503,10132,7881,4503,0,27019,12384,0.458344128206077,0.208334875458011,0.106480624745549
CAF,Markounda,2021,5716,8108,8108,4633,0,26565,12741,0.479616036137775,0.218006148440931,0.111424807076981
CAF,Markounda,2022,4573,8003,9146,3430,0,25152,12576,0.5,0.212123621713316,0.101012510602205
CAF,Mbaïki,2019,43767,105041,17507,8753,0,175068,26260,0.149998857586766,0.0666655242534329,0.0333324447897071
CAF,Mbaïki,2020,70027,96287,43767,17507,0,227588,61274,0.269232121201469,0.11538540403419,0.0555560437671973
CAF,Mbaïki,2021,82072,72953,47053,18821,0,220899,65874,0.298208683606535,0.127803505976336,0.0615349096193283
CAF,Mbaïki,2022,75284,65874,47053,28231,0,216442,75284,0.34782528344776,0.159419151550993,0.0821246441181574
CAF,Mbomou,2017,66745,95350,28605,0,0,190700,28605,0.15,0.05,0.0166666666666667
CAF,Mbomou,2018,19444,58332,87498,29166,0,194440,116664,0.6,0.25,0.116666666666667
CAF,Mbomou,2019,58333,48611,58333,48611,0,213888,106944,0.5,0.242424384101337,0.131313272990225
CAF,Mbrès,2020,4893,5872,6851,1957,0,19573,8808,0.45000766361825,0.183330778793917,0.0833290757676391
CAF,Mbrès,2021,5337,8129,10838,4064,0,28368,14902,0.525310208685843,0.22285673998872,0.106121138058532
CAF,Mbrès,2022,4003,6672,12009,4003,0,26687,16012,0.599992505714393,0.249996877380997,0.116665209444465
CAF,Mingala,2020,8676,6941,13882,5206,0,34705,19088,0.550007203572972,0.233338135715315,0.111114312699099
CAF,Mingala,2021,7471,9339,16650,9250,0,42710,25900,0.606415359400609,0.274330757824085,0.139571789068394
CAF,Mingala,2022,9339,11207,11207,7471,0,39224,18678,0.476188048133796,0.222219389489428,0.116399823237474
CAF,Mobaye,2019,11356,30282,22712,11356,0,75706,34068,0.450003962697805,0.200001761199024,0.100000880599512
CAF,Mobaye,2020,15141,22712,30282,15141,0,83276,45423,0.545451270474086,0.242422786877372,0.121211393438686
CAF,Mobaye,2021,23326,23326,34701,15423,0,96776,50124,0.517938331817806,0.225768785649335,0.110671378578711
CAF,Mobaye,2022,27213,19438,19438,11663,0,77752,31101,0.400002572281099,0.183335048187399,0.0944455876804884
CAF,Mongoumba,2019,4041,16166,5389,1347,0,26943,6736,0.250009278847938,0.100001237179725,0.044443619657961
CAF,Mongoumba,2020,5389,13472,9430,2694,0,30985,12124,0.39128610618041,0.159410467430477,0.072457999390386
CAF,Mongoumba,2021,7646,11222,12625,3058,0,34551,15683,0.4539087146537,0.180805186535846,0.0799365832794677
CAF,Mongoumba,2022,10705,10705,10705,4587,0,36702,15292,0.416653043430876,0.180544202859063,0.0879546376522018
CAF,Nana-bakassa,2019,11444,20028,20028,5722,0,57222,25750,0.450001747579602,0.183332750806799,0.0833323624557765
CAF,Nana-bakassa,2020,14306,28611,22889,11444,0,77250,34333,0.444440129449838,0.197527508090615,0.0987630348795397
CAF,Nana-bakassa,2021,14528,23550,20607,11775,0,70460,32382,0.459579903491343,0.208898665909736,0.106769798467215
CAF,Nana-bakassa,2022,14528,20339,20339,5811,0,61017,26150,0.428569087303538,0.174601613757914,0.0793640388015726
CAF,Nana-gribizi,2018,15387,61550,53856,41903,0,172696,95759,0.554494603233428,0.265711616559349,0.142490593618587
CAF,Nana-gribizi,2019,13968,69839,48887,20952,0,153646,69839,0.454544862866589,0.196970091422274,0.0959601218963649
CAF,Nana-mambéré,2017,92375,135846,24452,13585,0,266258,38037,0.142857679393671,0.0646265401728148,0.0328803891964435
CAF,Nana-mambéré,2018,76295,106813,124660,45777,0,353545,170437,0.482080074672248,0.203853352001395,0.0967244465186736
CAF,Nana-mambéré,2019,96959,152364,55405,13851,0,318579,69256,0.217390349018611,0.0869559303448543,0.0386469638962741
CAF,Nangha boguila,2019,2766,11063,9680,4149,0,27658,13829,0.5,0.216670282257093,0.105559171145981
CAF,Nangha boguila,2020,5531,12446,9680,5531,0,33188,15211,0.458328311437869,0.208328311437869,0.106477575562787
CAF,Nangha boguila,2021,5691,8537,12651,5691,0,32570,18342,0.563156278784157,0.245962542216764,0.120816702486951
CAF,Nangha boguila,2022,4217,7028,12651,4217,0,28113,16868,0.60000711414648,0.2500029642277,0.116668049972927
CAF,Ndjoukou,2019,5486,7315,16458,7315,0,36574,23773,0.649997265817247,0.283334244727584,0.138890407879307
CAF,Ndjoukou,2020,5486,12801,16458,7315,0,42060,23773,0.565216357584403,0.246378189887462,0.120774554868706
CAF,Ndjoukou,2021,9313,13471,15396,7450,0,45630,22846,0.500679377602455,0.22131638541895,0.110054301507293
CAF,Ndjoukou,2022,5773,11547,17320,7698,0,42338,25018,0.59091123813123,0.257577904797896,0.12626429632429
CAF,Ndélé,2019,12625,22725,12625,2525,0,50500,15150,0.3,0.116666666666667,0.05
CAF,Ndélé,2020,10100,25250,20200,7575,0,63125,27775,0.44,0.186666666666667,0.0888888888888889
CAF,Ndélé,2021,11883,12625,22725,7575,0,54808,30300,0.552839001605605,0.230349584002335,0.107496472534423
CAF,Ndélé,2022,11883,11883,16636,9507,0,49909,26143,0.523813340279308,0.238100008682469,0.121697044175956
CAF,Ngaoundaye,2019,22096,49716,22096,16572,0,110480,38668,0.35,0.166666666666667,0.0888888888888889
CAF,Ngaoundaye,2020,16572,44192,44192,22096,0,127052,66288,0.521739130434783,0.231884057971015,0.115942028985507
CAF,Ngaoundaye,2021,16822,28422,51160,28038,0,124442,79198,0.636425001205381,0.287244928025372,0.145817149979732
CAF,Ngaoundaye,2022,11215,16822,50468,33645,0,112150,84113,0.750004458314757,0.350001486104919,0.18333382870164
CAF,Nola,2019,24682,24682,34555,14809,0,98728,49364,0.5,0.216665991410745,0.105554880299634
CAF,Nola,2020,24682,54300,39491,24682,0,143155,64173,0.448276343823129,0.206896953185941,0.107279987891912
CAF,Nola,2021,36308,66881,30868,10373,0,144430,41241,0.285543169701586,0.119121142883519,0.0556671051720557
CAF,Nola,2022,36308,31121,36308,10373,0,114110,46681,0.409087722373149,0.16666374550872,0.0757553627591311
CAF,Obo,2019,4781,11952,19123,11952,0,47808,31075,0.649995816599732,0.299998605533244,0.155555090733304
CAF,Obo,2020,8762,13142,21514,14342,0,57760,35856,0.620775623268698,0.28969298245614,0.151742843951985
CAF,Obo,2021,5680,12244,16326,9467,0,43717,25793,0.589999313768099,0.268850409070461,0.137739450455328
CAF,Obo,2022,4081,10204,18822,12548,0,45655,31370,0.687109845580988,0.320651261271128,0.167960184475353
CAF,Ombella m'poko,2017,161763,182501,58069,0,0,402333,58069,0.144330691243323,0.0481102304144411,0.0160367434714804
CAF,Ombella m'poko,2018,93180,302836,69885,23295,0,489196,93180,0.190475801110393,0.0793649171293306,0.0370369613270209
CAF,Ombella m'poko,2019,84584,211460,169168,42292,0,507504,211460,0.416666666666667,0.166666666666667,0.0740740740740741
CAF,Ouaka,2017,64348,106174,35391,48261,0,254174,83652,0.329113127227805,0.172995664387388,0.0998594138923205
CAF,Ouaka,2018,36140,126489,144558,90349,0,397536,234907,0.590907490139258,0.272726662910193,0.141413887323692
CAF,Ouaka,2019,65611,131222,114819,32806,0,344458,147625,0.428571843301651,0.17460377365794,0.0793655862575731
CAF,Ouanda-djallé,2020,1955,1466,1466,0,0,4887,1466,0.299979537548598,0.0999931791828661,0.033331059727622
CAF,Ouanda-djallé,2021,1366,1086,1614,605,0,4671,2219,0.475058873902805,0.201527153357597,0.0959585147125289
CAF,Ouanda-djallé,2022,807,1412,1815,605,0,4639,2420,0.521664151756844,0.217360063232018,0.101434696174942
CAF,Ouango,2019,18883,31471,9441,3147,0,62942,12588,0.199993644942963,0.0833306853929014,0.038887653183354
CAF,Ouango,2020,22030,28324,15736,12588,0,78678,28324,0.359998983197336,0.173330960793784,0.0933311867499315
CAF,Ouango,2021,14032,19768,25257,14032,0,73089,39289,0.537550110139693,0.24317840805958,0.123722828028538
CAF,Ouango,2022,11296,16944,22592,11296,0,62128,33888,0.545454545454545,0.242424242424242,0.121212121212121
CAF,Ouham,2017,107326,128791,128791,60102,0,425010,188893,0.444443660149173,0.195285601123111,0.0965203433121835
CAF,Ouham,2018,96443,175091,168776,120554,0,560864,289330,0.515864808581046,0.243602727220859,0.128966103091738
CAF,Ouham,2019,153206,153206,153206,43773,0,503391,196979,0.391304175084576,0.159420145903814,0.0724636625516856
CAF,Ouham pendé,2017,100113,105118,200226,90102,0,495559,290328,0.585859605011714,0.255892840206716,0.12570181687078
CAF,Ouham pendé,2018,84339,196792,224905,112453,0,618489,337358,0.545455133397684,0.242424683381596,0.121212431515444
CAF,Ouham pendé,2019,102078,204155,178636,76558,0,561427,255194,0.454545292620412,0.196969508057147,0.095959443030389
CAF,Paoua,2019,29440,98133,58880,9813,0,196266,68693,0.3499994904874,0.1333326539832,0.0555549894304442
CAF,Paoua,2020,39253,58880,78506,49067,0,225706,127573,0.565217583936625,0.260870335746502,0.13526642820503
CAF,Paoua,2021,30291,60582,90873,30111,0,211857,120984,0.571064444412977,0.237731111079643,0.110827901210093
CAF,Paoua,2022,50185,70259,80296,30111,0,230851,110407,0.478260869565217,0.202898550724638,0.0966183574879227
CAF,Rafai,2019,1805,5415,8122,2707,0,18049,10829,0.599977838107374,0.249986148817109,0.116657740348804
CAF,Rafai,2020,3210,7222,8122,3610,0,22164,11732,0.529326836311135,0.23073452445407,0.113106338607151
CAF,Rafai,2021,4682,6604,9365,2809,0,23460,12174,0.518925831202046,0.212887183859051,0.0975703324808184
CAF,Rafai,2022,1887,5661,9435,2830,0,19813,12265,0.619038005350023,0.253957839129191,0.116393837940297
CAF,Sangha-mbaéré,2017,23505,79916,14103,0,0,117524,14103,0.120001021068037,0.0400003403560124,0.0133334467853375
CAF,Sangha-mbaéré,2018,59404,59404,19801,13201,0,151810,33002,0.21739015875107,0.101449179895923,0.053140255729018
CAF,Sangha-mbaéré,2019,17975,83881,17975,5992,0,125823,23967,0.190481867385136,0.0793681070498505,0.0370388031864868
CAF,Satéma,2019,3675,11026,16539,5513,0,36753,22052,0.600005441732648,0.250002267388603,0.116667724781348
CAF,Satéma,2020,7351,9189,16539,9189,0,42268,25728,0.608687423109681,0.275361975962903,0.140098104160752
CAF,Satéma,2021,6090,9134,13561,7534,0,36319,21095,0.580825463256147,0.262755031801536,0.133682706633504
CAF,Satéma,2022,6090,7612,9134,7612,0,30448,16746,0.549986862848135,0.266662287616045,0.144442984760904
CAF,Sibut,2019,15392,17958,10262,7696,0,51308,17958,0.350003898027598,0.166666666666667,0.0888880226605338
CAF,Sibut,2020,12827,17958,23089,7696,0,61570,30785,0.5,0.208331979860322,0.0972208687492105
CAF,Sibut,2021,10452,20526,28744,10452,0,70174,39196,0.558554450366233,0.235832834573109,0.111709623380613
CAF,Sibut,2022,7697,15395,20526,10263,0,53881,30789,0.571425920083146,0.253967075592509,0.126983537796255
CAF,Sosso-nakombo,2019,6022,4301,5162,1721,0,17206,6883,0.400034871556434,0.166686039753574,0.0777894016299224
CAF,Sosso-nakombo,2020,4301,6882,6022,2581,0,19786,8603,0.434802385525119,0.188416051753765,0.09179329941485
CAF,Sosso-nakombo,2021,4485,7176,6116,1794,0,19571,7910,0.404169434367176,0.165278558411255,0.0754631285518823
CAF,Sosso-nakombo,2022,5382,6279,6279,1794,0,19734,8073,0.409090909090909,0.166666666666667,0.0757575757575758
CAF,Vakaga,2017,18228,15190,21266,6076,0,60760,27342,0.45,0.183333333333333,0.0833333333333333
CAF,Vakaga,2018,13649,27299,20474,10237,0,71659,30711,0.428571428571429,0.190476190476191,0.0952380952380953
CAF,Vakaga,2019,18586,37171,15488,3098,0,74343,18586,0.250003362791386,0.0972250245483771,0.0416687217058469
CAF,Yaloké,2019,11800,17699,7866,1967,0,39332,9833,0.25,0.100003389945422,0.0444478343898663
CAF,Yaloké,2020,9833,21633,11800,5900,0,49166,17700,0.360004881422121,0.160002169520943,0.0800010847604713
CAF,Yaloké,2021,11999,17998,14252,4000,0,48249,18252,0.378287632904309,0.153730301836998,0.0696663834138186
CAF,Yaloké,2022,10180,14252,14252,4072,0,42756,18324,0.428571428571429,0.174603174603175,0.0793650793650794
CAF,Zangba,2019,5926,13827,15802,3951,0,39506,19753,0.5,0.200003375014766,0.0888922639036546
CAF,Zangba,2020,15802,9877,17778,9877,0,53334,27655,0.518524768440395,0.234572067849152,0.119344341529064
CAF,Zangba,2021,9530,14165,19061,7148,0,49904,26209,0.525188361654377,0.222807790958641,0.106099266146557
CAF,Zangba,2022,9530,14295,14295,9530,0,47650,23825,0.5,0.233333333333333,0.122222222222222
CAF,Zémio,2019,1338,4682,4682,2675,0,13377,7357,0.549973835688121,0.249981311205801,0.127764903275107
CAF,Zémio,2020,2907,4844,6782,5351,0,19884,12133,0.610189096761215,0.293099979883323,0.157502402825276
CAF,Zémio,2021,4530,9244,13591,7551,0,34916,21142,0.605510367739718,0.273924084469393,0.139366224971678
CAF,Zémio,2022,4765,11913,19060,11913,0,47651,30973,0.649996852112233,0.300000699530615,0.155556954616785
CIV,Agneby-tiassa,2021,626107,74537,44722,0,0,745366,44722,0.0600000536649109,0.0200000178883036,0.00666667262943455
CIV,Agneby-tiassa,2022,670829,96897,44722,0,0,812448,44722,0.0550459844814684,0.0183486614938228,0.00611622049794093
CIV,Bagoue,2020,397512,76629,14368,0,0,488509,14368,0.029411945327517,0.009803981775839,0.00326799392527967
CIV,Bagoue,2021,454084,62632,5219,0,0,521935,5219,0.00999932941841417,0.00333310980613806,0.00111103660204602
CIV,Bagoue,2022,381013,125265,15658,0,0,521936,15658,0.0299998467245026,0.00999994890816754,0.00333331630272251
CIV,Belier,2020,359178,97958,40816,0,0,497952,40816,0.0819677398624767,0.0273225799541589,0.0091075266513863
CIV,Belier,2021,560246,103749,27666,0,0,691661,27666,0.0399993638502099,0.0133331212834033,0.00444437376113443
CIV,Belier,2022,504913,152166,34583,0,0,691662,34583,0.0499998554207113,0.0166666184735704,0.00555553949119014
CIV,Bere,2020,392998,101717,4624,0,0,499339,4624,0.00926024203997685,0.00308674734665895,0.00102891578221965
CIV,Bere,2021,432889,54111,4919,0,0,491919,4919,0.00999961375754951,0.00333320458584984,0.00111106819528328
CIV,Bere,2022,383697,98384,9838,0,0,491919,9838,0.019999227515099,0.00666640917169968,0.00222213639056656
CIV,Cavally,2021,274486,174673,49907,0,0,499066,49907,0.100000801497197,0.0333336004990656,0.0111112001663552
CIV,Cavally,2022,434187,149720,39925,0,0,623832,39925,0.0639996024570718,0.0213332008190239,0.00711106693967464
CIV,Folon,2020,99507,16961,3392,0,0,119860,3392,0.0282996829634574,0.00943322765448579,0.00314440921816193
CIV,Folon,2021,101873,14382,3596,0,0,119851,3596,0.0300039215359071,0.0100013071786357,0.00333376905954523
CIV,Folon,2022,98278,16779,4794,0,0,119851,4794,0.0399996662522632,0.0133332220840877,0.00444440736136258
CIV,Goh,2021,1049170,117884,11788,0,0,1178842,11788,0.00999964371815731,0.0033332145727191,0.0011110715242397
CIV,Goh,2022,1037382,153250,11788,0,0,1202420,11788,0.00980356281498977,0.00326785427166326,0.00108928475722109
CIV,Grands ponts,2020,277720,82565,37530,0,0,397815,37530,0.0943403340748841,0.0314467780249614,0.0104822593416538
CIV,Grands ponts,2021,234068,111278,38372,0,0,383718,38372,0.100000521216101,0.0333335070720338,0.0111111690240113
CIV,Grands ponts,2022,230231,115115,38372,0,0,383718,38372,0.100000521216101,0.0333335070720338,0.0111111690240113
CIV,Guemon,2021,918613,241740,48348,0,0,1208701,48348,0.0399999669066212,0.0133333223022071,0.00444444076740236
CIV,Guemon,2022,870265,302175,60435,0,0,1232875,60435,0.0490195680827335,0.0163398560275778,0.00544661867585927
CIV,Haut-sassandra,2021,962616,388152,201839,0,0,1552607,201839,0.130000057967019,0.0433333526556731,0.0144444508852244
CIV,Haut-sassandra,2022,1164455,388152,155261,0,0,1707868,155261,0.0909092505978214,0.0303030835326071,0.0101010278442024
CIV,Iffou,2020,314421,63680,31840,0,0,409941,31840,0.0776697134465691,0.0258899044821897,0.00862996816072991
CIV,Iffou,2021,355880,65100,13020,0,0,434000,13020,0.03,0.01,0.00333333333333333
CIV,Iffou,2022,230020,182280,21700,0,0,434000,21700,0.05,0.0166666666666667,0.00555555555555556
CIV,Indenie-djuablin,2020,549140,98061,19612,0,0,666813,19612,0.0294115441660556,0.00980384805535185,0.00326794935178395
CIV,Indenie-djuablin,2021,546413,89916,55333,0,0,691662,55333,0.0800000578317155,0.0266666859439052,0.00888889531463506
CIV,Indenie-djuablin,2022,463414,172916,55333,0,0,691663,55333,0.0799999421683681,0.026666647389456,0.00888888246315201
CIV,Kabadougou,2021,212145,11166,0,0,0,223311,0,0,0,0
CIV,Kabadougou,2022,200980,17865,4466,0,0,223311,4466,0.0199990148268558,0.00666633827561861,0.00222211275853954
CIV,Loh-djiboua,2021,714493,123493,44105,0,0,882091,44105,0.050000510151447,0.016666836717149,0.00555561223904966
CIV,Loh-djiboua,2022,785060,114672,35284,0,0,935016,35284,0.037736252641666,0.0125787508805553,0.00419291696018511
CIV,Marahoue,2020,782733,210736,30105,0,0,1023574,30105,0.0294116497683607,0.00980388325612022,0.00326796108537341
CIV,Marahoue,2021,551652,371304,137913,0,0,1060869,137913,0.130000028278704,0.0433333427595679,0.0144444475865226
CIV,Marahoue,2022,509217,392522,159130,0,0,1060869,159130,0.149999670081791,0.0499998900272638,0.0166666300090879
CIV,Me,2020,542247,27951,5590,0,0,575788,5590,0.00970843435431096,0.00323614478477032,0.00107871492825677
CIV,Me,2021,554436,23101,0,0,0,577537,0,0,0,0
CIV,Me,2022,548660,28877,0,0,0,577537,0,0,0,0
CIV,Moronou,2020,327176,109059,26174,0,0,462409,26174,0.0566035695672013,0.0188678565224004,0.00628928550746682
CIV,Moronou,2021,310646,117669,42361,0,0,470676,42361,0.0900003399366018,0.0300001133122006,0.0100000377707335
CIV,Moronou,2022,291819,131789,47068,0,0,470676,47068,0.100000849841505,0.0333336166138349,0.0111112055379449
CIV,N'zi,2020,279322,31036,6207,0,0,316565,6207,0.0196073476221313,0.00653578254071044,0.00217859418023681
CIV,N'zi,2021,292613,33634,10090,0,0,336337,10090,0.0299996729470739,0.00999989098235797,0.00333329699411932
CIV,N'zi,2022,265706,53814,16817,0,0,336337,16817,0.0500004459812628,0.0166668153270876,0.00555560510902921
CIV,Poro,2020,825360,147386,29477,0,0,1002223,29477,0.0294116179732455,0.00980387265774849,0.00326795755258283
CIV,Poro,2021,719593,214804,139622,0,0,1074019,139622,0.129999562391354,0.0433331874637848,0.0144443958212616
CIV,Poro,2022,859215,171843,42961,0,0,1074019,42961,0.040000223459734,0.0133334078199113,0.00444446927330377
CIV,Sud-comoe,2021,590866,84409,28136,0,0,703411,28136,0.0399993744766573,0.0133331248255524,0.00444437494185081
CIV,Sud-comoe,2022,604934,126614,21102,0,0,752650,21102,0.0280369361589052,0.00934564538630173,0.00311521512876724
CIV,Tchologo,2021,566522,89815,34544,0,0,690881,34544,0.0499999276286365,0.0166666425428788,0.00555554751429294
CIV,Tchologo,2022,531978,117450,41453,0,0,690881,41453,0.0600002026398179,0.020000067546606,0.00666668918220198
CIV,Tonkpi,2021,1069394,145826,0,0,0,1215220,0,0,0,0
CIV,Tonkpi,2022,1093698,121522,0,0,0,1215220,0,0,0,0
CIV,Worodougou,2021,205068,97943,3061,0,0,306072,3061,0.0100009148174286,0.00333363827247619,0.00111121275749206
CIV,Worodougou,2022,192825,122428,21425,0,0,336678,21425,0.0636364716435288,0.0212121572145096,0.0070707190715032
CMR,Bamboutos,2020,365313,55871,8596,0,0,429780,8596,0.0200009307087347,0.00666697690291157,0.00222232563430386
CMR,Bamboutos,2021,382504,79217,4298,0,0,466019,4298,0.00922279992875827,0.00307426664291942,0.00102475554763981
CMR,Bamboutos,2022,369679,96821,22005,0,0,488505,22005,0.0450455983050327,0.0150151994350109,0.00500506647833697
CMR,Boumba-et-ngoko,2020,142418,23736,3391,0,0,169545,3391,0.0200005898139137,0.00666686327130457,0.00222228775710152
CMR,Boumba-et-ngoko,2021,145809,29514,1736,0,0,177059,1736,0.00980464139072287,0.00326821379690762,0.00108940459896921
CMR,Boumba-et-ngoko,2022,147572,34723,12153,0,0,194448,12153,0.0625,0.0208333333333333,0.00694444444444444
CMR,Boyo,2020,88107,55067,38547,1836,0,183557,40383,0.220002506033548,0.0766682828767086,0.0277788370914757
CMR,Boyo,2021,108299,58268,30074,0,0,196641,30074,0.152938603851689,0.0509795346172297,0.0169931782057432
CMR,Boyo,2022,107139,65787,26315,1880,0,201121,28195,0.140189239313647,0.0498456153260972,0.0186924510341757
CMR,Bui,2020,170361,175093,118306,9465,0,473225,127771,0.270000528289926,0.0966671949565922,0.036667077558831
CMR,Bui,2021,246077,213216,145375,38767,0,643435,184142,0.286185861819764,0.115478641976268,0.0518817837940982
CMR,Bui,2022,140529,203525,135683,38767,0,518504,174450,0.336448706278062,0.137071909442036,0.0623055302691333
CMR,Bénoué,2020,1130235,209303,55814,0,0,1395352,55814,0.0399999426667966,0.0133333142222655,0.00444443807408851
CMR,Bénoué,2021,948839,457229,171461,0,0,1577529,171461,0.108689602536625,0.0362298675122084,0.0120766225040695
CMR,Bénoué,2022,1014477,500094,214326,0,0,1728897,214326,0.123966899127016,0.0413222997090052,0.0137740999030017
CMR,Diamaré,2020,582856,268299,74013,0,0,925168,74013,0.0799995244107016,0.0266665081369005,0.00888883604563351
CMR,Diamaré,2021,729477,323809,92517,0,0,1145803,92517,0.0807442466113285,0.0269147488704428,0.00897158295681427
CMR,Diamaré,2022,701055,236843,94737,0,0,1032635,94737,0.0917429682317566,0.0305809894105855,0.0101936631368618
CMR,Dja-et-lobo,2020,224633,59921,4921,0,0,289475,4921,0.0169997409102686,0.00566658030342286,0.00188886010114095
CMR,Dja-et-lobo,2021,257923,53356,1737,0,0,313016,1737,0.00554923709970097,0.00184974569990032,0.000616581899966775
CMR,Dja-et-lobo,2022,251960,59285,5928,0,0,317173,5928,0.0186901154890233,0.00623003849634111,0.00207667949878037
CMR,Djérem,2020,158756,23233,11616,0,0,193605,11616,0.0599984504532424,0.0199994834844141,0.00666649449480472
CMR,Djérem,2021,166532,27755,15488,0,0,209775,15488,0.0738314861160768,0.0246104953720256,0.00820349845734186
CMR,Djérem,2022,156619,49563,13878,0,0,220060,13878,0.0630646187403435,0.0210215395801145,0.00700717986003817
CMR,Donga-mantung,2020,158696,178533,59511,0,0,396740,59511,0.15,0.05,0.0166666666666667
CMR,Donga-mantung,2021,198370,154380,60939,0,0,413689,60939,0.147306309812444,0.0491021032708146,0.0163673677569382
CMR,Donga-mantung,2022,215319,142192,89378,16250,0,463139,105628,0.228069758754931,0.0877188058012821,0.0370366371890752
CMR,Fako,2020,383894,171381,130250,0,0,685525,130250,0.190000364684001,0.0633334548946671,0.0211111516315557
CMR,Fako,2021,459302,210593,82263,0,0,752158,82263,0.10936930804432,0.0364564360147735,0.0121521453382578
CMR,Fako,2022,456286,203574,147415,14040,0,821315,161455,0.19658109251627,0.0712252099783072,0.0275405227524695
CMR,Faro,2020,92171,18207,3414,0,0,113792,3414,0.0300021091113611,0.0100007030371204,0.00333356767904012
CMR,Faro,2021,95585,19809,2330,0,0,117724,2330,0.019792055995379,0.00659735199845967,0.00219911733281989
CMR,Faro,2022,97879,29131,8157,0,0,135167,8157,0.0603475700429839,0.0201158566809946,0.00670528556033154
CMR,Faro-et-déo,2020,103817,15380,8972,0,0,128169,8972,0.0700013263737721,0.023333775457924,0.00777792515264135
CMR,Faro-et-déo,2021,107621,20999,10254,0,0,138874,10254,0.0738367152958797,0.0246122384319599,0.00820407947731997
CMR,Faro-et-déo,2022,95809,34124,14437,0,0,144370,14437,0.1,0.0333333333333333,0.0111111111111111
CMR,Haut-nkam,2020,165987,40433,6384,0,0,212804,6384,0.0299994361008252,0.00999981203360839,0.00333327067786946
CMR,Haut-nkam,2021,178756,65373,32687,0,0,276816,32687,0.118082047280504,0.0393606824268347,0.0131202274756116
CMR,Haut-nkam,2022,156896,61015,17433,0,0,235344,17433,0.0740745461962064,0.0246915153987355,0.00823050513291182
CMR,Haut-nyong,2020,239738,43326,5777,0,0,288841,5777,0.0200006231802272,0.00666687439340906,0.00222229146446969
CMR,Haut-nyong,2021,251291,47324,5915,0,0,304530,5915,0.0194233737234427,0.00647445790781423,0.00215815263593808
CMR,Haut-nyong,2022,257322,59155,29577,0,0,346054,29577,0.0854693198171384,0.0284897732723795,0.00949659109079315
CMR,Haute-sanaga,2020,119472,22124,5900,0,0,147496,5900,0.0400010847751803,0.0133336949250601,0.00444456497502004
CMR,Haute-sanaga,2021,128380,22655,2950,0,0,153985,2950,0.0191577101665747,0.00638590338885822,0.00212863446295274
CMR,Haute-sanaga,2022,134422,18124,0,0,0,152546,0,0,0,0
CMR,Hauts-plateaux,2020,93678,21344,3557,0,0,118579,3557,0.0299968797173193,0.00999895990577308,0.0033329866352577
CMR,Hauts-plateaux,2021,105536,27928,2429,0,0,135893,2429,0.0178743570308993,0.00595811901029977,0.00198603967009992
CMR,Hauts-plateaux,2022,100783,31571,6071,0,0,138425,6071,0.0438576846667871,0.0146192282222624,0.00487307607408745
CMR,Kadey,2020,219173,45999,5412,0,0,270584,5412,0.0200011826272063,0.00666706087573545,0.00222235362524515
CMR,Kadey,2021,227291,63728,8312,0,0,299331,8312,0.0277685906237576,0.00925619687458588,0.00308539895819529
CMR,Kadey,2022,232746,47103,22166,0,0,302015,22166,0.0733937056106485,0.0244645685368828,0.00815485617896094
CMR,Koung-khi,2020,70719,19113,5734,0,0,95566,5734,0.0600004185589017,0.0200001395196339,0.0066667131732113
CMR,Koung-khi,2021,78365,23487,3823,0,0,105675,3823,0.0361769576531819,0.012058985884394,0.00401966196146466
CMR,Koung-khi,2022,80246,28380,2936,0,0,111562,2936,0.0263172047829906,0.00877240159433021,0.00292413386477674
CMR,Kupe-manenguba,2020,72934,54312,27932,0,0,155178,27932,0.179999742231502,0.0599999140771673,0.0199999713590558
CMR,Kupe-manenguba,2021,97762,52438,15890,1589,0,167679,17479,0.104240841130971,0.037905760411262,0.0147411290488241
CMR,Kupe-manenguba,2022,101698,52438,36548,7945,0,198629,44493,0.224000523589204,0.0879999060224506,0.0382220118915163
CMR,Lebialem,2020,71882,58509,35105,1672,0,167168,36777,0.220000239280245,0.0766673845074017,0.0277784424451251
CMR,Lebialem,2021,80240,59913,46218,5135,0,191506,51353,0.268153478220004,0.0983224198371504,0.038732758010483
CMR,Lebialem,2022,80454,54777,37659,11983,0,184873,49642,0.268519470122733,0.111112313137487,0.0514413197768799
CMR,Lekié,2020,344754,58860,16817,0,0,420431,16817,0.039999429157222,0.0133331430524073,0.00444438101746911
CMR,Lekié,2021,365776,73189,8409,0,0,447374,8409,0.0187963538337051,0.00626545127790171,0.00208848375930057
CMR,Lekié,2022,383165,64578,30137,0,0,477880,30137,0.0630639491085628,0.0210213163695209,0.00700710545650698
CMR,Logone-et-chari,2020,235019,315697,147325,3508,0,701549,150833,0.214999950110399,0.0733334378639268,0.0255556711727271
CMR,Logone-et-chari,2021,294539,357790,179597,14031,0,845957,193628,0.228886338194495,0.0818240958661808,0.0309604651562931
CMR,Logone-et-chari,2022,287355,287355,237068,35919,0,847697,272987,0.322033698361561,0.121468716612972,0.0499056725326253
CMR,Lom-et-djérem,2020,332381,60801,12160,0,0,405342,12160,0.0299993585663464,0.00999978618878215,0.00333326206292738
CMR,Lom-et-djérem,2021,344542,70562,8301,0,0,423405,8301,0.0196053424026641,0.00653511413422137,0.00217837137807379
CMR,Lom-et-djérem,2022,348660,107919,49809,0,0,506388,49809,0.0983613355766724,0.0327871118588908,0.0109290372862969
CMR,Manyu,2020,98453,101114,61200,5322,0,266089,66522,0.249999060464732,0.0899999624185893,0.0344446156486489
CMR,Manyu,2021,138366,98091,62669,5449,0,304575,68118,0.223649347451367,0.0805132835371693,0.0308134285479767
CMR,Manyu,2022,147136,89917,57220,10899,0,305172,68119,0.223215104924436,0.0863097968795739,0.0367064402296992
CMR,Mayo-banyo,2020,191305,63768,34783,0,0,289856,34783,0.120000965996909,0.0400003219989696,0.0133334406663232
CMR,Mayo-banyo,2021,249323,37681,14493,0,0,301497,14493,0.0480701300510453,0.0160233766836818,0.00534112556122725
CMR,Mayo-banyo,2022,234482,77171,20777,0,0,332430,20777,0.0625003760190115,0.0208334586730038,0.00694448622433461
CMR,Mayo-danay,2020,617338,114322,30486,0,0,762146,30486,0.0400002099335298,0.0133334033111766,0.0044444677703922
CMR,Mayo-danay,2021,533502,234131,70239,0,0,837872,70239,0.0838302270513873,0.0279434090171291,0.00931446967237637
CMR,Mayo-danay,2022,554110,273153,85848,15609,0,928720,101457,0.10924390559049,0.0420169695925575,0.0177405461280041
CMR,Mayo-kani,2020,378897,116584,87438,0,0,582919,87438,0.150000257325632,0.0500000857752106,0.0166666952584035
CMR,Mayo-kani,2021,429774,145729,104925,0,0,680428,104925,0.154204412516828,0.0514014708389426,0.0171338236129809
CMR,Mayo-kani,2022,495434,161165,35814,0,0,692413,35814,0.0517234656195074,0.0172411552065025,0.00574705173550083
CMR,Mayo-louti,2020,314052,224323,102548,0,0,640923,102548,0.160000499279945,0.0533334997599816,0.0177778332533272
CMR,Mayo-louti,2021,387220,243551,108957,0,0,739728,108957,0.14729332944001,0.0490977764800035,0.0163659254933345
CMR,Mayo-louti,2022,511918,249396,78757,0,0,840071,78757,0.093750409191604,0.0312501363972013,0.0104167121324004
CMR,Mayo-rey,2020,344127,184354,86032,0,0,614513,86032,0.140000292914877,0.0466667643049591,0.015555588101653
CMR,Mayo-rey,2021,515994,215080,104467,0,0,835541,104467,0.125029172715642,0.0416763909052139,0.013892130301738
CMR,Mayo-rey,2022,541165,176193,31463,0,0,748821,31463,0.0420167169457053,0.0140055723152351,0.00466852410507837
CMR,Mayo-sava,2020,231195,155805,105546,10052,0,502598,115598,0.23000091524439,0.0833336649436196,0.0322223504448663
CMR,Mayo-sava,2021,216157,190987,133812,15078,0,556034,148890,0.26777139527439,0.0982961473578954,0.0387913928524754
CMR,Mayo-sava,2022,211011,205864,144105,10293,0,571273,154398,0.27027008102956,0.0960959121120725,0.0360358941055036
CMR,Mayo-tsanaga,2020,453758,383174,171420,0,0,1008352,171420,0.170000158674749,0.0566667195582495,0.0188889065194165
CMR,Mayo-tsanaga,2021,433672,403341,289115,20167,0,1146295,309282,0.269810127410483,0.0958011099527899,0.0358433038615714
CMR,Mayo-tsanaga,2022,351068,413021,320091,30977,0,1115157,351068,0.31481486463341,0.114197672016885,0.0442388132094604
CMR,Mbam-et-inoubou,2020,227699,41652,8330,0,0,277681,8330,0.0299984514604888,0.00999948382016295,0.00333316127338765
CMR,Mbam-et-inoubou,2021,247137,39808,2777,0,0,289722,2777,0.00958505049668303,0.00319501683222768,0.00106500561074256
CMR,Mbam-et-inoubou,2022,253068,51182,2843,0,0,307093,2843,0.00925778184458779,0.00308592728152927,0.00102864242717642
CMR,Mbam-et-kim,2020,100801,38770,15508,0,0,155079,15508,0.100000644832634,0.0333335482775446,0.0111111827591815
CMR,Mbam-et-kim,2021,131804,31016,10855,0,0,173675,10855,0.0625017993378437,0.0208339331126146,0.00694464437087152
CMR,Mbam-et-kim,2022,141332,25408,0,0,0,166740,0,0,0,0
CMR,Mbéré,2020,106400,101080,53200,5320,0,266000,58520,0.22,0.08,0.0311111111111111
CMR,Mbéré,2021,193393,109060,58520,5320,0,366293,63840,0.174286704905636,0.0629368656603684,0.0242064867924494
CMR,Mbéré,2022,209736,81715,24515,0,0,315966,24515,0.0775874619421077,0.0258624873140359,0.00862082910467863
CMR,Mefou-et-afamba,2020,129661,46307,9261,0,0,185229,9261,0.049997570574802,0.0166658568582673,0.00555528561942244
CMR,Mefou-et-afamba,2021,150036,43625,5557,0,0,199218,5557,0.0278940657972673,0.00929802193242244,0.00309934064414081
CMR,Mefou-et-afamba,2022,170708,32245,3794,0,0,206747,3794,0.0183509313315308,0.00611697711051027,0.00203899237017009
CMR,Mefou-et-akono,2020,63322,19083,4337,0,0,86742,4337,0.0499988471559337,0.0166662823853112,0.00555542746177041
CMR,Mefou-et-akono,2021,75500,13324,2602,0,0,91426,2602,0.0284601754424343,0.00948672514747811,0.00316224171582604
CMR,Mefou-et-akono,2022,79942,13324,0,0,0,93266,0,0,0,0
CMR,Meme,2020,192091,182487,100848,4802,0,480228,105650,0.219999666824925,0.0766663612561811,0.0277775464061978
CMR,Meme,2021,240114,186867,122939,14753,0,564673,137692,0.243843782153565,0.0899901358839541,0.0358026287387174
CMR,Meme,2022,265547,172114,108186,14753,0,560600,122939,0.21929896539422,0.0818718040195029,0.033138700598565
CMR,Menchum,2020,83336,83336,59526,11905,0,238103,71431,0.300000419986308,0.116666596668949,0.0499998366719912
CMR,Menchum,2021,97622,95241,70707,14629,0,278199,85336,0.306744452711908,0.119776371110848,0.051610937174868
CMR,Menchum,2022,109717,80459,63392,12191,0,265759,75583,0.284404291105852,0.110092226415662,0.0468912728365842
CMR,Menoua,2020,294008,92403,33601,0,0,420012,33601,0.0800000952353742,0.0266666984117914,0.00888889947059714
CMR,Menoua,2021,373810,107523,8602,0,0,489935,8602,0.0175574310877974,0.00585247702926579,0.00195082567642193
CMR,Menoua,2022,356976,94620,25806,0,0,477402,25806,0.0540550730830621,0.018018357694354,0.00600611923145134
CMR,Mezam,2020,439102,192588,107850,30814,0,770354,138664,0.180000363469262,0.0733333852575136,0.0333333044865665
CMR,Mezam,2021,516137,315537,205099,47331,0,1084104,252430,0.232846664157682,0.0921685865316735,0.0404248833855219
CMR,Mezam,2022,386533,299760,181434,39442,0,907169,220876,0.243478337553422,0.0956521515469187,0.041545854312825
CMR,Mfoundi,2020,2295741,387233,82979,0,0,2765953,82979,0.0300001482310075,0.0100000494103358,0.00333334980344528
CMR,Mfoundi,2021,2461698,453174,84970,0,0,2999842,84970,0.0283248251074557,0.00944160836915189,0.0031472027897173
CMR,Mfoundi,2022,2407484,566467,84970,0,0,3058921,84970,0.0277777686968706,0.00925925623229019,0.00308641874409673
CMR,Mifi,2020,323445,88615,31015,0,0,443075,31015,0.0699994357614399,0.0233331452538133,0.00777771508460444
CMR,Mifi,2021,363322,104353,17723,0,0,485398,17723,0.0365123053659059,0.012170768455302,0.00405692281843399
CMR,Mifi,2022,376579,117964,22685,0,0,517228,22685,0.0438588011476564,0.0146196003825521,0.00487320012751737
CMR,Momo,2020,69309,73386,50962,10192,0,203849,61154,0.299996566085681,0.116664786189778,0.0499988826151819
CMR,Momo,2021,101924,65232,52185,6262,0,225603,58447,0.259070136478682,0.0956089531906343,0.0380378117509273
CMR,Momo,2022,112720,81409,54273,16699,0,265101,70972,0.267716832452537,0.110235972956219,0.0507433435223221
CMR,Moungo,2020,351164,122629,83610,0,0,557403,83610,0.149999192684646,0.0499997308948822,0.0166665769649607
CMR,Moungo,2021,428085,125572,66888,0,0,620545,66888,0.107789120853443,0.0359297069511478,0.0119765689837159
CMR,Moungo,2022,462332,154111,114156,5708,0,736307,119864,0.162790792427615,0.0568476645384783,0.0206719328878972
CMR,Mvila,2020,208868,49580,5274,0,0,263722,5274,0.0199983315764328,0.00666611052547759,0.00222203684182586
CMR,Mvila,2021,229438,45909,1319,0,0,276666,1319,0.00476748136742498,0.00158916045580833,0.000529720151936109
CMR,Mvila,2022,232244,54010,5401,0,0,291655,5401,0.0185184550239152,0.00617281834130508,0.00205760611376836
CMR,Ndian,2020,72066,66661,39636,1802,0,180165,41438,0.230000277523381,0.0800007400623503,0.0288895672793766
CMR,Ndian,2021,90082,64571,51657,9224,0,215534,60881,0.282465875453525,0.108420635878021,0.0456504413327931
CMR,Ndian,2022,81175,64571,42432,11069,0,199247,53501,0.268515962599186,0.108023374672308,0.0483531607613777
CMR,Ndé,2020,110132,26487,2788,0,0,139407,2788,0.0199989957462681,0.00666633191542271,0.00222211063847424
CMR,Ndé,2021,115708,35688,4182,0,0,155578,4182,0.0268804072555246,0.00896013575184152,0.00298671191728051
CMR,Ndé,2022,117057,35688,9993,0,0,162738,9993,0.0614054492497143,0.0204684830832381,0.0068228276944127
CMR,Ngo-ketunjia,2020,126666,96376,52319,0,0,275361,52319,0.1900014889545,0.0633338296514999,0.0211112765505
CMR,Ngo-ketunjia,2021,167970,90230,70492,14098,0,342790,84590,0.246769158960296,0.0959654599025643,0.0411278690224984
CMR,Ngo-ketunjia,2022,146624,98689,59214,14098,0,318625,73312,0.230088662220479,0.0914450111154701,0.0403141972886971
CMR,Nkam,2020,34551,13496,5938,0,0,53985,5938,0.109993516717607,0.0366645055725356,0.0122215018575119
CMR,Nkam,2021,44777,10797,3779,0,0,59353,3779,0.0636699071656024,0.0212233023885341,0.00707443412951138
CMR,Nkam,2022,45330,16584,8845,1106,0,71865,9951,0.138467960759758,0.051285976019852,0.0205153180732392
CMR,Noun,2020,519715,127086,20066,2007,0,668874,22073,0.0330002362178826,0.0120002671155803,0.00466688128938418
CMR,Noun,2021,555165,164382,13377,0,0,732924,13377,0.0182515513204643,0.00608385044015478,0.00202795014671826
CMR,Noun,2022,575338,178081,54794,0,0,808213,54794,0.0677964843426176,0.0225988281142059,0.00753294270473529
CMR,Nyong-et-kellé,2020,135472,43885,11448,0,0,190805,11448,0.0599984277141584,0.0199994759047195,0.00666649196823983
CMR,Nyong-et-kellé,2021,154553,54708,9769,0,0,219030,9769,0.0446011961831713,0.0148670653943904,0.00495568846479681
CMR,Nyong-et-kellé,2022,173893,35169,1954,0,0,211016,1954,0.00925996132994655,0.00308665377664885,0.00102888459221628
CMR,Nyong-et-mfoumou,2020,107522,36865,9216,0,0,153603,9216,0.0599988281478877,0.0199996093826292,0.00666653646087642
CMR,Nyong-et-mfoumou,2021,130550,25166,4608,0,0,160324,4608,0.0287417978593349,0.00958059928644495,0.00319353309548165
CMR,Nyong-et-mfoumou,2022,138415,25166,1573,0,0,165154,1573,0.00952444385240442,0.00317481461746814,0.00105827153915605
CMR,Nyong-et-so'o,2020,121010,39200,10226,0,0,170436,10226,0.0599990612311953,0.0199996870770651,0.0066665623590217
CMR,Nyong-et-so'o,2021,143112,29670,5113,0,0,177895,5113,0.0287416734590629,0.00958055781968764,0.00319351927322921
CMR,Nyong-et-so'o,2022,155329,24434,3491,0,0,183254,3491,0.0190500616630469,0.00635002055434897,0.00211667351811632
CMR,Océan,2020,231904,29745,1579,0,0,263228,1579,0.00599860197243454,0.00199953399081151,0.000666511330270505
CMR,Océan,2021,250067,64691,5391,0,0,320149,5391,0.0168390343246426,0.00561301144154753,0.00187100381384918
CMR,Océan,2022,229114,48518,18868,0,0,296500,18868,0.0636357504215852,0.0212119168071951,0.00707063893573168
CMR,Sanaga-maritime,2020,183697,42942,11928,0,0,238567,11928,0.0499985329068983,0.0166661776356328,0.00555539254521092
CMR,Sanaga-maritime,2021,197878,43973,7157,0,0,249008,7157,0.0287420484482426,0.00958068281608088,0.00319356093869363
CMR,Sanaga-maritime,2022,207650,51302,12215,0,0,271167,12215,0.0450460417381171,0.015015347246039,0.00500511574867968
CMR,Vallée-du-ntem,2020,86122,27931,2328,0,0,116381,2328,0.0200032651377802,0.00666775504592674,0.00222258501530891
CMR,Vallée-du-ntem,2021,99156,28602,1192,0,0,128950,1192,0.00924389298177588,0.00308129766059196,0.00102709922019732
CMR,Vallée-du-ntem,2022,97722,29793,11917,0,0,139432,11917,0.0854681852085605,0.0284893950695202,0.00949646502317338
CMR,Vina,2020,408828,64033,19703,0,0,492564,19703,0.0400008932849335,0.0133336310949778,0.00444454369832595
CMR,Vina,2021,423684,65570,15132,0,0,504386,15132,0.0300008326955942,0.0100002775651981,0.00333342585506603
CMR,Vina,2022,398464,110965,35307,0,0,544736,35307,0.0648148828056159,0.0216049609352053,0.00720165364506844
CMR,Wouri,2020,1845734,709898,283959,0,0,2839591,283959,0.0999999647836608,0.0333333215945536,0.0111111071981845
CMR,Wouri,2021,2300068,726935,141980,0,0,3168983,141980,0.0448030172455958,0.0149343390818653,0.00497811302728843
CMR,Wouri,2022,2500657,523393,116310,0,0,3140360,116310,0.0370371549758626,0.0123457183252875,0.00411523944176252
COD,Aketi,2018,25375,175508,10573,0,0,211456,10573,0.0500009458232446,0.0166669819410815,0.00555566064702717
COD,Aketi,2019,86612,97439,21653,10827,0,216531,32480,0.150001616396728,0.0666678982070312,0.0333342056744249
COD,Aketi,2020,86612,97439,32480,0,0,216531,32480,0.150001616396728,0.0500005387989095,0.0166668462663032
COD,Aketi,2021,56762,147581,56762,11352,0,272457,68114,0.249999082424016,0.0972214575755685,0.0416661059257873
COD,Aketi,2022,23250,139498,58124,11625,0,232497,69749,0.299999569886923,0.116666738352179,0.0500001672661965
COD,Ango,2018,8531,87441,10664,0,0,106636,10664,0.100003751078435,0.0333345836928117,0.0111115278976039
COD,Ango,2021,11450,57250,34350,11450,0,114500,45800,0.4,0.166666666666667,0.0777777777777778
COD,Ango,2022,11725,52761,41036,11725,0,117247,52761,0.449998720649569,0.183333759783477,0.0833340440835729
COD,Aru,2018,76569,373275,430702,76569,0,957115,507271,0.530000052240326,0.203333281093007,0.0855554917062677
COD,Aru,2019,245022,245022,392035,98009,0,980088,490044,0.5,0.200000068021103,0.0888889569099918
COD,Aru,2020,301082,401443,392035,147013,0,1241573,539048,0.434165369253359,0.184191344367186,0.0877101511997728
COD,Aru,2021,411078,411078,256924,51385,0,1130465,308309,0.272727594396996,0.106060780298373,0.0454546482101515
COD,Aru,2022,473561,420943,157854,0,0,1052358,157854,0.150000285074091,0.0500000950246969,0.0166666983415656
COD,Bafwasende,2018,40516,151403,21324,0,0,213243,21324,0.0999985931542888,0.0333328643847629,0.011110954794921
COD,Bafwasende,2020,67081,89441,55901,11180,0,223603,67081,0.300000447221191,0.116666592129801,0.0499998260806479
COD,Bafwasende,2021,68691,114485,68691,22897,0,274764,91588,0.333333333333333,0.138888888888889,0.0648148148148148
COD,Bafwasende,2022,58616,105509,58616,11723,0,234464,70339,0.299999146990583,0.116666097993722,0.0499996208847035
COD,Bagata,2019,172802,246860,74058,0,0,493720,74058,0.15,0.05,0.0166666666666667
COD,Bagata,2020,172802,246860,74058,0,0,493720,74058,0.15,0.05,0.0166666666666667
COD,Bagata,2021,197159,281656,140828,28166,0,647809,168994,0.260870102144305,0.101449655685549,0.0434785218757038
COD,Bambesa,2018,12812,110185,5125,0,0,128122,5125,0.0400009366072962,0.0133336455357654,0.0044445485119218
COD,Bambesa,2019,26239,72158,26239,6560,0,131196,32799,0.25,0.100000508145574,0.044444952590018
COD,Bambesa,2020,40304,71500,26000,6717,0,144521,32717,0.226382325060026,0.0909533331949451,0.0406461498482727
COD,Bambesa,2021,40304,89421,34393,6879,0,170997,41272,0.241360959548998,0.0938632451641452,0.040227476375479
COD,Bambesa,2022,21131,77480,35218,7044,0,140873,42262,0.300000709859235,0.116667731455519,0.0500009070423557
COD,Banalia,2018,75561,169360,15633,0,0,260554,15633,0.0599990788857588,0.0199996929619196,0.00666656432063987
COD,Banalia,2019,53362,120064,66702,26681,0,266809,93383,0.349999437800074,0.149999937533342,0.0722222846888807
COD,Banalia,2020,81963,122945,80042,13661,0,298611,93703,0.313796209784636,0.119848230641202,0.0501157395779496
COD,Banalia,2021,125895,139884,68303,13988,0,348070,82291,0.236420834889534,0.0922027178441118,0.0396647545353266
COD,Banalia,2022,100268,114592,57296,14324,0,286480,71620,0.25,0.1,0.0444444444444444
COD,Bandalungwa,2021,123563,118811,23762,11881,0,278017,35643,0.128204390379006,0.0569797290573358,0.0284898645286679
COD,Bandalungwa,2022,99516,124395,12440,12440,0,248791,24880,0.100003617494202,0.050001808747101,0.0277787826372783
COD,Bandundu,2021,125419,41806,31355,10452,0,209032,41807,0.200002870373914,0.0833349279855078,0.0388898456801936
COD,Bandundu,2022,129182,75356,10765,0,0,215303,10765,0.0499993033074319,0.0166664344358106,0.00555547814527021
COD,Barumbu,2021,89366,79436,29789,9930,0,208521,39719,0.190479615961942,0.0793669062908132,0.0370381027437151
COD,Barumbu,2022,103962,72773,31189,0,0,207924,31189,0.150001923779843,0.0500006412599476,0.0166668804199825
COD,Bas-uele,2017,0,1073758,160447,0,0,1234205,160447,0.130000283583359,0.0433334278611198,0.0144444759537066
COD,Basankusu,2018,94628,246033,37851,0,0,378512,37851,0.0999994716151668,0.0333331572050556,0.0111110524016852
COD,Basankusu,2020,40079,280550,60118,20039,0,400786,80157,0.199999500980573,0.083332917483811,0.0388885839325725
COD,Basankusu,2021,144342,268065,103102,20620,0,536129,123722,0.230769087290559,0.0897433266993578,0.0384613073014558
COD,Basankusu,2022,148528,169747,106092,0,0,424367,106092,0.250000589112726,0.0833335297042419,0.0277778432347473
COD,Basoko,2018,86600,214769,45032,0,0,346401,45032,0.1299996247124,0.0433332082374666,0.0144444027458222
COD,Basoko,2019,120603,166716,53207,14189,0,354715,67396,0.190000422874702,0.0766671835135249,0.0344448673191467
COD,Basoko,2020,0,0,0,0,0,0,0,,,
COD,Basoko,2021,111584,204570,37195,18597,0,371946,55792,0.150000268856232,0.0666664874291788,0.0333330943500162
COD,Basoko,2022,114262,171393,76175,19044,0,380874,95219,0.250001312770102,0.100000700144055,0.0444448528618097
COD,Befale,2019,95966,127955,79972,15994,0,319887,95966,0.299999687389609,0.116666197751081,0.0499996005533899
COD,Befale,2020,49375,164582,115207,0,0,329164,115207,0.349998784800282,0.116666261600094,0.038888753866698
COD,Befale,2021,118549,169355,115207,16936,0,420047,132143,0.314590986246777,0.118303427949729,0.0483943198948901
COD,Befale,2022,69707,104560,156840,17427,0,348534,174267,0.5,0.183333620249387,0.0722225091382763
COD,Beni,2018,437638,802336,145879,72940,0,1458793,218819,0.150000034274911,0.0666667580664289,0.0333334171164487
COD,Beni,2019,602773,527427,301387,75347,0,1506934,376734,0.250000331799535,0.100000176959752,0.0444445476709663
COD,Beni,2020,678120,622664,389165,233499,0,1923448,622664,0.323722814445725,0.148372956620957,0.0764345534107961
COD,Beni,2021,723613,700497,321606,321606,0,2067322,643212,0.311132953647279,0.155566476823639,0.0864258204575775
COD,Beni,2022,498329,747493,332219,83055,0,1661096,415274,0.25,0.100000040134144,0.0444444845785888
COD,Beni-ville,2020,210766,126459,84306,0,0,421531,84306,0.199999525539047,0.0666665085130156,0.0222221695043386
COD,Beni-ville,2021,174177,210766,87088,21772,0,493803,108860,0.220452285628074,0.0881809142512297,0.039191517444991
COD,Beni-ville,2022,134944,224906,67472,22491,0,449813,89963,0.200000889258425,0.0833338891198491,0.0388892470624213
COD,Bikoro,2018,16354,278023,32709,0,0,327086,32709,0.100001222919966,0.033333740973322,0.0111112469911073
COD,Bikoro,2021,142550,178188,106913,17819,0,445470,124732,0.280000897928031,0.106667115630682,0.0444446938688975
COD,Bikoro,2022,128349,146684,73342,18336,0,366711,91678,0.250000681735754,0.100000636286704,0.0444449292343138
COD,Boende,2019,98505,140722,42216,0,0,281443,42216,0.149998401097203,0.0499994670324009,0.0166664890108003
COD,Boende,2020,72401,159283,57921,0,0,289605,57921,0.2,0.0666666666666667,0.0222222222222222
COD,Boende,2021,104301,173763,74501,0,0,352565,74501,0.211311389389191,0.0704371297963969,0.0234790432654656
COD,Boende,2022,91994,107326,107326,0,0,306646,107326,0.349999673891067,0.116666557963689,0.038888852654563
COD,Bokungu,2019,305360,213752,91608,0,0,610720,91608,0.15,0.05,0.0166666666666667
COD,Bokungu,2020,188529,345637,62843,31422,0,628431,94265,0.150000556942608,0.0666670910038917,0.0333336339055344
COD,Bokungu,2021,290994,323327,161664,31422,0,807407,193086,0.239143331677828,0.0926868357594125,0.0395438731643397
COD,Bokungu,2022,166352,332704,166352,0,0,665408,166352,0.25,0.0833333333333333,0.0277777777777778
COD,Bolobo,2021,46294,92587,46294,0,0,185175,46294,0.250001350074254,0.0833337833580847,0.0277779277860282
COD,Bolomba,2018,91303,273910,91303,0,0,456516,91303,0.199999561899254,0.0666665206330848,0.0222221735443616
COD,Bolomba,2019,140927,258366,46976,23488,0,469757,70464,0.150000957942085,0.0666670924187044,0.0333335462093522
COD,Bolomba,2020,0,0,0,0,0,0,0,,,
COD,Bolomba,2021,74610,248699,174089,0,0,497398,174089,0.349999396861266,0.116666465620422,0.038888821873474
COD,Bolomba,2022,153546,230319,127955,0,0,511820,127955,0.25,0.0833333333333333,0.0277777777777778
COD,Boma,2021,73748,73748,36874,0,0,184370,36874,0.2,0.0666666666666667,0.0222222222222222
COD,Boma,2022,76255,85787,28596,0,0,190638,28596,0.150001573663173,0.050000524554391,0.0166668415181303
COD,Bomongo,2020,51742,113832,31045,10348,0,206967,41393,0.199998067324743,0.0833321254112975,0.0388881104502436
COD,Bomongo,2021,95836,124180,42594,10648,0,273258,53242,0.194841505097746,0.0779361140997397,0.034638001855796
COD,Bomongo,2022,65744,98615,54786,0,0,219145,54786,0.249998859202811,0.0833329530676036,0.0277776510225345
COD,Bondo,2018,31077,207183,20718,0,0,258978,20718,0.0799990732803559,0.0266663577601186,0.00888878592003954
COD,Bondo,2019,26520,159117,53039,26520,0,265196,79559,0.300000754159188,0.133334087492521,0.066667253234924
COD,Bondo,2020,26520,145857,66299,26520,0,265196,92819,0.350001508318376,0.150001005545584,0.0722228925859448
COD,Bondo,2021,55615,194654,83423,27808,0,361500,111231,0.307692946058091,0.128205624711849,0.0598294144767174
COD,Bondo,2022,56950,99663,99663,28475,0,284751,128138,0.450000175592009,0.183333274802664,0.0833332357822175
COD,Bongandanga,2018,494406,266219,0,0,0,760625,0,0,0,0
COD,Bongandanga,2019,234805,469610,78268,0,0,782683,78268,0.0999996167030586,0.0333332055676862,0.0111110685225621
COD,Bongandanga,2020,0,0,0,0,0,0,0,,,
COD,Bongandanga,2021,41437,662990,124311,0,0,828738,124311,0.150000361996192,0.0500001206653973,0.0166667068884658
COD,Bosobolo,2018,119646,170405,72513,0,0,362564,72513,0.200000551626747,0.0666668505422491,0.022222283514083
COD,Bosobolo,2019,186540,130578,37308,18654,0,373080,55962,0.15,0.0666666666666667,0.0333333333333333
COD,Bosobolo,2020,167886,172754,93270,37308,0,471218,130578,0.27710741100722,0.118760319003094,0.0571808943348231
COD,Bosobolo,2021,134364,217267,98758,39503,0,489892,138261,0.282227511369853,0.120954550526783,0.0582373257779266
COD,Bosobolo,2022,121946,203244,60973,20324,0,406487,81297,0.19999901595869,0.0833327183075145,0.0388884925389168
COD,Budjala,2018,212466,394579,0,0,0,607045,0,0,0,0
COD,Budjala,2019,124930,406023,93698,0,0,624651,93698,0.150000560312879,0.0500001867709596,0.0166667289236532
COD,Budjala,2020,0,0,0,0,0,0,0,,,
COD,Budjala,2021,330703,363773,132281,33070,0,859827,165351,0.192307289722235,0.0769228383539169,0.0341878850823092
COD,Budjala,2022,238205,204176,170147,68059,0,680587,238206,0.350000808125927,0.150000416307296,0.0722224589459785
COD,Bukama,2018,605997,385635,110181,0,0,1101813,110181,0.0999997277214918,0.0333332425738306,0.0111110808579435
COD,Bukama,2019,286196,515153,286196,57239,0,1144784,343435,0.299999825294553,0.116666550196369,0.0499999223531348
COD,Bukama,2020,286196,572392,228957,57239,0,1144784,286196,0.25,0.0999999417648511,0.0444443862092956
COD,Bukama,2021,308954,679699,247163,0,0,1235816,247163,0.19999983816361,0.0666666127212034,0.0222222042404011
COD,Bukama,2022,321004,642007,321004,0,0,1284015,321004,0.250000194701775,0.0833333982339251,0.0277777994113084
COD,Bukavu,2020,435825,387400,145275,0,0,968500,145275,0.15,0.05,0.0166666666666667
COD,Bukavu,2021,450207,550254,145275,0,0,1145736,145275,0.126796225308448,0.0422654084361493,0.0140884694787164
COD,Bukavu,2022,671760,310043,51674,0,0,1033477,51674,0.050000145141111,0.016666715047037,0.00555557168234567
COD,Bulungu,2021,446728,574365,191455,63818,0,1276366,255273,0.199999843305134,0.0833332027542779,0.0388887931309149
COD,Bulungu,2022,525862,591595,131466,65733,0,1314656,197199,0.150000456393155,0.066666869508069,0.0333334347540345
COD,Bumba,2018,284519,663878,0,0,0,948397,0,0,0,0
COD,Bumba,2019,341565,585541,48795,0,0,975901,48795,0.0499999487652949,0.0166666495884316,0.00555554986281054
COD,Bumba,2020,439155,487951,150630,50210,0,1127946,200840,0.178058169451374,0.0741909039380727,0.0346224218377673
COD,Bumba,2021,413330,568328,200840,50210,0,1232708,251050,0.203657313816411,0.0814629255265643,0.036205744678473
COD,Bumbu,2020,155256,284637,77628,0,0,517521,77628,0.149999710156689,0.0499999033855631,0.0166666344618544
COD,Bumbu,2021,216738,258761,108369,27092,0,610960,135461,0.221718279429095,0.0886872026537471,0.039416473891726
COD,Bumbu,2022,170193,283656,113462,0,0,567311,113462,0.199999647459683,0.0666665491532275,0.0222221830510758
COD,Businga,2018,178005,335068,10471,0,0,523544,10471,0.0200002292070963,0.00666674306903208,0.00222224768967736
COD,Businga,2019,188554,269364,80809,0,0,538727,80809,0.149999907188613,0.049999969062871,0.0166666563542903
COD,Businga,2020,166305,277175,107745,27718,0,578943,135463,0.233983310964983,0.0939534058908505,0.0419571145652988
COD,Businga,2021,313734,277175,142606,57043,0,790558,199649,0.252541875485417,0.108232413055083,0.0521119962805456
COD,Businga,2022,322832,176090,88045,0,0,586967,88045,0.149999914816336,0.0499999716054452,0.0166666572018151
COD,Buta,2018,75355,185696,8074,0,0,269125,8074,0.0300009289363679,0.010000309645456,0.00333343654848532
COD,Buta,2021,57794,187832,115589,14449,0,375664,130038,0.346155074747647,0.128205879012451,0.0512825290685293
COD,Buta,2022,44386,177544,59181,14795,0,295906,73976,0.249998310274209,0.0999990988129113,0.044443918751976
COD,Butembo,2020,280685,400978,120293,0,0,801956,120293,0.149999501219518,0.0499998337398394,0.0166666112466131
COD,Butembo,2021,331368,497052,124263,41421,0,994104,165684,0.166666666666667,0.0694444444444445,0.0324074074074074
COD,Butembo,2022,256727,513455,42788,42788,0,855758,85576,0.100000233710932,0.0500001168554662,0.0277778426974812
COD,Dekese,2019,39409,86699,23645,7882,0,157635,31527,0.2,0.0833338619807361,0.0388894175362916
COD,Dekese,2020,40631,97513,23645,8126,0,169915,31771,0.186981726157196,0.0782685460377248,0.0367170513361256
COD,Dekese,2021,58646,75402,56883,16756,0,207687,73639,0.354567209310164,0.145082102715464,0.0662893895354281
COD,Dekese,2022,51826,86377,25913,8638,0,172754,34551,0.200001157715596,0.0833342980963297,0.0388895963817529
COD,Demba,2018,75649,453896,151299,75649,0,756493,226948,0.30000013218893,0.13333324520738,0.0666665491653958
COD,Demba,2019,233984,311978,155989,77995,0,779946,233984,0.300000256428009,0.133333589761342,0.0666668661106738
COD,Demba,2020,272981,350975,281443,80412,0,985811,361855,0.36706326060472,0.14954421621724,0.0679746027495241
COD,Demba,2021,165810,373073,331620,124358,0,994861,455978,0.458333375215231,0.19444458405077,0.09259272289183
COD,Demba,2022,213688,341901,170950,128213,0,854752,299163,0.349999766014002,0.166666666666667,0.0888889408857774
COD,Dibaya,2018,86268,316318,143781,28756,0,575123,172537,0.300000173875849,0.116666637687358,0.0499999323816142
COD,Dibaya,2019,148238,237181,88943,118590,0,592952,207533,0.34999966270457,0.183332996037903,0.105555293214665
COD,Dibaya,2020,207533,266828,213967,122267,0,810595,336234,0.414799005668676,0.188545039960358,0.0963674831450971
COD,Dibaya,2021,126057,220600,252114,126057,0,724828,378171,0.521738950482046,0.23188397799202,0.11594198899601
COD,Dibaya,2022,129965,259929,162456,97473,0,649823,259929,0.399999692223882,0.183332999909206,0.0944441794150099
COD,Dilolo,2018,184845,254162,23106,0,0,462113,23106,0.0500007573905084,0.0166669191301695,0.00555563971005649
COD,Dilolo,2019,168047,264074,48014,0,0,480135,48014,0.10000104137378,0.0333336804579268,0.0111112268193089
COD,Dilolo,2020,120034,324259,74829,0,0,519122,74829,0.144145306883546,0.0480484356278486,0.0160161452092829
COD,Dilolo,2021,207326,324259,129579,25916,0,687080,155495,0.226312802002678,0.0880106149696299,0.037718881191257
COD,Dilolo,2022,80779,296191,134632,26926,0,538528,161558,0.299999257234536,0.11666617148969,0.0499996698820158
COD,Dimbelenge,2018,31541,157706,78853,47312,0,315412,126165,0.400000634091284,0.183333756060856,0.0944447262627928
COD,Dimbelenge,2019,65038,130075,65038,65038,0,325189,130076,0.400001230053907,0.200000615026954,0.111111452792752
COD,Dimbelenge,2020,81297,184858,161750,92429,0,520334,254179,0.488492007057006,0.222041996102503,0.113488216756502
COD,Dimbelenge,2021,95294,207965,166765,71471,0,541495,238236,0.439959741087175,0.190649344253717,0.0928805129010117
COD,Dimbelenge,2022,98248,221058,98248,73686,0,491240,171934,0.35,0.166666666666667,0.0888888888888889
COD,Djolu,2019,129643,185205,55561,0,0,370409,55561,0.149999055098553,0.0499996850328511,0.016666561677617
COD,Djolu,2020,133403,152460,76230,19058,0,381151,95288,0.250000655908026,0.100000612180824,0.0444449108679296
COD,Djolu,2021,156881,215712,98051,19058,0,489702,117109,0.239143397413121,0.092686981061952,0.0395440038590363
COD,Djolu,2022,141252,161431,100894,0,0,403577,100894,0.249999380539525,0.0833331268465084,0.0277777089488361
COD,Djugu,2018,173623,173623,954925,434057,0,1736228,1388982,0.799999769615511,0.34999992320517,0.172222196623946
COD,Djugu,2019,355579,711158,355579,355579,0,1777895,711158,0.4,0.2,0.111111111111111
COD,Djugu,2020,182057,711158,728226,364113,0,1985554,1092339,0.550143184219618,0.244508081875386,0.122254040937693
COD,Djugu,2021,372852,652491,838917,372852,0,2237112,1211769,0.541666666666667,0.236111111111111,0.115740740740741
COD,Djugu,2022,381800,381800,763600,381800,0,1909000,1145400,0.6,0.266666666666667,0.133333333333333
COD,Dungu,2018,29616,157950,9872,0,0,197438,9872,0.0500005064881127,0.0166668354960376,0.00555561183201253
COD,Dungu,2019,40435,111197,40435,10109,0,202176,50544,0.25,0.1000003297457,0.0444447741901446
COD,Dungu,2020,82812,121306,51757,10351,0,266226,62108,0.233290512572025,0.0907236708661062,0.0388813347389895
COD,Dungu,2021,82812,95399,63599,10600,0,252410,74199,0.293962204350065,0.1119857903147,0.0466608560146851
COD,Dungu,2022,54272,97689,54272,10854,0,217087,65126,0.299999539355189,0.116665975699451,0.0499994113982976
COD,Equateur,2017,0,1760742,112388,0,0,1873130,112388,0.0600001067731551,0.0200000355910517,0.00666667853035057
COD,Faradje,2018,166998,166998,37111,0,0,371107,37111,0.100000808392189,0.0333336027973963,0.0111112009324654
COD,Faradje,2019,95003,190006,76002,19001,0,380012,95003,0.25,0.100000350866113,0.0444447953105574
COD,Faradje,2020,136197,116740,116740,19457,0,389134,136197,0.350000256980886,0.133333675974514,0.0555558410898731
COD,Faradje,2021,136197,139465,139465,39847,0,454974,179312,0.394114828539653,0.160565219111422,0.07298414610261
COD,Faradje,2022,102009,142813,142813,20402,0,408037,163215,0.400000490151628,0.150000285921783,0.0611112881103103
COD,Feshi,2019,56298,206427,93831,18766,0,375322,112597,0.300001065751541,0.116666933104552,0.0500000296042095
COD,Feshi,2020,93831,168895,75064,37532,0,375322,112596,0.299998401372688,0.133332622832306,0.0666663114161529
COD,Feshi,2021,99545,159271,199089,59727,0,517632,258816,0.5,0.205128353733927,0.0940172426228157
COD,Feshi,2022,143543,123037,102531,41012,0,410123,143543,0.349999878085355,0.149999715532495,0.0722219648468603
COD,Fizi,2018,239990,359985,159993,39998,0,799966,199991,0.249999374973436,0.0999996666524994,0.0444442499917358
COD,Fizi,2019,289228,371865,165273,0,0,826366,165273,0.19999975797649,0.0666665859921633,0.0222221953307211
COD,Fizi,2020,289228,330546,213409,170727,0,1003910,384136,0.38263987807672,0.184233978477486,0.0992028944604375
COD,Fizi,2021,220452,440904,264542,128046,0,1053944,392588,0.372494174263528,0.164662132586425,0.0818856494167516
COD,Fizi,2022,182181,500998,182181,45545,0,910905,227726,0.24999972554767,0.0999998170317797,0.0444443224656309
COD,Gbadolite,2020,79503,71552,7950,0,0,159005,7950,0.0499984277223987,0.0166661425741329,0.0055553808580443
COD,Gbadolite,2021,79503,79503,0,0,0,159006,0,0,0,0
COD,Gemena,2018,165300,619875,41325,0,0,826500,41325,0.05,0.0166666666666667,0.00555555555555556
COD,Gemena,2019,482747,543091,181030,0,0,1206868,181030,0.149999834281794,0.049999944760598,0.0166666482535327
COD,Gemena,2020,558194,418646,348872,69774,0,1395486,418646,0.300000143319245,0.116666642780126,0.049999944264738
COD,Gemena,2021,600059,511152,348872,127788,0,1587871,476660,0.300188113518038,0.126888561266417,0.0601800915957419
COD,Gemena,2022,394482,525976,328735,65747,0,1314940,394482,0.3,0.116666666666667,0.05
COD,Goma,2020,382096,429858,143286,0,0,955240,143286,0.15,0.05,0.0166666666666667
COD,Goma,2021,542720,542720,98676,49338,0,1233454,148014,0.119999610848885,0.053333160377282,0.026666580188641
COD,Goma,2022,407730,509663,50966,50966,0,1019325,101932,0.0999995094793123,0.0499997547396561,0.0277776415220312
COD,Gombe,2021,99051,17480,5827,0,0,122358,5827,0.0476225502214812,0.0158741834071604,0.00529139446905347
COD,Gombe,2022,109806,12201,0,0,0,122007,0,0,0,0
COD,Gungu,2021,225322,313883,174379,69752,0,783336,244131,0.311655534789669,0.133566779347134,0.0643099938383189
COD,Gungu,2022,174061,145051,145051,116041,0,580204,261092,0.450000344706345,0.216666896470896,0.116666819869487
COD,Haut-katanga,2017,0,1882257,163675,0,0,2045932,163675,0.0800002150609111,0.026666738353637,0.00888891278454568
COD,Haut-lomami,2017,0,3450906,181627,0,0,3632533,181627,0.0500000963514991,0.016666698783833,0.00555556626127768
COD,Haut-uele,2017,0,1633443,68060,0,0,1701503,68060,0.0399999294741179,0.013333309824706,0.00444443660823532
COD,Idiofa,2021,524434,706123,294218,131108,0,1655883,425326,0.256857519522817,0.112011537047002,0.0549320882641534
COD,Idiofa,2022,540166,472646,270083,67521,0,1350416,337604,0.25,0.100000049367504,0.044444493811948
COD,Idjwi,2018,121427,134919,13492,0,0,269838,13492,0.050000370592726,0.0166667901975753,0.00555559673252511
COD,Idjwi,2019,83623,139371,55748,0,0,278742,55748,0.199998564981237,0.066666188327079,0.022222062775693
COD,Idjwi,2020,97560,143970,57588,13937,0,313055,71525,0.228474229767932,0.0909978544771153,0.0402258034175748
COD,Idjwi,2021,104105,178465,44616,0,0,327186,44616,0.136362802809411,0.0454542676031371,0.015151422534379
COD,Idjwi,2022,122903,168992,15363,0,0,307258,15363,0.0500003254593859,0.0166667751531286,0.00555559171770955
COD,Ikela,2019,85738,205770,51443,0,0,342951,51443,0.150001020553957,0.0500003401846522,0.0166667800615507
COD,Ikela,2020,123514,141159,70579,17645,0,352897,88224,0.249999291577996,0.0999999055437328,0.0444445074152893
COD,Ikela,2021,127096,181566,90783,36313,0,435758,127096,0.291666475429023,0.124999808762356,0.0601850364447953
COD,Ikela,2022,130782,149465,93416,0,0,373663,93416,0.25000066905206,0.0833335563506868,0.0277778521168956
COD,Ilebo,2018,81673,163346,217795,81673,0,544487,299468,0.550000275488671,0.233333394553038,0.111111111111111
COD,Ilebo,2019,224547,112273,196478,28068,0,561366,224546,0.399999287452393,0.149999584347229,0.061110853802253
COD,Ilebo,2020,168410,231508,231508,28938,0,660364,260446,0.394397635243593,0.146072973895205,0.0584290549521846
COD,Ilebo,2021,208849,260446,208849,59671,0,737815,268520,0.363939469921322,0.148271585695601,0.0673961479353075
COD,Ilebo,2022,184563,276844,123042,30760,0,615209,153802,0.249999593634033,0.0999996207250978,0.0444441554730904
COD,Ingende,2021,114849,143561,71781,14356,0,344547,86137,0.250000725590413,0.0972223431539577,0.0416666263560882
COD,Ingende,2022,103407,118180,73862,0,0,295449,73862,0.249999153830272,0.0833330512767573,0.0277776837589191
COD,Inongo,2019,158468,217894,19809,0,0,396171,19809,0.0500011358731457,0.0166670452910486,0.00555568176368285
COD,Inongo,2020,0,0,0,0,0,0,0,,,
COD,Inongo,2021,126089,168119,126089,0,0,420297,126089,0.29999976207301,0.0999999206910034,0.0333333068970011
COD,Inongo,2022,129872,194808,108227,0,0,432907,108227,0.250000577491239,0.0833335258304131,0.0277778419434711
COD,Irumu,2018,68727,171817,343633,103090,0,687267,446723,0.649999199728781,0.266666375658951,0.122222109052555
COD,Irumu,2019,140795,168954,140795,112636,0,563180,253431,0.45,0.216666666666667,0.116666666666667
COD,Irumu,2020,201710,352993,352993,112636,0,1020332,465629,0.456350481999977,0.188914000541,0.0875027823187834
COD,Irumu,2021,201710,403420,464741,201710,0,1271581,666451,0.524112109256115,0.227580468723581,0.111111111111111
COD,Irumu,2022,158631,211509,475894,211509,0,1057543,687403,0.650000047279401,0.283333475171538,0.138889020220559
COD,Isangi,2018,120105,366035,85789,0,0,571929,85789,0.149999388035928,0.0499997960119758,0.0166665986706586
COD,Isangi,2019,70279,404102,81992,29283,0,585656,111275,0.190000614695316,0.0800003187309046,0.0377779599097233
COD,Isangi,2020,70279,404102,81992,29283,0,585656,111275,0.190000614695316,0.0800003187309046,0.0377779599097233
COD,Isangi,2021,214937,307053,153526,30705,0,706221,184231,0.260868764876717,0.10144888545276,0.0434780488134891
COD,Isangi,2022,220095,251538,125769,31442,0,628844,157211,0.25,0.0999998939853657,0.0444443384298102
COD,Ituri,2017,0,4651595,418121,104530,0,5174246,522651,0.101010079536226,0.0404040189301655,0.017957334588782
COD,Kabalo,2018,38963,116889,77926,25975,0,259753,103901,0.399999230037767,0.166666025031472,0.0777773072453019
COD,Kabalo,2019,40483,107954,67471,53977,0,269885,121448,0.44999907367953,0.216666357893177,0.11666656374217
COD,Kabalo,2020,53977,112164,80966,56082,0,303189,137048,0.452021676248149,0.212331801835379,0.111882540446901
COD,Kabalo,2021,56082,145674,101971,56082,0,359809,158053,0.439269167808476,0.198378398909792,0.100763028285686
COD,Kabalo,2022,60542,136220,75678,30271,0,302711,105949,0.350000495522132,0.150000055058015,0.0722221671642076
COD,Kabambare,2018,89452,201267,89452,67089,0,447260,156541,0.35,0.166666666666667,0.0888888888888889
COD,Kabambare,2019,161707,184808,92404,23101,0,462020,115505,0.25,0.1,0.0444444444444444
COD,Kabambare,2020,138606,214769,119316,92404,0,565095,211720,0.37466266733912,0.179394025193404,0.0961356546735996
COD,Kabambare,2021,172555,190906,172555,98603,0,634619,271158,0.427276838544071,0.194216792542717,0.099266383977368
COD,Kabambare,2022,178249,203714,101857,25464,0,509284,127321,0.25,0.0999998690972686,0.044444313541713
COD,Kabare,2018,284710,488074,40673,0,0,813457,40673,0.0500001843981919,0.0166667281327306,0.00555557604424355
COD,Kabare,2019,294105,336120,168060,42015,0,840300,210075,0.25,0.1,0.0444444444444444
COD,Kabare,2020,294105,420151,210075,42015,0,966346,252090,0.260869295262773,0.101449170379967,0.0434782158771289
COD,Kabare,2021,325613,596957,162806,0,0,1085376,162806,0.149999631464119,0.0499998771547064,0.0166666257182355
COD,Kabare,2022,336358,616656,168179,0,0,1121193,168179,0.150000044595355,0.0500000148651184,0.0166666716217061
COD,Kabeya-kamwanga,2018,39340,98351,39340,19670,0,196701,59010,0.299998474842528,0.133332655485568,0.0666663277427839
COD,Kabeya-kamwanga,2019,20359,101793,40717,40717,0,203586,81434,0.399998035228356,0.199999017614178,0.11111056534121
COD,Kabeya-kamwanga,2020,42142,63214,81434,50897,0,237687,132331,0.556744794624864,0.256959783244351,0.133238717772159
COD,Kabeya-kamwanga,2021,43617,65426,98139,43617,0,250799,141756,0.565217564663336,0.246376580448885,0.120772677190366
COD,Kabeya-kamwanga,2022,33858,67716,90288,33858,0,225720,124146,0.55,0.233333333333333,0.111111111111111
COD,Kabinda,2018,289759,331153,68990,0,0,689902,68990,0.0999997101037539,0.0333332367012513,0.0111110789004171
COD,Kabinda,2019,178512,428429,107107,0,0,714048,107107,0.149999719906785,0.049999906635595,0.0166666355451983
COD,Kabinda,2020,221712,464132,110856,0,0,796700,110856,0.139143968871595,0.0463813229571984,0.0154604409857328
COD,Kabinda,2021,382453,443424,152981,38245,0,1017103,191226,0.188010457151341,0.0752041173148967,0.0334240157257098
COD,Kabinda,2022,395839,237503,118752,39584,0,791678,158336,0.200000505255925,0.0833335438566353,0.0388889871330965
COD,Kabongo,2018,387035,348331,38703,0,0,774069,38703,0.0499994186564764,0.0166664728854921,0.00555549096183071
COD,Kabongo,2020,83562,250687,334250,167125,0,835624,501375,0.600000718026289,0.266666985789462,0.133333492894731
COD,Kabongo,2021,434107,477517,292468,125344,0,1329436,417812,0.314277633522787,0.136187074819698,0.0663476007035231
COD,Kabongo,2022,315726,451037,135311,0,0,902074,135311,0.14999988914435,0.0499999630481165,0.0166666543493722
COD,Kahemba,2019,83649,250948,83649,0,0,418246,83649,0.199999521812522,0.0666665072708406,0.0222221690902802
COD,Kahemba,2020,41825,250948,83649,41825,0,418247,125474,0.299999760906833,0.133333492728778,0.0666668791939266
COD,Kahemba,2021,88744,199673,155301,66558,0,510276,221859,0.43478235307951,0.18840588230683,0.0917875816224945
COD,Kahemba,2022,114258,159961,114258,68555,0,457032,182813,0.40000043760612,0.183333625070746,0.0944446389360531
COD,Kailo,2020,31498,86618,31498,7874,0,157488,39372,0.25,0.0999991533746486,0.0444435978190931
COD,Kailo,2021,56940,105745,40671,8134,0,211490,48805,0.230767412170788,0.0897426198244204,0.0384609726753563
COD,Kailo,2022,58819,75624,25208,8403,0,168054,33611,0.20000119009366,0.0833343250780503,0.038889616168348
COD,Kalamu,2021,288773,288773,36097,18048,0,631691,54145,0.085714376174427,0.0380951024050261,0.0190474632551534
COD,Kalamu,2022,151172,188966,37793,0,0,377931,37793,0.0999997354014357,0.0333332451338119,0.0111110817112706
COD,Kalehe,2018,281033,361328,120443,40148,0,802952,160591,0.200000747242675,0.0833337484681525,0.0388891379697804
COD,Kalehe,2019,248834,331779,82945,165890,0,829448,248835,0.300000723372653,0.166667068540363,0.100000241124218
COD,Kalehe,2020,290307,373252,237949,190359,0,1091867,428308,0.392271219846373,0.188871294153348,0.101699911965265
COD,Kalehe,2021,221274,531056,237949,47590,0,1037869,285539,0.275120463179843,0.106991344765091,0.0458534640584591
COD,Kalehe,2022,274290,457151,137145,45715,0,914301,182860,0.199999781253657,0.0833332421890238,0.0388888463548778
COD,Kalemie,2018,100278,133704,233982,200556,0,668520,434538,0.65,0.316666666666667,0.172222222222222
COD,Kalemie,2019,138919,347297,138919,69459,0,694594,208378,0.29999971206201,0.133333045395344,0.0666664427148969
COD,Kalemie,2020,138919,347297,180421,144337,0,810974,324758,0.400454268570879,0.19281136016691,0.103821522706715
COD,Kalemie,2021,187457,360842,224948,112474,0,885721,337422,0.380957434677511,0.169314415412227,0.0846572077061136
COD,Kalemie,2022,194768,311628,194768,77907,0,779071,272675,0.350000192537009,0.150000021393001,0.0722222008292212
COD,Kambove,2018,280034,606740,46672,0,0,933446,46672,0.0499996786102249,0.0166665595367416,0.00555551984558055
COD,Kambove,2021,314092,680532,157046,0,0,1151670,157046,0.13636371530039,0.0454545717667966,0.0151515239222655
COD,Kambove,2022,271951,652683,163171,0,0,1087805,163171,0.150000229820602,0.0500000766068674,0.0166666922022891
COD,Kamiji,2018,25582,40931,30698,5116,0,102327,35814,0.349995602333695,0.133330727308856,0.0555539267902574
COD,Kamiji,2019,31773,26477,31773,15886,0,105909,47659,0.449999527896591,0.199998741057575,0.0999988459694434
COD,Kamiji,2020,32885,54808,31773,15886,0,135352,47659,0.352111531414386,0.156493193057115,0.0782461860761406
COD,Kamiji,2021,65770,45381,17018,11345,0,139514,28363,0.203298593689522,0.0948721992058145,0.0496947339414762
COD,Kamiji,2022,52841,35227,23485,5871,0,117424,29356,0.25,0.0999994322568924,0.0444438767013368
COD,Kamina,2018,520121,109161,12843,0,0,642125,12843,0.0200007786645902,0.00666692622153008,0.00222230874051003
COD,Kamina,2019,400301,233509,33358,0,0,667168,33358,0.049999400450861,0.0166664668169537,0.00555548893898455
COD,Kamina,2020,400301,311935,207957,34659,0,954852,242616,0.254087544457152,0.0967951054194786,0.0403312066512227
COD,Kamina,2021,288090,432134,138638,34659,0,893521,173297,0.193948435459267,0.0775792249613234,0.0344795726370418
COD,Kamina,2022,224494,411572,112247,0,0,748313,112247,0.15000006681696,0.0500000222723201,0.0166666740907734
COD,Kamonia,2018,407655,407655,815311,407655,0,2038276,1222966,0.600000196244277,0.266666699374046,0.133333322430874
COD,Kamonia,2019,148785,396760,247975,198380,0,991900,446355,0.45,0.216666666666667,0.116666666666667
COD,Kamonia,2020,284730,759280,569460,284730,0,1898200,854190,0.45,0.2,0.1
COD,Kamonia,2021,397905,928444,795809,530539,0,2652697,1326348,0.499999811512585,0.233333220240884,0.122222151015865
COD,Kamonia,2022,546986,957226,683733,546986,0,2734931,1230719,0.450000018281997,0.21666664838467,0.116666644322004
COD,Kananga,2020,211896,529740,264870,52974,0,1059480,317844,0.3,0.116666666666667,0.05
COD,Kananga,2021,273081,546162,273081,163848,0,1256172,436929,0.347825775451132,0.159420047573103,0.0821254308061847
COD,Kananga,2022,281546,506783,225237,112619,0,1126185,337856,0.300000443976789,0.133333629317859,0.066666863989684
COD,Kaniama,2018,177809,118539,0,0,0,296348,0,0,0,0
COD,Kaniama,2021,99717,199435,33239,0,0,332391,33239,0.0999996991494956,0.0333332330498319,0.0111110776832773
COD,Kaniama,2022,86339,207212,51803,0,0,345354,51803,0.149999710442039,0.0499999034806797,0.0166666344935599
COD,Kapanga,2018,50891,178120,25446,0,0,254457,25446,0.100001178981125,0.0333337263270415,0.0111112421090138
COD,Kapanga,2019,37013,166560,44945,15863,0,264381,60808,0.230001399495425,0.0966673096780782,0.0455558875679837
COD,Kapanga,2020,66095,145410,39657,13219,0,264381,52876,0.199999243515986,0.083333018131661,0.0388887417947751
COD,Kapanga,2021,85622,156973,71351,42811,0,356757,114162,0.319999327273186,0.146666591919243,0.0755556303029793
COD,Kapanga,2022,88961,118614,74134,14827,0,296536,88961,0.300000674454366,0.116667116302911,0.0500002997574962
COD,Kasa vubu,2021,138990,104243,17374,0,0,260607,17374,0.0666674341057608,0.0222224780352536,0.00740749267841787
COD,Kasa vubu,2022,63666,100047,18190,0,0,181903,18190,0.0999983507693661,0.0333327835897887,0.0111109278632629
COD,Kasai,2017,0,3372414,463707,379397,0,4215518,843104,0.200000094887508,0.0966667283435472,0.0522222628129897
COD,Kasai central,2017,0,2169312,723104,394420,0,3286836,1117524,0.33999992698145,0.153333276541128,0.0777777372119165
COD,Kasai oriental,2017,0,1379112,268658,143284,0,1791054,411942,0.229999765501208,0.10333319561182,0.052222136611552
COD,Kasangulu,2021,142804,129822,38947,12982,0,324555,51929,0.160000616228374,0.0666666666666667,0.0311109741714724
COD,Kasangulu,2022,147660,80542,40271,0,0,268473,40271,0.150000186238467,0.0500000620794891,0.0166666873598297
COD,Kasenga,2018,159261,218984,19908,0,0,398153,19908,0.0500008790590552,0.0166669596863517,0.00555565322878391
COD,Kasenga,2020,69289,346446,207868,69289,0,692892,277157,0.400000288645272,0.166666666666667,0.0777777136343839
COD,Kasenga,2021,179979,467944,242512,35996,0,926431,278508,0.300624655263047,0.113159713639404,0.0463542346920602
COD,Kasenga,2022,74799,523594,149598,0,0,747991,149598,0.199999732617104,0.0666665775390346,0.0222221925130115
COD,Kasongo,2018,158061,379345,94836,0,0,632242,94836,0.149999525498148,0.049999841832716,0.0166666139442387
COD,Kasongo,2019,228587,261242,130621,32655,0,653105,163276,0.249999617213159,0.0999997448087725,0.0444442743169594
COD,Kasongo,2020,228587,261242,130621,32655,0,653105,163276,0.249999617213159,0.0999997448087725,0.0444442743169594
COD,Kasongo,2021,348461,243922,174230,34846,0,801459,209076,0.260869239724053,0.101449148781576,0.0434782066206755
COD,Kasongo,2022,251972,251972,179980,35996,0,719920,215976,0.3,0.116666666666667,0.05
COD,Kasongo-Lunda,2019,151392,416327,189240,0,0,756959,189240,0.250000330268879,0.0833334434229595,0.0277778144743198
COD,Kasongo-Lunda,2020,0,0,0,0,0,0,0,,,
COD,Kasongo-lunda,2021,80306,401528,321222,80306,0,883362,401528,0.45454524872023,0.18181825042659,0.0808081951554277
COD,Katako-kombe,2018,127536,159421,31884,0,0,318841,31884,0.0999996863640498,0.0333332287880166,0.0111110762626722
COD,Katako-kombe,2019,99000,132000,82500,16500,0,330000,99000,0.3,0.116666666666667,0.05
COD,Katako-kombe,2020,99000,541141,295168,98389,0,1033698,393557,0.38072725302748,0.158636274811405,0.0740302185830764
COD,Katako-kombe,2021,123726,590335,245973,49195,0,1009229,295168,0.29246880539501,0.11373797885977,0.0487449109942122
COD,Katako-kombe,2022,73175,182938,91469,18294,0,365876,109763,0.300000546633286,0.116667031088857,0.0500002429481269
COD,Katanda,2018,124381,290221,0,0,0,414602,0,0,0,0
COD,Katanda,2019,85823,171645,128734,42911,0,429113,171645,0.3999995339223,0.166666278268584,0.0777774929525168
COD,Katanda,2020,85823,222066,133239,42911,0,484039,176150,0.363916957104696,0.150856301523913,0.0699858666117583
COD,Katanda,2021,183870,244272,183870,68951,0,680963,252821,0.371269804673675,0.157508312982252,0.0750039119436576
COD,Katanda,2022,142729,237882,71365,23788,0,475764,95153,0.200000420376489,0.0833333333333333,0.0388887954718913
COD,Kazumba,2018,180561,496544,180561,45140,0,902806,225701,0.24999944617116,0.0999997046246185,0.0444442721421386
COD,Kazumba,2019,139619,418857,186159,186159,0,930794,372318,0.40000042974063,0.200000214870315,0.111111230483508
COD,Kazumba,2020,186159,511937,335877,95965,0,1129938,431842,0.382182031226492,0.155703823277619,0.0707744830050656
COD,Kazumba,2021,247350,395759,395759,148410,0,1187278,544169,0.458333263144773,0.194444491236818,0.0925926549824239
COD,Kazumba,2022,204014,459032,204014,153011,0,1020071,357025,0.350000147048588,0.166666830053986,0.0888890195987447
COD,Kenge,2019,138349,415047,138349,0,0,691745,138349,0.2,0.0666666666666667,0.0222222222222222
COD,Kenge,2020,0,0,0,0,0,0,0,,,
COD,Kenge,2021,256855,440323,183468,110081,0,990727,293549,0.296296557982169,0.135802631131819,0.0699589515802257
COD,Kenge,2022,188972,188972,264561,113383,0,755888,377944,0.5,0.216666578470179,0.105555467359068
COD,Kibombo,2021,119019,97379,54100,21640,0,292138,75740,0.259261034168783,0.111111871786621,0.0534983086380029
COD,Kibombo,2022,67062,89416,44708,22354,0,223540,67062,0.3,0.133333333333333,0.0666666666666667
COD,Kikwit,2021,208569,182498,104284,26071,0,521422,130355,0.249999041083805,0.0999996164335222,0.0444442739704543
COD,Kikwit,2022,187973,241679,80560,26853,0,537065,107413,0.2,0.0833331781689988,0.0388887337245543
COD,Kimbanseke,2020,307556,738134,184533,0,0,1230223,184533,0.149999634212659,0.0499998780708863,0.0166666260236288
COD,Kimbanseke,2021,772826,615112,193206,128804,0,1709948,322010,0.188315668078795,0.0878806451034379,0.0460327188637055
COD,Kimbanseke,2022,404574,606861,202287,134858,0,1348580,337145,0.25,0.116666666666667,0.0611111111111111
COD,Kimvula,2021,35816,49247,13431,0,0,98494,13431,0.136363636363636,0.0454545454545455,0.0151515151515152
COD,Kimvula,2022,27775,46292,18517,0,0,92584,18517,0.200002160200467,0.0666673867334889,0.0222224622444963
COD,Kindu,2021,149577,134619,59831,14958,0,358985,74789,0.208334610081201,0.0833340297412613,0.0370374497232165
COD,Kindu,2022,154513,108159,30903,15451,0,309026,46354,0.150000323597367,0.0666664509350885,0.0333330456912291
COD,Kinshasa,2021,131321,109435,32830,0,0,273586,32830,0.119998830349506,0.0399996101165021,0.0133332033721674
COD,Kinshasa,2022,91662,114578,22916,0,0,229156,22916,0.100001745535792,0.0333339151785974,0.0111113050595325
COD,Kintambo,2021,109489,61587,13686,6843,0,191605,20529,0.107142297956734,0.0476187990918817,0.0238093995459409
COD,Kintambo,2022,57317,71647,14329,0,0,143293,14329,0.0999979063876114,0.0333326354625371,0.0111108784875124
COD,Kipushi,2018,164676,139819,6214,0,0,310709,6214,0.0199994206798001,0.00666647355993336,0.00222215785331112
COD,Kipushi,2021,121974,226524,52275,0,0,400773,52275,0.130435433524714,0.0434784778415712,0.0144928259471904
COD,Kipushi,2022,90523,235359,36209,0,0,362091,36209,0.0999997238263309,0.0333332412754436,0.0111110804251479
COD,Kiri,2019,88952,98836,9884,0,0,197672,9884,0.0500020235541705,0.0166673411847235,0.00555578039490784
COD,Kiri,2020,0,0,0,0,0,0,0,,,
COD,Kiri,2021,73398,104855,52427,10485,0,241165,62912,0.260867041237327,0.101447833087996,0.0434773794797015
COD,Kiri,2022,75600,118800,21600,0,0,216000,21600,0.1,0.0333333333333333,0.0111111111111111
COD,Kisangani,2021,411776,366023,137259,0,0,915058,137259,0.150000327848071,0.0500001092826903,0.0166667030942301
COD,Kisangani,2022,421659,374808,93702,46851,0,937020,140553,0.15,0.0666666666666667,0.0333333333333333
COD,Kisenso,2020,108178,351577,81133,0,0,540888,81133,0.149999630237683,0.0499998767458944,0.0166666255819648
COD,Kisenso,2021,283155,351577,56631,0,0,691363,56631,0.0819121069539446,0.0273040356513149,0.00910134521710496
COD,Kisenso,2022,237171,266817,88939,0,0,592927,88939,0.149999915672587,0.0499999718908623,0.0166666572969541
COD,Kole,2018,37025,129588,18513,0,0,185126,18513,0.100002160690557,0.0333340535635189,0.0111113511878396
COD,Kole,2019,47901,114963,19161,9580,0,191605,28741,0.150001304767621,0.0666666666666667,0.0333330433849731
COD,Kole,2020,67062,105383,19161,0,0,191606,19161,0.100002087617298,0.033334029205766,0.0111113430685887
COD,Kole,2021,102626,123151,51313,20525,0,297615,71838,0.241378962753893,0.10344796689235,0.0498081973914845
COD,Kole,2022,53109,116840,31865,10622,0,212436,42487,0.199999058539984,0.0833333333333333,0.0388890981022258
COD,Kongo central,2017,0,3317595,0,0,0,3317595,0,0,0,0
COD,Kongolo,2018,75976,151951,227927,50650,0,506504,278577,0.549999605136386,0.216666271803053,0.0944441373283001
COD,Kongolo,2019,131564,263129,105251,26313,0,526257,131564,0.249999524946937,0.0999999366595915,0.0444444866713834
COD,Kongolo,2020,164034,236816,136695,54678,0,592223,191373,0.323143478047965,0.138490062020556,0.0666804002321198
COD,Kongolo,2021,170432,255647,198837,56811,0,681727,255648,0.375000550073563,0.152778164866582,0.0694447092946786
COD,Kongolo,2022,118052,295131,118052,59026,0,590261,177078,0.29999949175026,0.13333310744456,0.0666665537222799
COD,Kungu,2019,237318,166122,71195,0,0,474635,71195,0.149999473279467,0.0499998244264891,0.016666608142163
COD,Kungu,2020,0,0,0,0,0,0,0,,,
COD,Kungu,2021,226154,276411,100513,25128,0,628206,125641,0.199999681633095,0.0799997665309363,0.0355553928346929
COD,Kungu,2022,129285,232713,129285,25857,0,517140,155142,0.3,0.116666666666667,0.05
COD,Kutu,2019,212192,238716,79572,0,0,530480,79572,0.15,0.05,0.0166666666666667
COD,Kutu,2020,0,0,0,0,0,0,0,,,
COD,Kutu,2021,309532,281393,104995,20999,0,716919,125994,0.175743703263549,0.06834477349138,0.0292906172105914
COD,Kutu,2022,173032,194661,64887,0,0,432580,64887,0.15,0.05,0.0166666666666667
COD,Kwamouth,2021,48651,76451,27800,0,0,152902,27800,0.181815803586611,0.0606052678622037,0.0202017559540679
COD,Kwamouth,2022,50110,71586,21476,0,0,143172,21476,0.150001396921186,0.0500004656403952,0.0166668218801317
COD,Kwango,2017,0,2019218,275348,0,0,2294566,275348,0.120000034864981,0.0400000116216603,0.0133333372072201
COD,Kwilu,2017,0,3391275,552068,0,0,3943343,552068,0.139999994928161,0.0466666649760537,0.0155555549920179
COD,Lemba,2021,252655,147382,42109,0,0,442146,42109,0.0952377721386148,0.031745924046205,0.0105819746820683
COD,Lemba,2022,286574,110221,44088,0,0,440883,44088,0.0999993195473629,0.0333331065157876,0.0111110355052625
COD,Libenge,2018,39433,197166,138016,19717,0,394332,157733,0.400000507186838,0.150000507186838,0.0611115055897625
COD,Libenge,2019,121730,223172,60865,0,0,405767,60865,0.149999876776574,0.0499999589255246,0.0166666529751749
COD,Libenge,2020,135546,202884,112955,22591,0,473976,135546,0.285976505139501,0.111213085332028,0.0476627508565835
COD,Libenge,2021,158137,203319,85929,64446,0,511831,150375,0.293798148216892,0.139903600993297,0.0746151236117651
COD,Libenge,2022,132631,176841,110526,22105,0,442103,132631,0.300000226191634,0.116666628968061,0.0499999120365867
COD,Limete,2021,311806,259838,51968,25984,0,649596,77952,0.120000738920806,0.0533336617425805,0.0266668308712903
COD,Limete,2022,77108,141364,25703,12851,0,257026,38554,0.150000389065698,0.0666664072895349,0.0333329874971577
COD,Lingwala,2021,111856,181766,41946,0,0,335568,41946,0.125,0.0416666666666667,0.0138888888888889
COD,Lingwala,2022,47113,58892,11778,0,0,117783,11778,0.0999974529431242,0.0333324843143747,0.0111108281047916
COD,Lisala,2018,67286,571931,33643,0,0,672860,33643,0.05,0.0166666666666667,0.00555555555555556
COD,Lisala,2019,207712,450042,34619,0,0,692373,34619,0.0500005055078693,0.0166668351692898,0.00555561172309659
COD,Lisala,2020,142490,427471,106868,35623,0,712452,142491,0.200000842161998,0.0833338012011102,0.038889169609555
COD,Lisala,2021,183278,513178,146622,36656,0,879734,183278,0.208333428058936,0.0833335227845387,0.0370372054381084
COD,Lisala,2022,113156,452623,150874,37719,0,754372,188593,0.25,0.100000176747458,0.0444446211919024
COD,Lodja,2018,121070,423745,60535,0,0,605350,60535,0.1,0.0333333333333333,0.0111111111111111
COD,Lodja,2019,219288,313269,93981,0,0,626538,93981,0.150000478821716,0.0500001596072385,0.0166667198690795
COD,Lodja,2020,219288,250615,156634,0,0,626537,156634,0.249999600981267,0.083333200327089,0.027777733442363
COD,Lomami,2017,0,2784294,117233,29308,0,2930835,146541,0.0499997441002308,0.0199998748934462,0.00888882064895044
COD,Lomela,2018,40593,142075,20296,0,0,202964,20296,0.09999802920715,0.0333326764023833,0.0111108921341278
COD,Lomela,2019,100832,77725,21007,10503,0,210067,31510,0.149999761980701,0.0666660319485371,0.0333327515083812
COD,Lomela,2020,105034,108710,76097,10871,0,300712,86968,0.289206948841416,0.108452605815531,0.0441843949618831
COD,Lomela,2021,112515,101264,65226,22503,0,301508,87729,0.290967403849981,0.121867413136633,0.0572079900588597
COD,Lomela,2022,81517,116454,23291,11645,0,232907,34936,0.149999785322038,0.0666660941921024,0.0333328085649828
COD,Lualaba,2017,0,1758742,35893,0,0,1794635,35893,0.020000167164911,0.00666672238830366,0.00222224079610122
COD,Lubao,2018,257269,240491,61521,0,0,559281,61521,0.110000160920897,0.0366667203069656,0.0122222401023219
COD,Lubao,2019,144714,347314,86828,0,0,578856,86828,0.149999308981854,0.049999769660618,0.0166665898868727
COD,Lubao,2020,144714,347314,86828,0,0,578856,86828,0.149999308981854,0.049999769660618,0.0166665898868727
COD,Lubao,2021,186026,279038,93013,62009,0,620086,155022,0.250000806339766,0.116667150470526,0.061111415728356
COD,Lubao,2022,160447,352983,96268,32089,0,641787,128357,0.199999376740258,0.0833329437959946,0.0388886378537151
COD,Lubefu,2018,21223,360783,42445,0,0,424451,42445,0.0999997644015446,0.0333332548005149,0.011111084933505
COD,Lubefu,2019,43931,263583,109826,21965,0,439305,131791,0.299998861838586,0.11666609758596,0.0499996838440517
COD,Lubefu,2020,43931,263583,109826,21965,0,439305,131791,0.299998861838586,0.11666609758596,0.0499996838440517
COD,Lubefu,2021,141179,235298,141179,23530,0,541186,164709,0.304348227781206,0.115942270002057,0.0483093304951224
COD,Lubefu,2022,121767,170473,170473,24353,0,487066,194826,0.399999178756062,0.149999520941036,0.0611108145508001
COD,Lubero,2018,526510,601726,300863,75216,0,1504315,376079,0.250000166188598,0.100000110792398,0.0444445183060433
COD,Lubero,2019,543885,621582,310791,77698,0,1553956,388489,0.25,0.100000042901258,0.0444444873457021
COD,Lubero,2020,621582,642094,321047,160524,0,1745247,481571,0.275932862225232,0.122636891320636,0.061318477492807
COD,Lubero,2021,663284,746194,331642,160524,0,1901644,492166,0.258810797394255,0.114408024495296,0.0568945139632398
COD,Lubero,2022,599525,770818,256939,85646,0,1712928,342585,0.19999964972258,0.0833331387347668,0.038888772129749
COD,Lubudi,2018,152143,260817,21735,0,0,434695,21735,0.0500005751158859,0.016666858371962,0.00555561945732065
COD,Lubudi,2019,158077,203242,90330,0,0,451649,90330,0.200000442821749,0.0666668142739163,0.0222222714246388
COD,Lubudi,2020,158077,347591,115864,28966,0,650498,144830,0.222644804442135,0.089057921776854,0.0395812985674907
COD,Lubudi,2021,361147,347591,115864,30096,0,854698,145960,0.170773770384393,0.0686620693313116,0.0307123425792242
COD,Lubudi,2022,375232,156347,93808,0,0,625387,93808,0.149999920049505,0.0499999733498351,0.0166666577832784
COD,Lubumbashi,2021,833576,1945010,0,0,0,2778586,0,0,0,0
COD,Lubumbashi,2022,577390,2165213,144348,0,0,2886951,144348,0.0500001558737921,0.0166667186245974,0.00555557287486579
COD,Lubutu,2019,64608,86144,53840,10768,0,215360,64608,0.3,0.116666666666667,0.05
COD,Lubutu,2020,0,0,0,0,0,0,0,,,
COD,Lubutu,2021,91923,103413,45961,34471,0,275768,80432,0.291665457921151,0.138888485973717,0.0740739397690168
COD,Lubutu,2022,83087,94956,47478,11870,0,237391,59348,0.250001053114903,0.100000982907243,0.0444451933261534
COD,Luebo,2018,0,165065,185698,61899,0,412662,247597,0.599999515341854,0.249999596118211,0.116666370486688
COD,Luebo,2019,63818,170182,106364,85091,0,425455,191455,0.45000058760621,0.216666862535403,0.116666731956246
COD,Luebo,2020,106364,175458,131593,65797,0,479212,197390,0.411905377995543,0.18306928874903,0.0915347603055757
COD,Luebo,2021,90448,180897,180897,90448,0,542690,271345,0.5,0.222222017480821,0.11111090636971
COD,Luebo,2022,116566,209818,93252,46626,0,466262,139878,0.299998713169849,0.133332761408822,0.0666663807044108
COD,Luilu,2018,447336,322082,89467,35787,0,894672,125254,0.139999910581755,0.0600000149030408,0.0288889236626508
COD,Luilu,2019,366694,366694,137510,45837,0,916735,183347,0.2,0.0833334242356479,0.0388889797912035
COD,Luilu,2020,366694,412531,332087,94882,0,1206194,426969,0.35398037131672,0.144214225351256,0.0655519206142074
COD,Luilu,2021,441914,426969,196406,147305,0,1212594,343711,0.283451014931626,0.134976752317758,0.0719876378885083
COD,Luilu,2022,355740,406560,152460,101640,0,1016400,254100,0.25,0.116666666666667,0.0611111111111111
COD,Luiza,2018,167779,461391,167779,41945,0,838894,209724,0.250000596022859,0.100000317878858,0.0444446298737783
COD,Luiza,2019,216225,389204,172980,86490,0,864899,259470,0.30000034686131,0.133333487493915,0.0666667437469577
COD,Luiza,2020,259469,432449,312099,89171,0,1093188,401270,0.367064036560957,0.149544573607955,0.0679747877055202
COD,Luiza,2021,183871,367741,367741,183871,0,1103224,551612,0.5,0.222222322937137,0.111111211826026
COD,Luiza,2022,236963,331749,236963,142178,0,947853,379141,0.399999788996817,0.183333280582538,0.0944444385832449
COD,Lukolela,2020,67458,96369,28911,0,0,192738,28911,0.150001556517137,0.0500005188390458,0.0166668396130153
COD,Lukolela,2021,89247,106005,59498,9916,0,264666,69414,0.262270182040761,0.0999120904586661,0.0416298277829415
COD,Lukolela,2022,71427,81631,51020,0,0,204078,51020,0.250002450043611,0.083334150014537,0.0277780500048456
COD,Lukula,2021,105746,193867,105746,0,0,405359,105746,0.260869994252009,0.0869566647506696,0.0289855549168899
COD,Lukula,2022,127564,145788,91118,0,0,364470,91118,0.250001371855022,0.0833337906183408,0.0277779302061136
COD,Luozi,2018,113120,226239,37707,0,0,377066,37707,0.100001060822243,0.0333336869407478,0.0111112289802493
COD,Luozi,2019,90109,128728,38618,0,0,257455,38618,0.149999028956517,0.0499996763188389,0.0166665587729463
COD,Luozi,2020,154473,90109,12873,0,0,257455,12873,0.0500009710434833,0.0166669903478278,0.00555566344927593
COD,Luozi,2021,96341,165155,55052,13763,0,330311,68815,0.20833396405206,0.083333585620824,0.0370371491648107
COD,Luozi,2022,85385,142309,56923,0,0,284617,56923,0.199998594602571,0.0666661982008571,0.0222220660669524
COD,Lupatapata,2018,50589,286670,0,0,0,337259,0,0,0,0
COD,Lupatapata,2019,69813,226891,34906,17453,0,349063,52359,0.149998710834434,0.0666660937041929,0.0333330468520964
COD,Lupatapata,2020,72256,226891,90320,18064,0,407531,108384,0.265952774144789,0.103426078834085,0.0443254623574648
COD,Lupatapata,2021,93482,180641,149570,56089,0,479782,205659,0.428650928963571,0.181852035577269,0.0865962735853645
COD,Lupatapata,2022,96754,135455,143195,11610,0,387014,154805,0.399998449668487,0.143332454812143,0.0544439104413679
COD,Lusambo,2018,17466,130997,26199,0,0,174662,26199,0.149998282396858,0.0499994274656193,0.0166664758218731
COD,Lusambo,2019,81349,36155,45194,18078,0,180776,63272,0.3500022126831,0.150001475122066,0.0722232056369331
COD,Lusambo,2020,54233,63271,45194,18078,0,180776,63272,0.3500022126831,0.150001475122066,0.0722232056369331
COD,Lusambo,2021,121211,190475,86580,34632,0,432898,121212,0.28000129360727,0.120000554403116,0.0577780447126113
COD,Lusambo,2022,107532,125454,107532,17922,0,358440,125454,0.35,0.133333333333333,0.0555555555555556
COD,Madimba,2021,318587,227562,68269,0,0,614418,68269,0.111111653629939,0.0370372178766464,0.0123457392922155
COD,Madimba,2022,188239,211769,70590,0,0,470598,70590,0.150000637486772,0.0500002124955907,0.0166667374985302
COD,Mahagi,2018,200566,735407,334276,66855,0,1337104,401131,0.299999850423004,0.116666566948669,0.049999933521335
COD,Mahagi,2019,342299,410759,547678,68460,0,1369196,616138,0.449999853928875,0.166666666666667,0.0666666991269167
COD,Mahagi,2020,280411,616138,410759,280411,0,1587719,691170,0.435322623209775,0.203978369808092,0.107240009094808
COD,Mahagi,2021,210308,490720,646067,280411,0,1627506,926478,0.569262417465742,0.247185775864011,0.12068301642718
COD,Mahagi,2022,147016,514557,735081,73508,0,1470162,808589,0.549999931980285,0.199999954653523,0.0777777475467934
COD,Mai-ndombe,2017,0,1762664,0,0,0,1762664,0,0,0,0
COD,Makala,2020,96029,230469,57617,0,0,384115,57617,0.149999349153248,0.0499997830510828,0.0166665943503609
COD,Makala,2021,160867,241301,60325,0,0,462493,60325,0.130434406574802,0.0434781355249341,0.0144927118416447
COD,Makala,2022,189482,168428,63161,0,0,421071,63161,0.150000831213738,0.0500002770712461,0.0166667590237487
COD,Makanza,2020,32909,72399,26327,0,0,131635,26327,0.2,0.0666666666666667,0.0222222222222222
COD,Makanza,2021,54180,78980,27090,6773,0,167023,33863,0.202744532190177,0.08109861116932,0.0360442706826139
COD,Makanza,2022,48783,62721,27876,0,0,139380,27876,0.2,0.0666666666666667,0.0222222222222222
COD,Malemba-nkulu,2018,479924,287954,143977,47992,0,959847,191969,0.199999583266917,0.0833330728751561,0.0388887210380636
COD,Malemba-nkulu,2019,199456,498640,199456,99728,0,997280,299184,0.3,0.133333333333333,0.0666666666666667
COD,Malemba-nkulu,2020,149592,448776,299184,99728,0,997280,398912,0.4,0.166666666666667,0.0777777777777778
COD,Malemba-nkulu,2021,362360,645950,414126,155297,0,1577733,569423,0.360912144196768,0.153114204579186,0.0729115058687933
COD,Malemba-nkulu,2022,223714,615214,279643,0,0,1118571,279643,0.250000223499447,0.083333407833149,0.0277778026110497
COD,Maluku,2021,144592,144592,48197,0,0,337381,48197,0.1428562959977,0.0476187653325666,0.0158729217775222
COD,Maluku,2022,151388,151388,33642,0,0,336418,33642,0.100000594498511,0.0333335314995036,0.0111111771665012
COD,Mambasa,2018,53951,161852,107901,35967,0,359671,143868,0.399998887872528,0.16666620328022,0.0777775615307693
COD,Mambasa,2019,73661,128906,147321,18415,0,368303,165736,0.449999049695495,0.166666214140712,0.0666664253194909
COD,Mambasa,2020,75429,150858,132000,55245,0,413532,187245,0.452794463306346,0.195462503506379,0.0948415116605245
COD,Mambasa,2021,96549,154478,154478,38620,0,444125,193098,0.434783000281452,0.173913500328361,0.0772950558213716
COD,Mambasa,2022,79093,118639,158186,39546,0,395464,197732,0.5,0.19999966284331,0.0888885517321987
COD,Maniema,2017,0,1916216,170330,42583,0,2129129,212913,0.100000046967563,0.0400000814104422,0.0177778487509838
COD,Manono,2018,108537,180895,253252,180895,0,723579,434147,0.599999447192359,0.283333264232378,0.150000053745187
COD,Manono,2019,187950,263129,150360,150360,0,751799,300720,0.400000532057106,0.200000266028553,0.111111258904752
COD,Manono,2020,187950,273391,195280,156224,0,812845,351504,0.432436688421532,0.208210257388145,0.112113215516693
COD,Manono,2021,202895,324632,243474,162316,0,933317,405790,0.434782608695652,0.202898550724638,0.106280193236715
COD,Manono,2022,126485,463778,168647,84323,0,843233,252970,0.300000118591184,0.133333254272544,0.0666665612522807
COD,Masi-manimba,2021,306381,561699,204254,51064,0,1123398,255318,0.227272970042674,0.0909093067045992,0.0404042022506716
COD,Masina,2020,457101,228551,76184,0,0,761836,76184,0.100000525047386,0.0333335083491285,0.0111111694497095
COD,Masina,2021,380918,358938,159528,39882,0,939266,199410,0.212304075735734,0.0849216302942936,0.0377429467974638
COD,Masina,2022,292296,417565,125270,0,0,835131,125270,0.150000419095926,0.0500001396986421,0.0166667132328807
COD,Masisi,2018,384257,512342,192128,192128,0,1280855,384256,0.299999609635751,0.149999804817876,0.0833332248988198
COD,Masisi,2019,529250,463093,264625,66156,0,1323124,330781,0.25,0.0999999496141959,0.0444443940586403
COD,Masisi,2020,412869,1032172,412869,206434,0,2064344,619303,0.299999903116922,0.133333236450256,0.0666665913131618
COD,Masisi,2021,639740,1032172,639740,106623,0,2418275,746363,0.30863446051421,0.117574993194185,0.0489895575243602
COD,Masisi,2022,550710,1211561,330426,110142,0,2202839,440568,0.200000090791928,0.0833333711633034,0.0388889065428749
COD,Matadi,2021,140641,158221,52740,0,0,351602,52740,0.149999146762533,0.0499997155875109,0.0166665718625036
COD,Matadi,2022,163601,145423,54534,0,0,363558,54534,0.150000825177826,0.0500002750592753,0.0166667583530918
COD,Matete,2021,169695,169695,75420,18855,0,433665,94275,0.217391304347826,0.0869565217391304,0.0386473429951691
COD,Matete,2022,157930,177671,59224,0,0,394825,59224,0.15000063319192,0.0500002110639735,0.0166667370213245
COD,Mbandaka,2021,105026,252062,63016,0,0,420104,63016,0.150000952145183,0.0500003173817277,0.0166667724605759
COD,Mbandaka,2022,86457,280987,64843,0,0,432287,64843,0.149999884336101,0.0499999614453669,0.0166666538151223
COD,Mbanza-ngungu,2020,363303,254312,108991,0,0,726606,108991,0.150000137626169,0.0500000458753896,0.0166666819584632
COD,Mbanza-ngungu,2021,435963,413221,112697,37566,0,999447,150263,0.150346141416203,0.0626443089695268,0.0292340553214817
COD,Mbanza-ngungu,2022,310742,388428,77686,0,0,776856,77686,0.10000051489594,0.0333335049653132,0.0111111683217711
COD,Mbuji-mayi,2020,1028265,1542398,685510,171378,0,3427551,856888,0.250000072938375,0.100000068075817,0.0444444963117333
COD,Mbuji-mayi,2021,1064255,1713776,886879,354752,0,4019662,1241631,0.308889404133979,0.132381196893337,0.0637391070857865
COD,Mbuji-mayi,2022,917920,1652256,917920,183584,0,3671680,1101504,0.3,0.116666666666667,0.05
COD,Miabi,2018,35735,178673,71469,71469,0,357346,142938,0.399998880636694,0.199999440318347,0.111110800176859
COD,Miabi,2019,73970,147941,73970,73970,0,369851,147940,0.399998918483389,0.199999459241695,0.11111081068983
COD,Miabi,2020,114839,133979,110956,92463,0,452237,203419,0.449806185694669,0.2180877135956,0.118130783441229
COD,Miabi,2021,118859,133979,158478,59429,0,470745,217907,0.462898172046437,0.196380913941377,0.0935146534866128
COD,Miabi,2022,102516,225534,61509,20503,0,410062,82012,0.199999024537753,0.0833329268907303,0.0388886992156742
COD,Mitwaba,2018,33514,106637,85309,79216,0,304676,164525,0.539999868712993,0.266666885478344,0.146666914653235
COD,Mitwaba,2019,63312,142452,79140,31656,0,316560,110796,0.35,0.15,0.0722222222222222
COD,Mitwaba,2020,63312,126624,131562,32890,0,354388,164452,0.464045057959073,0.185617646948166,0.0824965229572609
COD,Mitwaba,2021,68346,170866,153779,17087,0,410078,170866,0.416667073093412,0.152778251942313,0.0601855690326664
COD,Mitwaba,2022,53259,159776,124270,17753,0,355058,142023,0.399999436711749,0.149999906118625,0.0611111424049029
COD,Moanda,2021,110419,184032,110419,18403,0,423273,128822,0.304347312490993,0.115941720827929,0.0483089847188195
COD,Moanda,2022,114173,190289,76115,0,0,380577,76115,0.199998948964336,0.0666663163214453,0.0222221054404818
COD,Moba,2018,125124,275272,75074,25025,0,500495,100099,0.2,0.0833334998351632,0.0388890553907187
COD,Moba,2019,52001,104003,260007,104003,0,520014,364010,0.70000038460503,0.300000256403353,0.144444615380013
COD,Moba,2020,104003,243133,135074,108059,0,590269,243133,0.411902031107851,0.198323137417008,0.106789352726375
COD,Moba,2021,112273,280684,140342,112273,0,645572,252615,0.391304145780796,0.188405527707728,0.101449050867551
COD,Moba,2022,174978,262467,87489,58326,0,583260,145815,0.25,0.116666666666667,0.0611111111111111
COD,Mobayi-Mbongo,2021,44384,63405,25362,6341,0,139492,31703,0.227274682419063,0.0909108288169453,0.0404053438349312
COD,Mobayi-Mbongo,2022,39146,58719,26097,6524,0,130486,32621,0.249996168171298,0.0999979563580256,0.0444432523199594
COD,Mobayi-mbongo,2018,44227,66341,5819,0,0,116387,5819,0.0499969927912911,0.0166656642637637,0.00555522142125457
COD,Mobayi-mbongo,2019,59882,41917,11976,5988,0,119763,17964,0.149996242579094,0.0666649967018194,0.0333324983509097
COD,Mobayi-mbongo,2020,65870,55456,18485,6162,0,145973,24647,0.168846293492632,0.0703531931704265,0.0328317946165082
COD,Mobayi-mbongo,2021,49294,61618,6162,6162,0,123236,12324,0.100003245804797,0.0500016229023987,0.0277786793902215
COD,Mongala,2017,0,2359390,0,0,0,2359390,0,0,0,0
COD,Monkoto,2019,53896,60633,20211,0,0,134740,20211,0.15,0.05,0.0166666666666667
COD,Monkoto,2020,0,0,0,0,0,0,0,,,
COD,Monkoto,2021,35667,64200,42800,0,0,142667,42800,0.299999299067058,0.0999997663556861,0.0333332554518954
COD,Monkoto,2022,36701,66062,44041,0,0,146804,44041,0.299998637639301,0.0999995458797671,0.0333331819599224
COD,Mont ngafula,2020,146638,195517,122198,24440,0,488793,146638,0.300000204585581,0.116666973545039,0.0500002614149093
COD,Mont ngafula,2021,332649,268836,73319,0,0,674804,73319,0.108652290146472,0.0362174300488241,0.0120724766829414
COD,Mont ngafula,2022,241119,267911,26791,0,0,535821,26791,0.049999906685255,0.0166666355617517,0.00555554518725055
COD,Mushie,2019,32366,77677,19419,0,0,129462,19419,0.149997682717709,0.0499992275725696,0.0166664091908565
COD,Mushie,2020,0,0,0,0,0,0,0,,,
COD,Mushie,2021,75540,61806,34337,6867,0,178550,41204,0.230770092411089,0.0897433025296369,0.038461059771617
COD,Mushie,2022,42440,70733,28293,0,0,141466,28293,0.199998586232734,0.0666661954109115,0.0222220651369705
COD,Mutshatsha,2018,99829,532419,33276,0,0,665524,33276,0.0499996994849172,0.0166665664949724,0.0055555221649908
COD,Mutshatsha,2019,100826,252066,126033,25207,0,504132,151240,0.300000793442987,0.116667195628658,0.0500003526413276
COD,Mutshatsha,2020,91259,273776,212937,30420,0,608392,243357,0.400000328735421,0.150000328735421,0.061111366794216
COD,Mutshatsha,2021,189635,316059,182517,60839,0,749050,243356,0.324886189172952,0.13536924548873,0.0631723145614074
COD,Mutshatsha,2022,197031,262708,197031,0,0,656770,197031,0.3,0.1,0.0333333333333333
COD,Mweka,2018,163123,244685,244685,163123,0,815616,407808,0.5,0.233333251595522,0.122222140484411
COD,Mweka,2019,252270,336360,210225,42045,0,840900,252270,0.3,0.116666666666667,0.05
COD,Mweka,2020,294315,296036,259032,84090,0,933473,343122,0.367575709206372,0.152552885836012,0.070869394901263
COD,Mweka,2021,185023,333041,305214,152607,0,975885,457821,0.469134170522142,0.208504075787618,0.104252037893809
COD,Mweka,2022,196672,314675,157338,118003,0,786688,275341,0.350000254230394,0.166666666666667,0.0888888323932458
COD,Mwene ditu,2021,268980,345831,115277,38426,0,768514,153703,0.200000260242494,0.0833335502020783,0.0388890479259685
COD,Mwene ditu,2022,238623,437476,79541,39771,0,795411,119312,0.150000440024088,0.0666670019231148,0.0333335708066508
COD,Mwenga,2018,249544,377881,85558,0,0,712983,85558,0.120000056102319,0.0400000187007731,0.0133333395669244
COD,Mwenga,2019,257779,331430,147302,0,0,736511,147302,0.199999728449405,0.0666665761498018,0.0222221920499339
COD,Mwenga,2020,294604,452321,164480,41120,0,952525,205600,0.215847353087845,0.0863389412351382,0.0383728627711725
COD,Mwenga,2021,235777,510850,196481,41120,0,984228,237601,0.241408494779665,0.0943958107267828,0.040749478553524
COD,Mwenga,2022,243558,446522,121779,0,0,811859,121779,0.150000184761147,0.050000061587049,0.016666687195683
COD,Ndjili,2020,120664,241327,40221,0,0,402212,40221,0.0999995027497937,0.0333331675832645,0.0111110558610882
COD,Ndjili,2021,147391,241327,63167,21056,0,472941,84223,0.178083524160519,0.0742016446026037,0.0346275281224884
COD,Ndjili,2022,154318,242499,44091,0,0,440908,44091,0.10000045360937,0.0333334845364566,0.0111111615121522
COD,Ngaba,2021,95175,130866,35691,11897,0,273629,47588,0.173914314637703,0.0724642977657095,0.0338166722906645
COD,Ngaba,2022,99648,99648,37368,12456,0,249120,49824,0.2,0.0833333333333333,0.0388888888888889
COD,Ngaliema,2021,456489,456489,152163,50721,0,1115862,202884,0.181818181818182,0.0757575757575758,0.0353535353535354
COD,Ngaliema,2022,477944,531049,53105,0,0,1062098,53105,0.0500000941532702,0.0166666980510901,0.00555556601703003
COD,Ngandajika,2018,167196,541396,87579,0,0,796171,87579,0.110000238642201,0.0366667462140671,0.0122222487380224
COD,Ngandajika,2019,247211,535623,41202,0,0,824036,41202,0.0500002427078429,0.016666747569281,0.00555558252309365
COD,Ngandajika,2020,247211,554370,85288,42644,0,929513,127932,0.137633362846996,0.0611703834875539,0.0305851917437769
COD,Ngandajika,2021,264818,529636,170575,44136,0,1009165,214711,0.21276104502237,0.0854987374050164,0.038218505177823
COD,Ngandajika,2022,182724,593854,91362,45681,0,913621,137043,0.149999835818135,0.0666665936969487,0.0333332968484744
COD,Ngiri-ngiri,2021,74254,127292,31823,10608,0,243977,42431,0.17391393451022,0.0724644809415095,0.0338169399392384
COD,Ngiri-ngiri,2022,77743,122168,11106,11106,0,222123,22212,0.0999986493969557,0.0499993246984779,0.0277774026102655
COD,Niangara,2018,85166,30417,6083,0,0,121666,6083,0.0499975342330643,0.0166658447443548,0.00555528158145159
COD,Niangara,2020,54880,42685,24391,0,0,121956,24391,0.199998360064285,0.0666661200214285,0.0222220400071428
COD,Niangara,2021,60978,62442,31221,6244,0,160885,37465,0.232868197781024,0.0905595093804063,0.0388110209846233
COD,Niangara,2022,38364,44758,38364,6394,0,127880,44758,0.35,0.133333333333333,0.0555555555555556
COD,Nord-kivu,2017,0,7385497,642217,0,0,8027714,642217,0.0799999850517844,0.0266666616839281,0.00888888722797604
COD,Nord-ubangi,2017,0,1110269,195930,0,0,1306199,195930,0.150000114837019,0.0500000382790065,0.0166666794263355
COD,Nsele,2020,43955,142852,32966,0,0,219773,32966,0.150000227507474,0.0500000758358245,0.0166666919452748
COD,Nsele,2021,92041,142852,46020,11505,0,292418,57525,0.196721816030477,0.0786887264121908,0.034972767294307
COD,Nsele,2022,60229,144550,24092,12046,0,240917,36138,0.150001867863206,0.0666674968280916,0.0333337484140458
COD,Nyiragongo,2018,174030,43507,0,0,0,217537,0,0,0,0
COD,Nyiragongo,2019,196832,262443,131222,65611,0,656108,196833,0.300000914483591,0.133333739770485,0.0666668698852425
COD,Nyiragongo,2020,262443,229638,131222,32805,0,656108,164027,0.25,0.0999997967814242,0.0444442412258686
COD,Nyiragongo,2021,191048,246691,123345,24669,0,585753,148014,0.252690127067211,0.0982683827483598,0.0421150211778685
COD,Nyiragongo,2022,152899,254832,76449,25483,0,509663,101932,0.199998822751504,0.0833328428131268,0.0388886599794592
COD,Nyunzu,2018,13341,53364,80047,120070,0,266822,200117,0.750001873908448,0.400000749563379,0.233333666472613
COD,Nyunzu,2019,69307,97030,55446,55446,0,277229,110892,0.400001442850495,0.200000721425248,0.111111511902915
COD,Nyunzu,2020,69307,97030,115216,72010,0,353563,187226,0.529540704202646,0.244403401939683,0.12672768989465
COD,Nyunzu,2021,44891,134673,89782,57608,0,326954,147390,0.450797359873254,0.208997799894379,0.108820608811433
COD,Nyunzu,2022,62189,139926,77737,31095,0,310947,108832,0.35000176879018,0.150000911194941,0.0722227403526789
COD,Opala,2019,27358,136790,95753,13679,0,273580,109432,0.4,0.15,0.0611111111111111
COD,Opala,2020,27358,136790,82074,27358,0,273580,109432,0.4,0.166666666666667,0.0777777777777778
COD,Opala,2021,114748,157779,57374,14344,0,344245,71718,0.208334180598121,0.0833340595602938,0.0370375749829337
COD,Opala,2022,102814,102814,73439,14688,0,293755,88127,0.300001702098688,0.116667517716011,0.050000472805191
COD,Oshwe,2019,74980,107115,21423,10711,0,214229,32134,0.149998366234263,0.0666654218927721,0.0333324516184913
COD,Oshwe,2020,0,0,0,0,0,0,0,,,
COD,Oshwe,2021,136366,166536,92520,0,0,395422,92520,0.233977876799976,0.0779926255999919,0.025997541866664
COD,Oshwe,2022,114355,190592,76237,0,0,381184,76237,0.200000524680994,0.0666668415603313,0.0222222805201104
COD,Pangi,2021,193363,171878,150394,64454,0,580089,214848,0.370370753453349,0.160493763313331,0.0781891514348086
COD,Pangi,2022,133163,177550,110969,22194,0,443876,133163,0.300000450576287,0.116666967050858,0.0500002002561276
COD,Poko,2018,25406,196317,9238,0,0,230961,9238,0.0399980949164578,0.0133326983054859,0.00444423276849531
COD,Poko,2019,47301,153728,23651,11825,0,236505,35476,0.150001057060104,0.0666666666666667,0.0333330984310879
COD,Poko,2020,35476,165554,23651,11825,0,236506,35476,0.150000422822254,0.066666384785164,0.0333329574913298
COD,Poko,2021,37199,148796,74398,12400,0,272793,86798,0.318182651314367,0.12121278771816,0.0505055318705229
COD,Poko,2022,38092,139670,63486,12697,0,253945,76183,0.29999803106972,0.116665682201527,0.0499994530749222
COD,Popokabaka,2021,50932,101864,91678,30559,0,275033,122237,0.444444848436369,0.18518505052121,0.0864195286464614
COD,Popokabaka,2022,52460,62952,62952,31476,0,209840,94428,0.45,0.2,0.1
COD,Punia,2018,26654,115500,35538,0,0,177692,35538,0.199997748913851,0.066665916304617,0.022221972101539
COD,Punia,2020,28442,104287,37923,18961,0,189613,56884,0.30000052739,0.13333298174,0.0666661978755559
COD,Punia,2021,78348,94807,47403,19587,0,240145,66990,0.278956463803119,0.120173228674343,0.0581829033847606
COD,Punia,2022,91050,70817,30350,10117,0,202334,40467,0.200000988464618,0.0833341570538483,0.0388894929505998
COD,Pweto,2018,136013,159667,165581,130099,0,591360,295680,0.5,0.239999887265512,0.128888776154401
COD,Pweto,2019,153606,276490,122884,61442,0,614422,184326,0.299999023472467,0.133332899321096,0.0666664496605482
COD,Pweto,2020,153606,307211,223435,63839,0,748091,287274,0.384009432007603,0.156448435640406,0.0711130063053826
COD,Pweto,2021,132657,298477,298477,66328,0,795939,364805,0.458332862191701,0.180555293810204,0.0787035466564928
COD,Pweto,2022,137830,310118,206745,34458,0,689151,241203,0.35000021765912,0.133333623545493,0.0555557973990219
COD,Rungu,2018,230858,106550,17758,0,0,355166,17758,0.0499991553245525,0.0166663851081842,0.00555546170272805
COD,Rungu,2019,72738,163661,90923,36369,0,363691,127292,0.350000412438031,0.150000045826448,0.0722221763957743
COD,Rungu,2020,167589,127292,127292,36369,0,458542,163661,0.356916051310458,0.145410162355175,0.0660954842861844
COD,Rungu,2021,167589,152543,114407,19068,0,453607,133475,0.294252513739867,0.112096300689069,0.046706853191321
COD,Rungu,2022,156204,136679,97628,0,0,390511,97628,0.250000640186832,0.083333546728944,0.027777848909648
COD,Rutshuru,2018,326977,523164,326977,130791,0,1307909,457768,0.349999885313122,0.149999987257014,0.0722222349652087
COD,Rutshuru,2019,472875,540428,270214,67554,0,1351071,337768,0.250000185038388,0.100000172702496,0.0444445760272982
COD,Rutshuru,2020,486385,769445,427469,170988,0,1854287,598457,0.322742380224852,0.138318214314541,0.0665976853756847
COD,Rutshuru,2021,658319,854939,564274,282137,0,2359669,846411,0.358699037873532,0.159421794610459,0.0797108973052294
COD,Rutshuru,2022,547377,912296,273689,91230,0,1824592,364919,0.200000328840639,0.0833335160225775,0.0388889985024354
COD,Sakania,2018,132743,113077,0,0,0,245820,0,0,0,0
COD,Sakania,2021,82715,179216,41358,0,0,303289,41358,0.136364985212124,0.0454549950707081,0.0151516650235694
COD,Sakania,2022,71618,186206,28647,0,0,286471,28647,0.0999996509245264,0.0333332169748421,0.0111110723249474
COD,Sandoa,2018,248599,88785,17757,0,0,355141,17757,0.0499998592108487,0.0166666197369496,0.00555553991231652
COD,Sandoa,2019,110697,239844,18450,0,0,368991,18450,0.0500012195419401,0.0166670731806467,0.00555569106021556
COD,Sandoa,2020,153353,202945,57507,0,0,413805,57507,0.138971254576431,0.046323751525477,0.0154412505084923
COD,Sandoa,2021,199167,249198,139417,0,0,587782,139417,0.237191679908538,0.0790638933028458,0.0263546311009486
COD,Sandoa,2022,124160,206934,82774,0,0,413868,82774,0.200000966491732,0.0666669888305772,0.0222223296101924
COD,Sankuru,2017,0,1625144,203143,18468,0,1846755,221611,0.120000216596138,0.0433334867555974,0.0166667719564558
COD,Seke-banza,2020,140780,89587,25596,0,0,255963,25596,0.099998827955603,0.0333329426518677,0.0111109808839559
COD,Seke-banza,2021,153578,132333,66167,13233,0,365311,79400,0.217349053272417,0.0845243276733158,0.0362245380572231
COD,Seke-banza,2022,82099,123149,68416,0,0,273664,68416,0.25,0.0833333333333333,0.0277777777777778
COD,Selembao,2020,152175,217394,65218,0,0,434787,65218,0.149999885001161,0.0499999616670538,0.0166666538890179
COD,Selembao,2021,322299,443161,120862,40287,0,926609,161149,0.173912621181102,0.0724635022251385,0.0338162530737824
COD,Selembao,2022,295266,379628,126543,42181,0,843618,168724,0.200000474148252,0.083333530895105,0.0388889810843823
COD,Shabunda,2018,192099,288149,128066,32017,0,640331,160083,0.250000390423078,0.100000364394873,0.0444447220786333
COD,Shabunda,2019,165365,231511,132292,132292,0,661460,264584,0.4,0.2,0.111111111111111
COD,Shabunda,2020,198438,264584,231511,132292,0,826825,363803,0.44,0.2,0.102222222222222
COD,Shabunda,2021,141168,423503,282335,70584,0,917590,352919,0.384615133120457,0.153846125902273,0.0683760963199492
COD,Shabunda,2022,182283,401022,109370,36457,0,729132,145827,0.200000822896266,0.0833337904979254,0.0388891631876441
COD,Songololo,2019,83497,233790,16699,0,0,333986,16699,0.0499991017587564,0.0166663672529188,0.00555545575097293
COD,Songololo,2020,0,0,0,0,0,0,0,,,
COD,Songololo,2021,160687,142833,71417,17854,0,392791,89271,0.227273537326466,0.0909092452050412,0.0404040146880487
COD,Songololo,2022,147690,147690,73845,0,0,369225,73845,0.2,0.0666666666666667,0.0222222222222222
COD,Sud-kivu,2017,0,5010241,556693,0,0,5566934,556693,0.0999999281471632,0.0333333093823877,0.0111111031274626
COD,Sud-ubangi,2017,0,2458766,102449,0,0,2561215,102449,0.0400001561758775,0.0133333853919592,0.00444446179731972
COD,Tanganyka,2017,0,1886623,563171,366061,0,2815855,929232,0.329999946730212,0.153333297820141,0.0799999763245385
COD,Territoire de LODJA,2020,25048,275528,150288,50096,0,500960,200384,0.4,0.166666666666667,0.0777777777777778
COD,Territoire de LODJA,2021,181473,311096,125240,25048,0,642857,150288,0.233781385284752,0.0909149831662926,0.0389635642141254
COD,Territoire de LODJA,2022,134160,321985,53664,26832,0,536641,80496,0.149999720483526,0.0666665424371228,0.0333332712185614
COD,Tshela,2018,176898,243234,22112,0,0,442244,22112,0.0499995477609645,0.0166665159203215,0.00555550530677384
COD,Tshela,2019,104441,271545,41776,0,0,417762,41776,0.0999995212585156,0.0333331737528385,0.0111110579176128
COD,Tshela,2020,146217,250657,20888,0,0,417762,20888,0.0499997606292578,0.0166665868764193,0.00555552895880642
COD,Tshela,2021,133997,223328,111664,22333,0,491322,133997,0.272727457756828,0.106060791090161,0.0454546893664214
COD,Tshela,2022,138552,207828,115460,0,0,461840,115460,0.25,0.0833333333333333,0.0277777777777778
COD,Tshilenge,2018,98610,328700,109567,10957,0,547834,120524,0.220000949192639,0.0800005111037285,0.0311114112831421
COD,Tshilenge,2019,170102,226803,113402,56701,0,567008,170103,0.300001058186128,0.133333803638279,0.0666669018191395
COD,Tshilenge,2020,113402,176056,198453,146713,0,634624,345166,0.543890555667608,0.25835717947425,0.137492611548115
COD,Tshilenge,2021,212588,273327,212588,146713,0,845216,359301,0.425099619505547,0.199560033569328,0.105093451456985
COD,Tshilenge,2022,220028,314326,94298,0,0,628652,94298,0.150000318141038,0.0500001060470128,0.0166667020156709
COD,Tshopo,2017,0,1920059,189896,0,0,2109955,189896,0.0900000236971879,0.0300000078990626,0.0100000026330209
COD,Tshuapa,2017,0,1945663,0,0,0,1945663,0,0,0,0
COD,Ubundu,2018,66427,211935,37959,0,0,316321,37959,0.120001517445886,0.0400005058152952,0.0133335019384317
COD,Ubundu,2019,16196,145760,145760,16196,0,323912,161956,0.5,0.183333744967769,0.0722226338566579
COD,Ubundu,2020,99506,152239,93934,33169,0,378848,127103,0.335498669651153,0.141016977785286,0.0664617178628075
COD,Ubundu,2021,118876,203788,99506,33965,0,456135,133471,0.292612932574786,0.122358512282548,0.0573334161548177
COD,Ubundu,2022,121729,139119,69560,17390,0,347798,86950,0.250001437616088,0.100000575046435,0.0444447000206378
COD,Uvira,2018,326229,448565,40779,0,0,815573,40779,0.0500004291461341,0.016666809715378,0.00555560323845934
COD,Uvira,2019,176993,227563,101139,0,0,505695,101139,0.2,0.0666666666666667,0.0222222222222222
COD,Uvira,2020,217573,304602,217573,130544,0,870292,348117,0.400000229807927,0.183333486538618,0.0944445465813007
COD,Uvira,2021,314654,539406,179802,44951,0,1078813,224753,0.208333603692206,0.08333356506951,0.0370372086934642
COD,Uvira,2022,278603,464339,185736,0,0,928678,185736,0.200000430719797,0.0666668102399325,0.0222222700799775
COD,Ville de Gbadolite,2021,73627,89989,16362,8181,0,188159,24543,0.130437555471702,0.0579722468763121,0.028986123438156
COD,Ville de Gbadolite,2022,67344,75762,16836,8418,0,168360,25254,0.15,0.0666666666666667,0.0333333333333333
COD,Walikale,2018,151859,273345,151859,30372,0,607435,182231,0.300000823133339,0.116667078233336,0.0500002286481498
COD,Walikale,2019,219618,250992,125496,31374,0,627480,156870,0.25,0.1,0.0444444444444444
COD,Walikale,2020,188244,259275,162047,64819,0,674385,226866,0.336404279454614,0.144173333234478,0.069416826689008
COD,Walikale,2021,200873,301310,234352,133915,0,870450,368267,0.423076569590442,0.192307427192831,0.0982904117282887
COD,Walikale,2022,276670,276670,103751,34584,0,691675,138335,0.2,0.0833334538138095,0.038889009369365
COD,Walungu,2018,402996,447773,44777,0,0,895546,44777,0.0499996650088326,0.0166665550029442,0.00555551833431473
COD,Walungu,2019,277530,416295,185020,46255,0,925100,231275,0.25,0.1,0.0444444444444444
COD,Walungu,2020,323785,370040,185020,77296,0,956141,262316,0.274348657781645,0.118396763657243,0.0574303952613219
COD,Walungu,2021,296150,592299,197433,38648,0,1124530,236081,0.209937484993731,0.0814352070050006,0.0347824325619493
COD,Walungu,2022,247444,494888,82481,0,0,824813,82481,0.0999996362811934,0.0333332120937312,0.0111110706979104
COD,Wamba,2018,62441,291393,62441,0,0,416275,62441,0.149999399435469,0.0499997998118231,0.0166665999372744
COD,Wamba,2019,127880,170506,85253,42627,0,426266,127880,0.300000469190599,0.133333802523933,0.0666670315926884
COD,Wamba,2020,0,0,0,0,0,0,0,,,
COD,Wamba,2021,134092,201137,111743,22349,0,469321,134092,0.285714894496517,0.111111584608402,0.0476193858313985
COD,Wamba,2022,137310,205965,114425,0,0,457700,114425,0.25,0.0833333333333333,0.0277777777777778
COD,Watsa,2021,92142,138213,92142,0,0,322497,92142,0.285714285714286,0.0952380952380952,0.0317460317460317
COD,Watsa,2022,110079,141530,62902,0,0,314511,62902,0.199999364092194,0.066666454697398,0.0222221515657993
COD,Yahuma,2018,33296,107287,44394,0,0,184977,44394,0.239997405082794,0.079999135027598,0.0266663783425327
COD,Yahuma,2019,37883,94709,47354,9471,0,189417,56825,0.299999472064282,0.116666754655953,0.050000205308335
COD,Yahuma,2020,28413,94709,47354,18942,0,189418,66296,0.349998416201206,0.149999824022356,0.072222398199866
COD,Yahuma,2021,79447,99309,39724,9931,0,228411,49655,0.217393207857765,0.0869572831431061,0.038647681396936
COD,Yahuma,2022,81354,91523,30508,0,0,203385,30508,0.15000122919586,0.0500004097319534,0.0166668032439845
COD,Yakoma,2018,143465,187871,10247,0,0,341583,10247,0.0299985655023816,0.00999952183412719,0.00333317394470906
COD,Yakoma,2019,175745,123021,52723,0,0,351489,52723,0.149999004236263,0.0499996680787545,0.0166665560262515
COD,Yakoma,2020,162757,144673,54252,0,0,361682,54252,0.149999170542078,0.0499997235140261,0.0166665745046754
COD,Yakoma,2021,180841,204694,55826,18609,0,459970,74435,0.161825771245951,0.0674275858570487,0.0314663033579485
COD,Yakoma,2022,134037,191482,57444,0,0,382963,57444,0.149998824951758,0.0499996083172526,0.0166665361057509
COD,Yumbi,2021,73243,33292,33292,6658,0,146485,39950,0.272724169710209,0.106058640816466,0.0454532697697527
COD,Zongo,2020,23380,46760,18704,4676,0,93520,23380,0.25,0.1,0.0444444444444444
COD,Zongo,2021,33706,51436,16853,4213,0,106208,21066,0.198346640554384,0.0793380285226474,0.0352609972883399
COD,Zongo,2022,34683,34683,13006,4335,0,86707,17341,0.199995386762314,0.0833304500597799,0.0388870307792656
CPV,Boa vista,2022,8451,3784,1009,0,0,13244,1009,0.0761854424645122,0.0253951474881707,0.00846504916272358
CPV,Brava,2022,4084,1454,280,0,0,5818,280,0.0481265039532485,0.0160421679844162,0.00534738932813873
CPV,Maio,2022,5542,945,189,0,0,6676,189,0.0283103654883164,0.00943678849610545,0.00314559616536848
CPV,Mosteiros,2022,6208,2257,403,0,0,8868,403,0.0454442940911141,0.0151480980303714,0.00504936601012379
CPV,Paul,2022,4272,1595,399,0,0,6266,399,0.0636769869135014,0.0212256623045005,0.00707522076816683
CPV,Porto novo,2022,9867,5570,2387,1273,0,19097,3660,0.191653139236529,0.0861042746679234,0.0435146881709169
CPV,Praia,2022,106507,39763,11361,0,0,157631,11361,0.0720733865800509,0.0240244621933503,0.0080081540644501
CPV,Ribeira brava,2022,5303,1675,419,0,0,7397,419,0.0566445856428282,0.0188815285476094,0.00629384284920313
CPV,Ribeira grande,2022,12168,4507,1202,0,0,17877,1202,0.0672372321977961,0.0224124107325987,0.00747080357753289
CPV,Ribeira grande de santiago,2022,2671,3053,2061,305,0,8090,2366,0.292459826946848,0.110053564070869,0.0450624914160143
CPV,Sal,2022,26011,7336,1000,0,0,34347,1000,0.0291146242757737,0.00970487475859124,0.00323495825286375
CPV,Santa catarina,2022,25481,9368,4871,0,0,39720,4871,0.122633434038268,0.0408778113460893,0.0136259371153631
CPV,Santa catarina do fogo,2022,3308,1418,236,0,0,4962,236,0.0475614671503426,0.0158538223834475,0.00528460746114918
CPV,Santa cruz,2022,13252,13752,5751,750,0,33505,6501,0.194030741680346,0.072138486793016,0.0290205441973835
CPV,Sao domingos,2022,7398,4885,2792,698,0,15773,3490,0.221264185633678,0.0885056742534711,0.039335855223765
CPV,Sao filipe,2022,17622,3317,622,0,0,21561,622,0.0288483836556746,0.00961612788522487,0.00320537596174162
CPV,Sao lourenco dos orgaos,2022,5117,2085,379,63,0,7644,442,0.0578231292517007,0.0220216291644863,0.0091720448863306
CPV,Sao miguel,2022,8002,4517,1291,0,0,13810,1291,0.0934829833454019,0.0311609944484673,0.0103869981494891
CPV,Sao salvador do mundo,2022,4769,2608,894,0,0,8271,894,0.108088501994922,0.036029500664974,0.0120098335549913
CPV,Sao vicente,2022,56992,18504,3701,0,0,79197,3701,0.0467315681149538,0.0155771893716513,0.00519239645721709
CPV,Tarrafal,2022,10969,4654,1828,0,0,17451,1828,0.104750444100625,0.0349168147002082,0.0116389382334027
CPV,Tarrafal de sao nicolau,2022,3472,1684,263,0,0,5419,263,0.0485329396567632,0.0161776465522544,0.00539254885075147
DJI,Ali Addeh Camp,2020,7307,4871,3247,812,0,16237,4059,0.249984603067069,0.0999979470756092,0.044445813060705
DJI,Ali Addeh Camp,2021,7307,4871,3247,812,0,16237,4059,0.249984603067069,0.0999979470756092,0.044445813060705
DJI,Ali Addeh Camp,2022,3403,6805,6805,851,0,17864,7656,0.428571428571429,0.158736378563965,0.0634982833258695
DJI,Ali Sabieh Rural,2020,8719,2180,2906,727,0,14532,3633,0.25,0.100009175153684,0.0444536195981283
DJI,Ali Sabieh Rural,2021,8719,2180,2906,727,0,14532,3633,0.25,0.100009175153684,0.0444536195981283
DJI,Ali Sabieh Rural,2022,6142,6142,3839,768,0,16891,4607,0.2727488011367,0.106072267282379,0.0454614225853347
DJI,Ali Sabieh Ville,2020,20663,4428,2952,1476,0,29519,4428,0.15000508147295,0.0666689250990887,0.0333344625495444
DJI,Ali Sabieh Ville,2021,20663,4428,2952,1476,0,29519,4428,0.15000508147295,0.0666689250990887,0.0333344625495444
DJI,Ali Sabieh Ville,2022,14038,10918,7799,0,0,32755,7799,0.238101053274309,0.0793670177581031,0.0264556725860344
DJI,Arta Rural,2020,11861,6470,3235,0,0,21566,3235,0.150004636928499,0.0500015456428329,0.0166671818809443
DJI,Arta Rural,2021,11861,5392,4313,0,0,21566,4313,0.199990726143003,0.066663575381001,0.022221191793667
DJI,Arta Rural,2022,5698,9116,7977,1140,0,23931,9117,0.38097028958255,0.142869081943922,0.0582090175922444
DJI,Arta Ville,2020,7369,4689,1340,0,0,13398,1340,0.100014927601134,0.0333383092003782,0.0111127697334594
DJI,Arta Ville,2021,6699,4689,2010,0,0,13398,2010,0.150022391401702,0.0500074638005672,0.0166691546001891
DJI,Arta Ville,2022,7080,6372,2124,708,0,16284,2832,0.173913043478261,0.072463768115942,0.0338164251207729
DJI,Balbala,2020,253171,97374,38949,0,0,389494,38949,0.0999989730265421,0.0333329910088474,0.0111109970029491
DJI,Balbala,2021,194747,136323,58424,0,0,389494,58424,0.149999743256636,0.0499999144188785,0.0166666381396262
DJI,Balbala,2022,226386,144064,61742,0,0,432192,61742,0.14285780393899,0.0476192679796634,0.0158730893265545
DJI,Boulaos,2020,261371,69699,17425,0,0,348495,17425,0.050000717370407,0.0166669057901357,0.00555563526337856
DJI,Boulaos,2021,191672,121973,34850,0,0,348495,34850,0.100001434740814,0.0333338115802714,0.0111112705267571
DJI,Boulaos,2022,257799,92071,36828,0,0,386698,36828,0.0952371100962508,0.0317457033654169,0.0105819011218056
DJI,Dikhil Rural,2020,31089,23317,15545,7772,0,77723,23317,0.300001286620434,0.133332475586377,0.0666655230040586
DJI,Dikhil Rural,2021,27203,27203,19431,3886,0,77723,23317,0.300001286620434,0.116666452229928,0.049999499647609
DJI,Dikhil Rural,2022,28748,45175,16427,0,0,90350,16427,0.181815163254012,0.0606050544180041,0.0202016848060014
DJI,Dikhil Ville,2020,4695,9389,7042,2347,0,23473,9389,0.399991479572275,0.166659566310229,0.0777725708497233
DJI,Dikhil Ville,2021,5868,8216,7042,2347,0,23473,9389,0.399991479572275,0.166659566310229,0.0777725708497233
DJI,Dikhil Ville,2022,9922,12403,3721,0,0,26046,3721,0.142862627658758,0.0476208758862525,0.0158736252954175
DJI,Holl-Holl Camp,2020,2304,3292,988,0,0,6584,988,0.150060753341434,0.0500202511138113,0.0166734170379371
DJI,Holl-Holl Camp,2021,2304,3292,988,0,0,6584,988,0.150060753341434,0.0500202511138113,0.0166734170379371
DJI,Holl-Holl Camp,2022,2404,3205,3205,401,0,9215,3606,0.391318502441671,0.144944836317598,0.0579851691083379
DJI,Markazi Camp,2020,380,1012,759,380,0,2531,1139,0.450019755037535,0.200052680100092,0.100048290091751
DJI,Markazi Camp,2021,380,1012,759,380,0,2531,1139,0.450019755037535,0.200052680100092,0.100048290091751
DJI,Markazi Camp,2022,1002,1145,1002,143,0,3292,1145,0.347812879708384,0.130417172944512,0.0531254218982044
DJI,Obock Rural,2020,20000,15000,12500,2500,0,50000,15000,0.3,0.116666666666667,0.05
DJI,Obock Rural,2021,15000,15000,12500,7500,0,50000,20000,0.4,0.183333333333333,0.0944444444444445
DJI,Obock Rural,2022,21136,23778,7926,2642,0,55482,10568,0.19047619047619,0.0793650793650794,0.037037037037037
DJI,Obock Ville,2020,8000,8000,3000,1000,0,20000,4000,0.2,0.0833333333333333,0.0388888888888889
DJI,Obock Ville,2021,9000,7000,3000,1000,0,20000,4000,0.2,0.0833333333333333,0.0388888888888889
DJI,Obock Ville,2022,7398,10568,3170,1057,0,22193,4227,0.190465462082639,0.0793643641388426,0.0370387058982562
DJI,Tadjourah Rural,2020,26578,35437,17718,8859,0,88592,26577,0.299993227379447,0.133330323279754,0.0666651616398772
DJI,Tadjourah Rural,2021,26578,39866,13289,8859,0,88592,22148,0.25,0.116665914153272,0.0611103585977164
DJI,Tadjourah Rural,2022,32768,56174,14043,4681,0,107666,18724,0.173908197573979,0.0724617489891578,0.033815482861607
DJI,Tadjourah Ville,2020,5250,8250,1500,0,0,15000,1500,0.1,0.0333333333333333,0.0111111111111111
DJI,Tadjourah Ville,2021,6000,7500,1500,0,0,15000,1500,0.1,0.0333333333333333,0.0111111111111111
DJI,Tadjourah Ville,2022,3170,10304,3170,0,0,16644,3170,0.190459024273011,0.0634863414243371,0.0211621138081124
ETH,AAP - Assale Agropastoral Livelihood Zone,2019,29674,33914,21196,0,0,84784,21196,0.25,0.0833333333333333,0.0277777777777778
ETH,AAP - Assale Agropastoral Livelihood Zone,2020,34429,34429,17214,0,0,86072,17214,0.199995352727949,0.0666651175759829,0.022221705858661
ETH,ABB - Abay-Beshilo Basin Livelihood Zone,2019,556513,159004,119253,39751,0,874521,159004,0.181818389724203,0.0757576623850847,0.0353535757797062
ETH,ABB - Abay-Beshilo Basin Livelihood Zone,2020,480450,160150,120113,40038,0,800751,160151,0.20000099906213,0.0833338536781929,0.0388891872199417
ETH,AFP - Afder Pastoral Livelihood Zone,2019,150462,200616,150462,25077,0,526617,175539,0.333333333333333,0.126984126984127,0.0529100529100529
ETH,AFP - Afder Pastoral Livelihood Zone,2020,179690,179690,128350,25670,0,513400,154020,0.3,0.116666666666667,0.05
ETH,AGA - Awsa Gewane Agropastoral Livelihood Zone,2019,43300,27555,11809,0,0,82664,11809,0.142855414690797,0.0476184715635988,0.0158728238545329
ETH,AGA - Awsa Gewane Agropastoral Livelihood Zone,2020,43958,31970,3996,0,0,79924,3996,0.0499974976227416,0.0166658325409139,0.00555527751363796
ETH,AMP Alaba-Mareko Lowland Pepper LZ,2019,186264,165568,82784,20696,0,455312,103480,0.227272727272727,0.0909090909090909,0.0404040404040404
ETH,AMP Alaba-Mareko Lowland Pepper LZ,2020,147465,147465,84266,42133,0,421329,126399,0.30000071203264,0.133333649792284,0.0666668248961421
ETH,ARP - Aramis-Adar Pastoral Livelihood Zone,2019,239969,191975,71991,47994,0,551929,119985,0.217392092098803,0.101449642979441,0.0531402891797073
ETH,ARP - Aramis-Adar Pastoral Livelihood Zone,2020,194892,194892,73084,24361,0,487229,97445,0.19999835806161,0.0833324781570883,0.0388883985878418
ETH,ASP - Asale Pastoral Livelihood Zone,2019,78425,89629,56018,11204,0,235276,67222,0.285715500093507,0.111112055628283,0.0476197222741707
ETH,ASP - Asale Pastoral Livelihood Zone,2020,90990,90990,45495,0,0,227475,45495,0.2,0.0666666666666667,0.0222222222222222
ETH,Abm-Alaba-Badewacho-Maize Livelihood,2019,116155,48398,38718,9680,0,212951,48398,0.227272940723453,0.0909098024115094,0.0404047044729643
ETH,Abm-Alaba-Badewacho-Maize Livelihood,2020,88676,59117,39412,9853,0,197058,49265,0.250002537324037,0.100001014929615,0.0444448955242732
ETH,"Afc-Agarfa, Gasera, Ginir & Gololcha Fruit, Coffee & Ch",2019,26400,47520,21120,10560,0,105600,31680,0.3,0.133333333333333,0.0666666666666667
ETH,"Afc-Agarfa, Gasera, Ginir & Gololcha Fruit, Coffee & Ch",2020,26903,43044,21522,16142,0,107611,37664,0.350001393909545,0.16666821545505,0.0888901279195952
ETH,Afder,2020,177170,206698,236226,29528,0,649622,265754,0.409090209383303,0.151514778337762,0.0606058429192498
ETH,Afder,2021,121170,242340,212047,30292,0,605849,242339,0.399999009654221,0.149999422298295,0.0611107534862464
ETH,AoH - Alaje-Ofla Highland Livelihood Zone,2019,193298,89215,74346,0,0,356859,74346,0.208334384168537,0.0694447947228457,0.0231482649076152
ETH,AoH - Alaje-Ofla Highland Livelihood Zone,2020,209290,74746,14949,0,0,298985,14949,0.0499991638376507,0.0166663879458836,0.00555546264862786
ETH,Arsi,2020,1736127,1093698,468728,157830,0,3456383,626558,0.181275628308553,0.0756463235314682,0.0353628505740121
ETH,Arsi,2021,1452423,1129662,638442,161380,0,3381907,799822,0.236500294064857,0.0947396444274389,0.0421840235241373
ETH,"Arsi-Bale Wheat, Barley and Potato Livelihood Zone (ABW",2019,902819,1625074,722255,361128,0,3611276,1083383,0.300000055382087,0.13333338871542,0.0666667097416229
ETH,"Arsi-Bale Wheat, Barley and Potato Livelihood Zone (ABW",2020,920020,1288028,920020,552012,0,3680080,1472032,0.4,0.183333333333333,0.0944444444444444
ETH,Asa-Abijata Shala Jido Agro-pastoral Livelihood Zone,2019,42284,56379,28190,14095,0,140948,42285,0.300004256889065,0.133335225284029,0.0666676126420145
ETH,Asa-Abijata Shala Jido Agro-pastoral Livelihood Zone,2020,43090,50272,28727,21545,0,143634,50272,0.350000696213988,0.166666666666667,0.0888887341746693
ETH,BAM Badewacho-Alaba Maize LZ,2019,69655,32149,21432,0,0,123236,21432,0.173910221039307,0.0579700736797689,0.0193233578932563
ETH,BAM Badewacho-Alaba Maize LZ,2020,54540,21816,27270,5454,0,109080,32724,0.3,0.116666666666667,0.05
ETH,Bale,2020,647865,566882,401130,80983,0,1696860,482113,0.284120669943307,0.110615293345748,0.0474773666916802
ETH,Bale,2021,662429,496822,573688,163911,0,1896850,737599,0.38885468012758,0.158422296614563,0.0720101454751005
ETH,"Bgc-Borena-Guji Maize, Wheat and Livestock Livelihood Z",2019,38728,87138,58092,9682,0,193640,67774,0.35,0.133333333333333,0.0555555555555556
ETH,"Bgc-Borena-Guji Maize, Wheat and Livestock Livelihood Z",2020,49332,88798,49332,9866,0,197328,59198,0.299997972918187,0.116665315278791,0.0499990990747498
ETH,"Bge-Guji Coffee, Enset & Cattle Livelihood Zone",2019,373241,373241,266601,53320,0,1066403,319921,0.30000009377318,0.116666651037803,0.0499999635326524
ETH,"Bge-Guji Coffee, Enset & Cattle Livelihood Zone",2020,326017,434689,271681,54336,0,1086723,326017,0.30000009201977,0.116666651330038,0.0499999642145341
ETH,Bgp-Borena-Guji Cattle Pastoralist Livelihood Zone,2019,202962,202962,101481,25370,0,532775,126851,0.238094880578105,0.0952378271002456,0.0423278536384444
ETH,Bgp-Borena-Guji Cattle Pastoralist Livelihood Zone,2020,155122,206829,129268,25854,0,517073,155122,0.30000019339629,0.116666956761102,0.050000247117482
ETH,Blp-Bale Agro-pastoral Livelihood Zone,2019,69166,92221,46110,23055,0,230552,69165,0.299997397550227,0.13333217668899,0.0666660883444949
ETH,Blp-Bale Agro-pastoral Livelihood Zone,2020,70483,105725,46989,11747,0,234944,58736,0.25,0.0999997162444384,0.0444441606888828
ETH,Borena,2020,193594,171115,122225,24445,0,511379,146670,0.286812716204615,0.111538278524017,0.0478021193674359
ETH,Borena,2021,124975,149970,197767,74985,0,547697,272752,0.497997980635278,0.211635874093401,0.10096965617445
ETH,Boricha,2019,103673,162915,29621,0,0,296209,29621,0.100000337599465,0.0333334458664884,0.0111111486221628
ETH,Boricha,2020,90454,165832,45227,0,0,301513,45227,0.150000165830329,0.0500000552767764,0.0166666850922588
ETH,Bpa-Bale Pastoral Livelihood,2019,111316,86579,61842,12368,0,272105,74210,0.272725602249132,0.106059548091117,0.0454538587024208
ETH,Bpa-Bale Pastoral Livelihood,2020,100833,88229,63021,0,0,252083,63021,0.250000991736849,0.0833336639122829,0.027777887970761
ETH,CNO Cheno Livelihood Zone,2019,11378,10114,5057,1264,0,27813,6321,0.227267824398663,0.0909047327988111,0.0404007718213306
ETH,CNO Cheno Livelihood Zone,2020,10267,11551,3850,0,0,25668,3850,0.149992208196977,0.0499974027323256,0.0166658009107752
ETH,"Central gondar, cluster 1",2020,219893,139932,39981,0,0,399806,39981,0.100001000485235,0.0333336668284118,0.0111112222761373
ETH,"Central gondar, cluster 1",2021,202092,161674,80837,0,0,444603,80837,0.181818386290691,0.0606061287635636,0.0202020429211879
ETH,"Central, cluster 1",2020,262019,262019,58227,0,0,582265,58227,0.100000858715533,0.0333336195718444,0.0111112065239481
ETH,"Central, cluster 1",2021,205352,381369,322439,429919,107480,1446559,859838,0.594402302291161,0.346734791552459,0.231156604512271
ETH,"Central, cluster 2",2020,263725,184608,79118,0,0,527451,79118,0.150000663568749,0.0500002211895829,0.0166667403965276
ETH,"Central, cluster 2",2021,265744,186020,313011,243453,69558,1077786,626022,0.58084072348314,0.311932981129835,0.197199011059091
ETH,"Cgc-Charcher/Gololcha Coffee, Chat & Maize",2019,362169,321928,160964,40241,0,885302,201205,0.227272727272727,0.0909090909090909,0.0404040404040404
ETH,"Cgc-Charcher/Gololcha Coffee, Chat & Maize",2020,287054,287054,205038,41008,0,820154,246046,0.299999756143358,0.11666670730944,0.0500000948331384
ETH,DAP - Degahbur Agropastoral Livelihood Zone,2019,69013,78872,59154,9859,0,216898,69013,0.318181818181818,0.121212121212121,0.0505050505050505
ETH,DAP - Degahbur Agropastoral Livelihood Zone,2020,60553,70645,70645,0,0,201843,70645,0.349999752282715,0.116666584094238,0.0388888613647461
ETH,DGR - Dawa- Ganale Riverine Livelihood Zone,2019,55126,73502,55126,18375,0,202129,73501,0.363634114847449,0.151513802241803,0.0707062211645918
ETH,DGR - Dawa- Ganale Riverine Livelihood Zone,2020,56430,75240,47025,9405,0,188100,56430,0.3,0.116666666666667,0.05
ETH,DMR Dawro-Konta Maize and Root Crop LZ,2019,138823,88342,50481,12620,0,290266,63101,0.217390255834304,0.0869558726593309,0.0386469269183745
ETH,DMR Dawro-Konta Maize and Root Crop LZ,2020,89923,89923,64231,12846,0,256923,77077,0.300000389221673,0.116666601796388,0.0499998486360159
ETH,Daawa,2020,164908,185521,61840,20613,0,432882,82453,0.19047454040593,0.0793641993276074,0.037036523681845
ETH,Daawa,2021,126881,147383,126329,63441,0,464034,189770,0.408957102281298,0.181891125793943,0.0910117697314325
ETH,Dawuro,2020,380212,126730,58494,29247,0,594683,87741,0.147542472207882,0.0655744320923921,0.032787216046196
ETH,Dawuro,2021,327714,178753,89376,25802,0,621645,115178,0.185279379710285,0.0755951279803318,0.0344219324891574
ETH,"Dbc-Dallo, Barbare and Arana-Buluk Coffee Livelihood Zo",2019,55519,71382,39657,7931,0,174489,47588,0.272727793729118,0.106060171892402,0.0454539955081537
ETH,"Dbc-Dallo, Barbare and Arana-Buluk Coffee Livelihood Zo",2020,48494,72742,32330,8082,0,161648,40412,0.25,0.099999175162493,0.0444436196069374
ETH,Doolo,2020,211219,115211,57605,19202,0,403237,76807,0.190476072384231,0.0793652368210259,0.0370372207356413
ETH,Doolo,2021,157590,98494,98494,39397,0,393975,137891,0.34999936544197,0.14999936544197,0.0722217286770875
ETH,EDM - Enderta Dry Midland Livelihood Zone,2019,212440,169952,127464,0,0,509856,127464,0.25,0.0833333333333333,0.0277777777777778
ETH,EDM - Enderta Dry Midland Livelihood Zone,2020,213585,149510,64076,0,0,427171,64076,0.15000081934401,0.0500002731146699,0.01666675770489
ETH,ELP - Eli-Daar Pastoral Livelihood Zone,2019,59954,39970,46631,0,0,146555,46631,0.318180887721333,0.106060295907111,0.035353431969037
ETH,ELP - Eli-Daar Pastoral Livelihood Zone,2020,47340,47340,40577,0,0,135257,40577,0.299999260666731,0.0999997535555769,0.0333332511851923
ETH,East belesa,2019,49793,24897,24897,9959,0,109546,34856,0.318185967538751,0.136365849354,0.0656578565676114
ETH,East belesa,2020,45137,25076,25076,5015,0,100304,30091,0.299998006061573,0.116665337374382,0.0499991138051435
ETH,"East gojam, cluster 1",2020,378046,44476,22238,0,0,444760,22238,0.05,0.0166666666666667,0.00555555555555555
ETH,"East gojam, cluster 1",2021,337223,89926,67445,0,0,494594,67445,0.136364371585583,0.0454547905285278,0.0151515968428426
ETH,East hararge,2020,1847514,1007735,671823,167956,0,3695028,839779,0.227272702669641,0.0909090991101195,0.0404040540724214
ETH,East hararge,2021,1372610,1029458,857881,171576,0,3431525,1029457,0.299999854292188,0.116666593812761,0.0499999595256077
ETH,"East hararge, cluster 1",2020,218458,191150,109229,27307,0,546144,136536,0.25,0.0999998779320716,0.0444443223765161
ETH,"East hararge, cluster 1",2021,223372,195450,139607,27921,0,586350,167528,0.285713311162275,0.111110542622438,0.0476186956974882
ETH,"East hararge, cluster 2",2020,556174,834261,370783,92696,0,1853914,463479,0.250000269699673,0.100000143839826,0.0444445283510095
ETH,"East hararge, cluster 2",2021,663466,853028,473905,94781,0,2085180,568686,0.272727534313584,0.106060707788616,0.0454545890522641
ETH,"East hararge, cluster 3",2020,397177,347530,198589,49647,0,992943,248236,0.250000251776789,0.100000033570239,0.0444444220642854
ETH,"East hararge, cluster 3",2021,456876,406112,253820,50764,0,1167572,304584,0.260869565217391,0.101449275362319,0.0434782608695652
ETH,East shewa,2020,751202,478038,202893,0,0,1432133,202893,0.141671897791616,0.0472239659305386,0.0157413219768462
ETH,East shewa,2021,621801,558614,209480,69827,0,1459722,279307,0.191342598111147,0.0797261396348072,0.0372055622767745
ETH,"Eastern, cluster 1",2020,234390,127849,42616,21308,0,426163,63924,0.149998944066003,0.066666197362668,0.033333098681334
ETH,"Eastern, cluster 1",2021,150298,193241,233082,129490,51796,757907,414368,0.546726709213663,0.284753494382116,0.178445523146126
ETH,"Eastern, cluster 2",2020,137601,96320,27520,13760,0,275201,41280,0.149999454943841,0.0666664244194849,0.0333332122097425
ETH,"Eastern, cluster 2",2021,97057,172436,310385,137949,34487,752314,482821,0.641781224329203,0.305609980229886,0.173178870642961
ETH,Ebenat,2019,134507,73368,61140,24456,0,293471,85596,0.291667660518416,0.125000425936464,0.0601853902657049
ETH,Ebenat,2020,98529,73897,49264,24632,0,246322,73896,0.299997564163981,0.133332250739547,0.0666661253697734
ETH,Enarj enawga,2019,99380,63242,45173,9035,0,216830,54208,0.250002305953973,0.0972236314163169,0.0416675634265451
ETH,Enarj enawga,2020,90997,63698,27299,0,0,181994,27299,0.149999450531336,0.0499998168437787,0.0166666056145929
ETH,Enebse sarmder,2019,78584,50008,35720,7144,0,171456,42864,0.25,0.0972222222222222,0.0416666666666667
ETH,Enebse sarmder,2020,71955,50369,21587,0,0,143911,21587,0.150002432058703,0.0500008106862343,0.0166669368954114
ETH,Erer,2020,68046,136092,81655,13609,0,299402,95264,0.318180907275169,0.121211615152871,0.0505047468695006
ETH,Erer,2021,55846,97730,83768,41884,0,279228,125652,0.449997851218359,0.199999044985937,0.0999995224929687
ETH,Erob,2019,14424,6557,5245,1311,0,27537,6556,0.238079674619603,0.0952294488627423,0.0423228545028305
ETH,Erob,2020,15820,7910,1318,1318,0,26366,2636,0.0999772434195555,0.0499886217097778,0.0277714565054321
ETH,FDP - Filtu Dolo Pastoral,2019,52825,70434,52825,8804,0,184888,61629,0.33333153044005,0.126983182611455,0.0529095091803326
ETH,FDP - Filtu Dolo Pastoral,2020,63087,54075,63087,0,0,180249,63087,0.349999167817852,0.116666389272617,0.0388887964242058
ETH,FKP - Fik Pastoral  Livelihood Zone March,2019,117006,117006,100291,16715,0,351018,117006,0.333333333333333,0.126983991324282,0.0529099172502075
ETH,FKP - Fik Pastoral  Livelihood Zone March,2020,85552,136884,102663,17110,0,342209,119773,0.349999561671376,0.133332748895168,0.0555550685237514
ETH,Fafan,2020,433750,377193,144583,48194,0,1003720,192777,0.192062527398079,0.0800259700580507,0.0373454084140331
ETH,Fafan,2021,346235,346235,197849,98924,0,989243,296773,0.300000101087397,0.133333265941735,0.0666665768112025
ETH,GAP - Gode Agropastoral Livelihood Zone,2019,43283,57710,50497,7214,0,158704,57711,0.363639227744732,0.136364972947542,0.0555562556709346
ETH,GAP - Gode Agropastoral Livelihood Zone,2020,36922,59075,44306,7384,0,147687,51690,0.349996953015499,0.133331527712888,0.0555544270427774
ETH,GCO Gedeo Coffee LZ,2019,201893,134596,89730,67298,0,493517,157028,0.318181541871911,0.151515212917353,0.0808082036124839
ETH,GCO Gedeo Coffee LZ,2020,182674,159839,68503,45668,0,456684,114171,0.25,0.116666374706945,0.0611108191513899
ETH,GGE Gamo Gofa Enset and Barley LZ,2019,201335,92924,30975,0,0,325234,30975,0.0952391201411907,0.0317463733803969,0.0105821244601323
ETH,GGE Gamo Gofa Enset and Barley LZ,2020,141881,110352,47294,15765,0,315292,63059,0.200001902997856,0.0833343905543644,0.0388895232215075
ETH,GMR Gamo Gofa Maize and Root Crop LZ,2019,364895,232206,99517,33172,0,729790,132689,0.181818057249346,0.0757574096657943,0.0353533969437174
ETH,GMR Gamo Gofa Maize and Root Crop LZ,2020,270129,236363,135065,33766,0,675323,168831,0.250000370193226,0.100000049359097,0.0444444115383799
ETH,Gamo,2020,849954,392287,104590,52295,0,1399126,156885,0.112130715889777,0.0498358737287897,0.0249179368643949
ETH,Gamo,2021,532799,466199,266400,66600,0,1331998,333000,0.250000375375939,0.100000150150376,0.0444445111779447
ETH,"Gbc-Guji Enset, Barley and Cattle Livelihood",2019,163038,97823,48911,16304,0,326076,65215,0.199999386646058,0.0833333333333333,0.0388890251897649
ETH,"Gbc-Guji Enset, Barley and Cattle Livelihood",2020,166145,99687,49843,16614,0,332289,66457,0.199997592457168,0.0833320794047752,0.0388881699698489
ETH,Gedeo,2020,588409,317104,158552,39638,0,1103703,198190,0.179568235295184,0.0718272941180734,0.0319232418302549
ETH,Gedeo,2021,507165,242103,161402,80701,0,991371,242103,0.244210290597566,0.108537906932252,0.0542689534661259
ETH,Gofa,2020,351083,136731,54013,0,0,541827,54013,0.0996868003993895,0.0332289334664632,0.0110763111554877
ETH,Gofa,2021,247588,192568,110039,0,0,550195,110039,0.2,0.0666666666666667,0.0222222222222222
ETH,"Gsw-Goro–Ginir Teff, Wheat & Spices",2019,18630,11856,5081,0,0,35567,5081,0.142857142857143,0.0476190476190476,0.0158730158730159
ETH,"Gsw-Goro–Ginir Teff, Wheat & Spices",2020,18985,10356,5178,0,0,34519,5178,0.15000434543295,0.05000144847765,0.01666714949255
ETH,Guji,2020,710784,383808,258467,63968,0,1417027,322435,0.227543300162947,0.0908952334712042,0.040330055657216
ETH,Guji,2021,528562,396422,396422,65347,0,1386753,461769,0.332985758819343,0.126702688462425,0.0527058531692378
ETH,"Guraghe, cluster 1",2020,346691,92451,23113,0,0,462255,23113,0.0500005408270327,0.0166668469423442,0.00555561564744808
ETH,"Guraghe, cluster 1",2021,258979,141261,94174,23544,0,517958,117718,0.227273253815946,0.090909558947508,0.0404043914328532
ETH,"Guraghe, cluster 2",2020,753534,141288,47096,0,0,941918,47096,0.0500001061663542,0.0166667020554514,0.00555556735181713
ETH,"Guraghe, cluster 2",2021,671637,191896,143922,47974,0,1055429,191896,0.181818009548724,0.0757575039786349,0.0353535018566963
ETH,HDP - Harshin Degahbur Pastoral Livelihood Zone,2019,207927,184824,115515,0,0,508266,115515,0.227272727272727,0.0757575757575758,0.0252525252525253
ETH,HDP - Harshin Degahbur Pastoral Livelihood Zone,2020,141897,189196,141897,0,0,472990,141897,0.3,0.1,0.0333333333333333
ETH,HGZ Hadero Ginger LZ,2019,50864,25432,16955,0,0,93251,16955,0.18182110647607,0.0606070354920233,0.0202023451640078
ETH,HGZ Hadero Ginger LZ,2020,38831,25887,21573,0,0,86291,21573,0.250002897173518,0.0833342990578392,0.0277780996859464
ETH,HMC/IBA - Chamo-Abaya Irrigated Banana,2019,88139,40679,20340,6780,0,155938,27120,0.173915274019161,0.0724646975079839,0.0338168588370592
ETH,HMC/IBA - Chamo-Abaya Irrigated Banana,2020,69013,34506,27605,6901,0,138025,34506,0.249998188733925,0.0999987924892834,0.0444436394373
ETH,HWE Hadiya-Kembata Cereal and Enset LZ – Hadiya sub zon,2019,67414,20743,20743,5186,0,114086,25929,0.22727591466087,0.0909109502188408,0.0404051914053141
ETH,HWE Hadiya-Kembata Cereal and Enset LZ – Hadiya sub zon,2020,52786,26393,21114,5279,0,105572,26393,0.25,0.100001262961139,0.0444457074055831
ETH,Hadiya,2020,647913,518330,194374,64791,0,1425408,259165,0.181818118040589,0.0757574907207854,0.0353534644895434
ETH,Hadiya,2021,527648,461692,263824,65956,0,1319120,329780,0.25,0.1,0.0444444444444444
ETH,"Hadiya, cluster 1",2020,527699,307825,43975,0,0,879499,43975,0.0500000568505479,0.0166666856168493,0.0055555618722831
ETH,"Hadiya, cluster 1",2021,492742,313563,134384,0,0,940689,134384,0.142856990992772,0.0476189969975908,0.0158729989991969
ETH,"Hadiya, cluster 2",2020,247592,173314,74278,0,0,495184,74278,0.150000807780542,0.0500002692601807,0.0166667564200602
ETH,"Hadiya, cluster 2",2021,226987,176545,75662,25221,0,504415,100883,0.2,0.0833334985412144,0.03888905409677
ETH,"Halaba special, cluster 1",2020,106404,85123,21281,0,0,212808,21281,0.100000939814293,0.0333336466047642,0.0111112155349214
ETH,"Halaba special, cluster 1",2021,108387,75871,32516,10839,0,227613,43355,0.190476818107929,0.0793657069968177,0.0370375251950557
ETH,JAP - Jijiga Agropastoral Livelihood Zone,2019,242599,242599,181949,0,0,667147,181949,0.272727000196359,0.0909090000654528,0.0303030000218176
ETH,JAP - Jijiga Agropastoral Livelihood Zone,2020,217295,248337,155211,0,0,620843,155211,0.250000402678294,0.0833334675594313,0.0277778225198104
ETH,JSF - Jijiga Sedentary Farming  Livelihood Zone,2019,105242,140323,122783,17540,0,385888,140323,0.363636599220499,0.136363400779501,0.0555552676193899
ETH,JSF - Jijiga Sedentary Farming  Livelihood Zone,2020,89777,143642,125687,0,0,359106,125687,0.34999972153069,0.116666573843563,0.0388888579478545
ETH,Janamora,2019,95576,66903,57346,28673,0,248498,86019,0.346155703466426,0.153846979318412,0.0769234896592058
ETH,Janamora,2020,57759,67386,48133,19253,0,192531,67386,0.350000779095315,0.150000086566146,0.0722221356560762
ETH,Jarar,2020,217538,190346,108769,27192,0,543845,135961,0.249999540310199,0.0999996935401325,0.0444442401378661
ETH,Jarar,2021,167414,195317,139512,55805,0,558048,195317,0.35000035839211,0.150000238928073,0.0722223815076043
ETH,KAP - Korahe Agropastoral Livelihood Zone,2019,33101,44134,33101,11034,0,121370,44135,0.363640108758342,0.151517398588339,0.0707084855309293
ETH,KAP - Korahe Agropastoral Livelihood Zone,2020,33884,39531,33884,5647,0,112946,39531,0.349999114621146,0.133332152828195,0.0555545718012738
ETH,KBC Kedida-Badewacho Coffee LZ,2019,70568,40324,5041,0,0,115933,5041,0.0434820111616192,0.0144940037205397,0.00483133457351325
ETH,KBC Kedida-Badewacho Coffee LZ,2020,66700,25654,10262,0,0,102616,10262,0.100003898027598,0.033334632675866,0.0111115442252887
ETH,KCE Hadiya-Kembata Cereal and Enset LZ – Kembata sub-zo,2019,123849,41283,16513,0,0,181645,16513,0.0909080899556828,0.0303026966518943,0.0101008988839648
ETH,KCE Hadiya-Kembata Cereal and Enset LZ – Kembata sub-zo,2020,100853,42022,25213,0,0,168088,25213,0.149998810147066,0.0499996033823553,0.0166665344607851
ETH,KGP - Korahe Gode Pastoral Livelihood Zone,2019,92549,79328,92549,13221,0,277647,105770,0.380951351896473,0.142856456819871,0.0582006008428768
ETH,KGP - Korahe Gode Pastoral Livelihood Zone,2020,94738,81204,81204,13534,0,270680,94738,0.35,0.133333333333333,0.0555555555555556
ETH,Kembata Tembaro,2020,317057,282874,94291,35229,0,729451,129520,0.177558191023112,0.075284471929346,0.0358270961464322
ETH,Kembata Tembaro,2021,358852,223968,127982,35885,0,746687,163867,0.219458755810668,0.0891725716397902,0.0404039592374196
ETH,Korahe,2020,256941,107059,64235,21412,0,449647,85647,0.190476084573009,0.0793652205693207,0.0370372017753186
ETH,Korahe,2021,131795,153761,109829,43932,0,439317,153761,0.350000113813032,0.150000265563743,0.0722224624941797
ETH,LAP - Liban Agropastoral Livelihood Zone,2019,33408,44544,33408,11136,0,122496,44544,0.363636363636364,0.151515151515152,0.0707070707070707
ETH,LAP - Liban Agropastoral Livelihood Zone,2020,34198,45598,28499,5700,0,113995,34199,0.300004386157288,0.11666885974531,0.0500012183770243
ETH,LHP - Lowland Hawd Pastoral Livelihood Zone,2019,190328,217518,163139,27190,0,598175,190329,0.318182806035023,0.12121257714437,0.0505052869143645
ETH,LHP - Lowland Hawd Pastoral Livelihood Zone,2020,194830,222663,111331,27833,0,556657,139164,0.249999550890405,0.0999999401187206,0.0444444843652974
ETH,Liban,2020,91122,205025,113903,45561,0,455611,159464,0.350000329228223,0.150000036580914,0.0722221856413085
ETH,Liban,2021,93481,163591,140221,70110,0,467403,210331,0.449999251181529,0.199999429471641,0.0999995958757456
ETH,Loka abaya,2019,84867,30310,18186,0,0,133363,18186,0.136364658863403,0.045454886287801,0.0151516287626003
ETH,Loka abaya,2020,74046,30853,18512,0,0,123411,18512,0.150002836051892,0.0500009453506306,0.0166669817835435
ETH,MWP - Moyale Woyamo Pastoral Livelihood Zone,2019,109850,146467,109850,36617,0,402784,146467,0.363636589338206,0.151515452450941,0.0707073214868957
ETH,MWP - Moyale Woyamo Pastoral Livelihood Zone,2020,112449,149932,93707,18741,0,374829,112448,0.299998132481745,0.116665643978098,0.0499993923154885
ETH,Mcb-Moyale Agro-Pastoral Labor and Cross-Border Trade,2019,11370,11370,7107,1421,0,31268,8528,0.272738902392222,0.106061575199352,0.0454529302233025
ETH,Mcb-Moyale Agro-Pastoral Labor and Cross-Border Trade,2020,8690,10139,8690,1448,0,28967,10138,0.349984465080954,0.13332412745538,0.0555498018818349
ETH,"Mcp-Moyale Cattle, Shoats and Camel Pastoralist",2019,1148,2678,3443,765,0,8034,4208,0.523773960667165,0.206331424778027,0.0899372112964346
ETH,"Mcp-Moyale Cattle, Shoats and Camel Pastoralist",2020,1169,2729,3118,780,0,7796,3898,0.5,0.200017102787754,0.0889059916766433
ETH,Mereb lehe,2019,66820,27842,27842,5568,0,128072,33410,0.260868886251484,0.101448143752473,0.0434772801410318
ETH,Mereb lehe,2020,61582,22393,27992,0,0,111967,27992,0.250002232800736,0.0833340776002453,0.0277780258667484
ETH,Mip-Market Isolated Pastoralist,2019,13884,16198,11570,6942,0,48594,18512,0.380952380952381,0.174603174603175,0.0899470899470899
ETH,Mip-Market Isolated Pastoralist,2020,14149,14149,11791,7074,0,47163,18865,0.399995759387656,0.183328739336627,0.0944407928060367
ETH,NHB - North Wollo Highland Belg Livelihood Zone,2019,38326,26828,7665,3833,0,76652,11498,0.150002609194802,0.0666692758614691,0.0333353627070686
ETH,NHB - North Wollo Highland Belg Livelihood Zone,2020,23161,27021,19301,7720,0,77203,27021,0.349999352356774,0.149998488832472,0.0722208549754112
ETH,NMP - Namalefane Baadu Pastoral Livelihood Zone,2019,17562,35125,39515,4391,0,96593,43906,0.454546395701552,0.166668392119512,0.0656580819636114
ETH,NMP - Namalefane Baadu Pastoral Livelihood Zone,2020,22287,35658,31201,0,0,89146,31201,0.349998878244677,0.116666292748226,0.0388887642494086
ETH,"NSS - North Shewa Highland Sheep, Wheat and Barley LZ",2019,190776,190776,71541,23847,0,476940,95388,0.2,0.0833333333333333,0.0388888888888889
ETH,"NSS - North Shewa Highland Sheep, Wheat and Barley LZ",2020,144113,168132,120095,48038,0,480378,168133,0.3500014571858,0.1500006245082,0.0722225229113555
ETH,NWE - North Wollo East Plain Livelihood Zone,2019,327038,100627,50314,25157,0,503136,75471,0.150001192520511,0.0666671966757828,0.0333335983378914
ETH,NWE - North Wollo East Plain Livelihood Zone,2020,253382,126691,101353,25338,0,506764,126691,0.25,0.0999998684463248,0.0444443128907692
ETH,Nap-North-East Agro-Pastoral,2019,69510,125118,55608,41706,0,291942,97314,0.333333333333333,0.158730158730159,0.0846560846560847
ETH,Nap-North-East Agro-Pastoral,2020,56668,113335,70835,42501,0,283339,113336,0.400001411736471,0.183333980379216,0.0944447777711112
ETH,Nogob,2020,68239,87736,33246,9748,0,198969,42994,0.216083912569295,0.0883588230662398,0.0403401758286187
ETH,Nogob,2021,42633,80039,60029,20010,0,202711,80039,0.394842904430445,0.164518287940303,0.0767754202890925
ETH,"North gondar, cluster 1",2020,308619,57866,19289,0,0,385774,19289,0.0500007776573849,0.016666925885795,0.00555564196193166
ETH,"North gondar, cluster 1",2021,272999,142045,142045,40584,0,597673,182629,0.305566756403585,0.124490036078815,0.0565863124335734
ETH,"North gondar, cluster 2",2020,269761,77075,38537,0,0,385373,38537,0.0999992215334235,0.0333330738444745,0.0111110246148248
ETH,"North gondar, cluster 2",2021,253235,97398,155837,58439,0,564909,214276,0.379310650033899,0.160919723353673,0.0766284677905842
ETH,North shewa,2020,1614215,379815,191361,0,0,2185391,191361,0.0875637357342462,0.0291879119114154,0.0097293039704718
ETH,North shewa,2021,1246372,479374,290185,96728,0,2112659,386913,0.183140298552677,0.0763084182855192,0.0356105741627021
ETH,"North shewa oromia, cluster 1",2020,426404,341123,85281,0,0,852808,85281,0.100000234519376,0.0333334115064587,0.0111111371688196
ETH,"North shewa oromia, cluster 1",2021,392397,348798,130799,43600,0,915594,174399,0.190476346502926,0.0793652353918149,0.0370371583911646
ETH,"North shewa oromia, cluster 2",2020,96659,61510,17574,0,0,175743,17574,0.0999982929618818,0.0333327643206273,0.0111109214402091
ETH,"North shewa oromia, cluster 2",2021,89849,71879,17970,8985,0,188683,26955,0.142858657112723,0.0634927364945438,0.0317463682472719
ETH,"North shewa oromia, cluster 3",2020,267397,102845,41138,0,0,411380,41138,0.1,0.0333333333333333,0.0111111111111111
ETH,"North shewa oromia, cluster 3",2021,252380,147222,63095,0,0,462697,63095,0.136363538125382,0.0454545127084608,0.0151515042361536
ETH,North wello,2020,1258936,518385,223868,74055,0,2075244,297923,0.143560468070261,0.0597484761631243,0.0278461499252886
ETH,North wello,2021,1046827,377199,448712,149571,0,2022309,598283,0.295841535591247,0.123267347703376,0.0575247842386544
ETH,"North western, cluster 1",2020,380783,135994,27199,0,0,543976,27199,0.0500003676632793,0.0166667892210931,0.00555559640703103
ETH,"North western, cluster 1",2021,275167,220133,431411,647117,143804,1717632,1222332,0.711637882852672,0.418610622065728,0.279073812732361
ETH,"North western, cluster 2",2020,68617,28590,17154,0,0,114361,17154,0.14999868836404,0.0499995627880134,0.0166665209293378
ETH,"North western, cluster 2",2021,51462,40026,49248,30780,6156,177672,86184,0.485073618803188,0.242536809401594,0.142442253140619
ETH,Oap-Borena Agro-Pastoral Livelihood,2019,138071,184095,115060,69036,0,506262,184096,0.363637800190415,0.166667325087274,0.0858589250449592
ETH,Oap-Borena Agro-Pastoral Livelihood,2020,117252,164152,117252,70351,0,469007,187603,0.400000426432868,0.18333343994155,0.0944444562898019
ETH,"Oromia, cluster 1",2020,52705,67763,22588,7529,0,150585,30117,0.2,0.0833327799360273,0.0388883354915828
ETH,"Oromia, cluster 1",2021,45670,68505,30447,15223,0,159845,45670,0.285714285714286,0.126983431866287,0.0634913683742236
ETH,"Oromia, cluster 2",2020,191711,111831,15976,0,0,319518,15976,0.0500003129714132,0.0166667709904711,0.00555559033015702
ETH,"Oromia, cluster 2",2021,177659,129206,48452,16151,0,371468,64603,0.173912692344966,0.072463846145563,0.0338165811800149
ETH,RVL - Raya Valley Livelihood Zone,2019,93318,104982,46659,11665,0,256624,58324,0.227274144273334,0.090909917492778,0.0404045520987039
ETH,RVL - Raya Valley Livelihood Zone,2020,117276,70365,46910,0,0,234551,46910,0.199999147306982,0.0666663824356608,0.0222221274785536
ETH,SAP - Shinile Agropastoral Livelihood Zone,2019,34849,46465,40657,5808,0,127779,46465,0.363635652180718,0.136363043483932,0.0555551207771056
ETH,SAP - Shinile Agropastoral Livelihood Zone,2020,41619,41619,35673,0,0,118911,35673,0.299997477104725,0.0999991590349085,0.0333330530116362
ETH,SBW,2019,194037,36382,36382,0,0,266801,36382,0.136363806732359,0.0454546022441195,0.0151515340813732
ETH,SBW,2020,185166,37033,24689,0,0,246888,24689,0.100000810083925,0.0333336033613082,0.0111112011204361
ETH,SCO Sidama Coffee LZ,2019,344009,86002,21501,0,0,451512,21501,0.047619996810716,0.0158733322702387,0.00529111075674622
ETH,SCO Sidama Coffee LZ,2020,306396,87542,43771,0,0,437709,43771,0.100000228462289,0.0333334094874296,0.0111111364958099
ETH,SHP - Shinile Pastoral  Livelihood Zone,2019,168708,147620,126531,21089,0,463948,147620,0.318182210075267,0.121212578421145,0.0505054206266411
ETH,SHP - Shinile Pastoral  Livelihood Zone,2020,172698,151111,107937,0,0,431746,107937,0.25000115808832,0.0833337193627735,0.0277779064542578
ETH,SHR - Shabelle Riverine Livelihood Zone,2019,80245,93619,93619,13374,0,280857,106993,0.380951872305123,0.142856803758971,0.0582008321356103
ETH,SHR - Shabelle Riverine Livelihood Zone,2020,109524,82143,82143,0,0,273810,82143,0.3,0.1,0.0333333333333333
ETH,SMB Sidama Maize Belt LZ,2019,316330,84355,63266,0,0,463951,63266,0.136363538390908,0.0454545127969692,0.0151515042656564
ETH,SMB Sidama Maize Belt LZ,2020,300527,85865,42932,0,0,429324,42932,0.0999990683027271,0.0333330227675757,0.0111110075891919
ETH,SOC South Omo Crop LZ,2019,37768,8887,2222,0,0,48877,2222,0.0454610553020848,0.0151536851006949,0.00505122836689831
ETH,SOC South Omo Crop LZ,2020,31660,6784,4523,2261,0,45228,6784,0.149995577960555,0.0666622446272221,0.0333298939693209
ETH,SOP South Omo Pastoral LZ,2019,33186,26549,19912,0,0,79647,19912,0.250003138850176,0.0833343796167255,0.0277781265389085
ETH,SOP South Omo Pastoral LZ,2020,33780,23646,10134,0,0,67560,10134,0.15,0.05,0.0166666666666667
ETH,SWB - South Wollo Belg Livelihood Zone,2019,243103,141810,40517,20259,0,445689,60776,0.136364146299325,0.060606536546037,0.0303033929239647
ETH,SWB - South Wollo Belg Livelihood Zone,2020,163237,142832,61214,40809,0,408092,102023,0.25,0.11666650330481,0.0611109477492548
ETH,Saesie Tsaedamba,2019,67459,53967,26984,0,0,148410,26984,0.181820632032882,0.060606877344294,0.020202292448098
ETH,Saesie Tsaedamba,2020,40694,47476,40694,6782,0,135646,47476,0.34999926278696,0.133332350382614,0.0555547364299557
ETH,Segen,2020,300313,386117,171607,32094,0,890131,203701,0.228843844333025,0.0882997371547933,0.0374455495252322
ETH,Segen,2021,305912,262210,262210,43702,0,874034,305912,0.350000114412025,0.1333334858827,0.055555682680028
ETH,Sekota,2019,66030,46221,39618,19809,0,171678,59427,0.346153846153846,0.153846153846154,0.0769230769230769
ETH,Sekota,2020,53205,46554,33253,0,0,133012,33253,0.25,0.0833333333333333,0.0277777777777778
ETH,Shabelle,2020,159032,265054,185537,26505,0,636128,212042,0.333332285326224,0.124999475996445,0.0509256348128399
ETH,Shabelle,2021,135956,190339,163148,54383,0,543826,217531,0.400001103294068,0.166667279607816,0.0777781455424672
ETH,Sidama,2020,2833245,794479,476687,0,0,4104411,476687,0.116140172122139,0.0387133907073796,0.0129044635691265
ETH,Sidama,2021,2525304,808760,647008,161752,0,4142824,808760,0.195219492790425,0.07808779711617,0.0347056876071867
ETH,"Siltie, cluster 1",2020,197078,39416,26277,0,0,262771,26277,0.0999996194405014,0.0333332064801671,0.0111110688267224
ETH,"Siltie, cluster 1",2021,160603,93720,40166,13389,0,307878,53555,0.173948771916149,0.0724789256350459,0.0338236429870129
ETH,"Siltie, cluster 2",2020,347503,208502,104251,34750,0,695006,139001,0.1999997122327,0.0833330935272501,0.0388887130310945
ETH,"Siltie, cluster 2",2021,283184,283184,106194,70796,0,743358,176990,0.238095238095238,0.111111111111111,0.0582010582010582
ETH,Siti,2020,232398,261447,116199,58099,0,668143,174298,0.260869304924245,0.115941747001266,0.0579707903514334
ETH,Siti,2021,178809,268213,119206,29801,0,596029,149007,0.249999580557322,0.0999996085201671,0.0444441461740956
ETH,Skv-Siraro-Kofele Potato and Vegetable,2019,30670,46004,25558,5112,0,107344,30670,0.285716947384111,0.111113181298753,0.0476205263245061
ETH,Skv-Siraro-Kofele Potato and Vegetable,2020,26045,41672,26045,10418,0,104180,36463,0.35,0.15,0.0722222222222222
ETH,"Smc-Sorghum, Maize & Chat",2019,617654,1111776,494123,370592,0,2594145,864715,0.333333333333333,0.158730140373803,0.0846560662997293
ETH,"Smc-Sorghum, Maize & Chat",2020,503537,1007074,629421,377653,0,2517685,1007074,0.4,0.183333366432523,0.0944444775436341
ETH,"South eastern, cluster 1",2020,207902,113401,37800,18900,0,378003,56700,0.149998809533258,0.0666661375703367,0.0333330687851684
ETH,"South eastern, cluster 1",2021,152359,133314,159679,136868,22811,605031,319358,0.527837416595183,0.276486108425298,0.167567171489285
ETH,"South gondar, cluster 1",2020,492211,205088,123053,0,0,820352,123053,0.150000243797784,0.0500000812659281,0.0166666937553094
ETH,"South gondar, cluster 1",2021,414668,331734,165867,41467,0,953736,207334,0.217391395522451,0.0869566281095258,0.0386474291045367
ETH,South omo,2020,273724,240244,137282,68641,0,719891,205923,0.286047471075482,0.127132209366881,0.0635661046834405
ETH,South omo,2021,244722,247683,174801,69921,0,737127,244722,0.331994351041272,0.142283487106021,0.068506964652405
ETH,South wello,2020,2298558,811256,408742,135209,0,3653765,543951,0.148874106572262,0.0619598323008367,0.0288766975070008
ETH,South wello,2021,2047811,688696,413218,137739,0,3287464,550957,0.167593318132153,0.0698305238729104,0.0325875642879875
ETH,Southern,2020,401184,201723,57635,28656,0,689198,86291,0.125204948360268,0.0555945703073234,0.0277712484494861
ETH,Southern,2021,261136,261136,231134,115567,0,868973,346701,0.398977873881007,0.17732349950267,0.0886617497513348
ETH,TER - Teru Pastoral Livelihood Zone,2019,139894,139894,119909,39970,0,439667,159879,0.36363657040442,0.151515427205893,0.0707073004493552
ETH,TER - Teru Pastoral Livelihood Zone,2020,142019,162307,81154,20288,0,405768,101442,0.25,0.0999996714050065,0.0444441158494509
ETH,TSC - Tsirare Catchment Livelihood Zone,2019,62600,37560,31300,6260,0,137720,37560,0.272727272727273,0.106060606060606,0.0454545454545455
ETH,TSC - Tsirare Catchment Livelihood Zone,2020,56643,44056,25175,0,0,125874,25175,0.200001588890478,0.0666671962968259,0.0222223987656086
ETH,Telemt,2019,20176,26902,26902,10088,0,84068,36990,0.440000951610601,0.186666349463133,0.0888883602163328
ETH,Telemt,2020,10161,20322,27096,10161,0,67740,37257,0.55,0.233333333333333,0.111111111111111
ETH,Tselemti,2019,87622,51113,29207,7302,0,175244,36509,0.208332382278423,0.0833333333333333,0.0370372483825726
ETH,Tselemti,2020,88094,29365,29365,0,0,146824,29365,0.200001362175121,0.0666671207250404,0.0222223735750135
ETH,WCG Wolayita Ginger and Coffee LZ,2019,61814,55633,24726,6181,0,148354,30907,0.208332771613843,0.0833322098943518,0.037036038424609
ETH,WCG Wolayita Ginger and Coffee LZ,2020,44044,56628,18876,6292,0,125840,25168,0.2,0.0833333333333333,0.0388888888888889
ETH,WMB - South Wollo Meher & Belg Livelihood Zone,2019,85700,35709,14283,7142,0,142834,21425,0.149999299886582,0.0666671334089456,0.0333339556563719
ETH,WMB - South Wollo Meher & Belg Livelihood Zone,2020,86318,28773,21580,7193,0,143864,28773,0.200001390201857,0.0833333333333333,0.0388885799551428
ETH,WMR Wolayita Maize and Root Crop LZ,2019,282957,282957,125759,31440,0,723113,157199,0.217392025865944,0.0869569025403591,0.0386475634590383
ETH,WMR Wolayita Maize and Root Crop LZ,2020,192015,256020,128010,64005,0,640050,192015,0.3,0.133333333333333,0.0666666666666667
ETH,WWB Wolayita Barley and Wheat LZ,2019,98687,111023,37008,12336,0,259054,49344,0.190477661028203,0.0793656920950844,0.0370373229777061
ETH,WWB Wolayita Barley and Wheat LZ,2020,87897,100454,50227,12557,0,251135,62784,0.250000995480518,0.100000663653679,0.0444448868802304
ETH,"Wag hamra, cluster 1",2020,100950,42063,25238,0,0,168251,25238,0.150002080225378,0.0500006934084592,0.0166668978028197
ETH,"Wag hamra, cluster 1",2021,85046,51028,76815,25605,0,238494,102420,0.429444765906061,0.178935319127525,0.0835031489261784
ETH,"Wag hamra, cluster 2",2020,208740,59640,29820,0,0,298200,29820,0.1,0.0333333333333333,0.0111111111111111
ETH,"Wag hamra, cluster 2",2021,165806,105513,45220,15073,0,331612,60293,0.181817907675235,0.0757572102336466,0.035353230750261
ETH,Wbp- Wheat Barely and Potato,2019,169389,304900,169389,33878,0,677556,203267,0.300000295178554,0.116666863452369,0.0500001311904682
ETH,Wbp- Wheat Barely and Potato,2020,172616,310709,172616,34523,0,690464,207139,0.299999710339714,0.116666473559809,0.0499998712620949
ETH,West arsi,2020,1176805,941444,465875,0,0,2584124,465875,0.18028353128565,0.0600945104285501,0.0200315034761834
ETH,West arsi,2021,1070814,962628,481314,0,0,2514756,481314,0.191395904811441,0.063798634937147,0.0212662116457157
ETH,West guji,2020,507153,338102,225401,111565,0,1182221,336966,0.285027926250676,0.126465638263348,0.063126099096531
ETH,West guji,2021,230472,460944,398893,172854,0,1263163,571747,0.452631212282184,0.196491136403879,0.095906422563394
ETH,West hararge,2020,800858,1029674,457633,114408,0,2402573,572041,0.238095158815154,0.0952380357780319,0.0423280004857755
ETH,West hararge,2021,701246,818121,584372,233749,0,2337488,818121,0.350000085561937,0.150000057041291,0.0722222602497496
ETH,"West hararge, cluster 1",2020,449860,578391,192797,64266,0,1285314,257063,0.200000155604,0.0833334630033336,0.0388889839802224
ETH,"West hararge, cluster 1",2021,394266,591399,328555,65711,0,1379931,394266,0.285714285714286,0.111111111111111,0.0476190476190476
ETH,"West hararge, cluster 2",2020,181115,241486,150929,30186,0,603716,181115,0.300000331281596,0.116666887521064,0.0500001472362649
ETH,"West hararge, cluster 2",2021,246919,216054,123459,30865,0,617297,154324,0.249999595008562,0.0999999460011415,0.0444444804436834
ETH,"West hararge, cluster 3",2020,210956,147669,42191,21096,0,421912,63287,0.1500004740325,0.0666671406991663,0.0333337020252775
ETH,"West hararge, cluster 3",2021,194130,172560,64710,21570,0,452970,86280,0.19047619047619,0.0793650793650794,0.037037037037037
ETH,Wolayita,2020,1028160,499941,285681,142840,0,1956622,428521,0.219010621366825,0.0973379971535977,0.0486689701831921
ETH,Wolayita,2021,886200,402818,290816,80564,0,1660398,371380,0.223669264838912,0.0907300538786484,0.0410257728033346
ETH,Zone 1 (awsi rasu),2020,156639,144568,192758,72284,0,566249,265042,0.468066168770276,0.198573419114206,0.0945587149430335
ETH,Zone 1 (awsi rasu),2021,139276,147199,171732,73600,0,531807,245332,0.461317733689102,0.1999046019828,0.0973895500518881
ETH,Zone 2 (kilbet rasu),2020,172506,172506,151725,43350,0,540087,195075,0.361191807986491,0.14715221806857,0.0668873718493502
ETH,Zone 2 (kilbet rasu),2021,109561,175297,239163,47833,0,571854,286996,0.501869358262773,0.195171611401978,0.0836450873435838
ETH,Zone 3 (gabi rasu),2020,74122,83387,74517,27944,0,259970,102461,0.394126245336,0.167205190342475,0.0796215802678087
ETH,Zone 3 (gabi rasu),2021,65905,66388,56904,18968,0,208165,75872,0.364480099920736,0.151866708300307,0.0708711305401431
ETH,Zone 4 (fantana rasu),2020,115852,103490,90553,25872,0,335767,116425,0.346743426244985,0.141265619710494,0.0642115249893858
ETH,Zone 4 (fantana rasu),2021,78484,91565,137443,27489,0,334981,164932,0.492362253381535,0.191474541342146,0.0820607072573602
ETH,Zone 5 (hari rasu),2020,137469,109975,56075,18692,0,322211,74767,0.232043598759819,0.0966850914462883,0.0451198472774397
ETH,Zone 5 (hari rasu),2021,83815,111754,69846,19030,0,284445,88876,0.31245407723813,0.126452096773249,0.0570178573869973
GHA,Ada east,2021,79795,13624,3892,0,0,97311,3892,0.0399954784145677,0.0133318261381892,0.00444394204606308
GHA,Ada east,2022,84661,18339,8405,0,0,111405,8405,0.0754454467932319,0.0251484822644106,0.00838282742147021
GHA,Ada west,2021,63436,12045,4015,803,0,80299,4818,0.0600007472073127,0.0233336239139549,0.0100001245345521
GHA,Ada west,2022,69860,8030,5326,0,0,83216,5326,0.0640021149778889,0.021334038325963,0.00711134610865432
GHA,Agona west municipal,2021,113819,23962,11981,0,0,149762,11981,0.0800002670904502,0.0266667556968167,0.00888891856560558
GHA,Agona west municipal,2022,128795,23270,5990,0,0,158055,5990,0.0378981999936731,0.0126327333312244,0.00421091111040812
GHA,Ahafo,2020,527222,61305,24522,0,0,613049,24522,0.0400000652476393,0.0133333550825464,0.00444445169418214
GHA,Ahafo,2021,551744,42913,18391,0,0,613048,18391,0.0299992822747974,0.0099997607582658,0.0033332535860886
GHA,Akatsi north,2021,29845,1946,649,0,0,32440,649,0.0200061652281134,0.00666872174270448,0.00222290724756816
GHA,Akatsi north,2022,31142,4881,1302,0,0,37325,1302,0.0348827863362358,0.0116275954454119,0.00387586514847064
GHA,Amansie central,2021,72216,22696,8253,0,0,103165,8253,0.0799980613580187,0.0266660204526729,0.0088886734842243
GHA,Amansie central,2022,90785,37221,15819,0,0,143825,15819,0.109987832435251,0.0366626108117504,0.0122208702705835
GHA,Amansie west,2021,87310,4595,0,0,0,91905,0,0,0,0
GHA,Amansie west,2022,88229,27354,8753,0,0,124336,8753,0.070397953931283,0.023465984643761,0.00782199488125366
GHA,Ashanti,2020,5509783,355470,59245,0,0,5924498,59245,0.0100000033758134,0.00333333445860448,0.00111111148620149
GHA,Ashanti,2021,5628273,296225,0,0,0,5924498,0,0,0,0
GHA,Asunafo south,2021,90236,16710,4456,0,0,111402,4456,0.0399992818800381,0.0133330939600127,0.00444436465333756
GHA,Asunafo south,2022,93579,14482,3668,0,0,111729,3668,0.0328294355091337,0.0109431451697112,0.00364771505657041
GHA,Asutifi south,2021,51793,8112,2496,0,0,62401,2496,0.0399993589846317,0.0133331196615439,0.00444437322051463
GHA,Asutifi south,2022,62239,9360,1368,0,0,72967,1368,0.0187482012416572,0.00624940041388573,0.00208313347129524
GHA,Ayensuano,2021,59009,17959,8552,0,0,85520,8552,0.1,0.0333333333333333,0.0111111111111111
GHA,Ayensuano,2022,85135,14189,3421,0,0,102745,3421,0.0332960241374276,0.0110986747124759,0.00369955823749196
GHA,Banda,2021,20217,4256,2128,0,0,26601,2128,0.0799969925942634,0.0266656641980878,0.00888855473269593
GHA,Banda,2022,24798,3945,1330,0,0,30073,1330,0.0442257174209424,0.0147419058069808,0.00491396860232693
GHA,Bawku municipal,2021,88200,25725,7350,1225,0,122500,8575,0.07,0.0266666666666667,0.0111111111111111
GHA,Bawku municipal,2022,106575,13475,2450,0,0,122500,2450,0.02,0.00666666666666667,0.00222222222222222
GHA,Bawku west,2021,105212,11690,0,0,0,116902,0,0,0,0
GHA,Bawku west,2022,129770,14419,4326,0,0,148515,4326,0.0291283708716291,0.00970945695720971,0.00323648565240324
GHA,Biakoye,2021,72365,5692,3252,0,0,81309,3252,0.0399955724458547,0.0133318574819516,0.00444395249398386
GHA,Biakoye,2022,74804,7183,4310,0,0,86297,4310,0.0499437987415553,0.0166479329138518,0.00554931097128393
GHA,Binduri,2021,38277,19138,15311,3828,0,76554,19139,0.250006531337357,0.100003483379924,0.0444464764160665
GHA,Binduri,2022,65944,16076,3834,0,0,85854,3834,0.0446572087497379,0.0148857362499126,0.00496191208330421
GHA,Bolga  east,2021,24238,7728,2459,703,0,35128,3162,0.0900136643133683,0.0366753966446519,0.0166723601305701
GHA,Bolga  east,2022,30210,14365,5824,0,0,50399,5824,0.115557848370007,0.0385192827900024,0.0128397609300008
GHA,Bongo,2021,47288,26271,23119,8407,0,105085,31526,0.300004758053005,0.126668887091402,0.0600011630796234
GHA,Bongo,2022,73355,42089,27658,7215,0,150317,34873,0.231996380981526,0.0933316480061027,0.0417768966768747
GHA,Bono,2020,1051926,93505,23376,0,0,1168807,23376,0.0199998802197454,0.00666662673991514,0.00222220891330505
GHA,Bono,2021,1086991,70128,11688,0,0,1168807,11688,0.00999994010987272,0.00333331336995757,0.00111110445665252
GHA,Bono east,2020,918352,158728,56688,0,0,1133768,56688,0.049999647194135,0.0166665490647117,0.00555551635490388
GHA,Bono east,2021,975040,113377,45351,0,0,1133768,45351,0.0400002469641055,0.0133334156547018,0.00444447188490062
GHA,Builsa north,2021,53382,11941,4917,0,0,70240,4917,0.07000284738041,0.0233342824601367,0.00777809415337889
GHA,Builsa north,2022,56894,10536,2810,0,0,70240,2810,0.04000569476082,0.01333523158694,0.00444507719564667
GHA,Builsa south,2021,32700,8175,4542,0,0,45417,4542,0.100006605456107,0.0333355351520356,0.0111118450506785
GHA,Builsa south,2022,36788,11704,6584,366,0,55442,6950,0.125356228130298,0.0439859071943052,0.0161289676097944
GHA,Bunkpurugu nakpanduri,2021,40543,29666,23733,4944,0,98886,28677,0.290000606759299,0.113332524320935,0.0488879450410911
GHA,Bunkpurugu nakpanduri,2022,48454,34610,16477,4943,0,104484,21420,0.205007465257839,0.084105381366206,0.0385481668644641
GHA,Central,2020,2344943,260549,0,0,0,2605492,0,0,0,0
GHA,Central,2021,2475217,130275,0,0,0,2605492,0,0,0,0
GHA,Central gonja,2021,60799,30399,20671,9728,0,121597,30399,0.249997944028224,0.109999972587043,0.0544448739141043
GHA,Central gonja,2022,70526,57105,29980,14276,0,171887,44256,0.257471478354966,0.113508681090872,0.0562927970119904
GHA,Chereponi,2021,46909,18915,7566,2270,0,75660,9836,0.130002643404705,0.0533350956031369,0.0244456192909801
GHA,Chereponi,2022,61284,24409,13948,0,0,99641,13948,0.139982537308939,0.0466608457696464,0.0155536152565488
GHA,Daffiama bussie issa,2021,38492,2961,846,0,0,42299,846,0.0200004728244167,0.00666682427480555,0.00222227475826852
GHA,Daffiama bussie issa,2022,40184,3488,0,0,0,43672,0,0,0,0
GHA,East gonja municipal,2021,96466,29232,14616,5846,0,146160,20462,0.139997263273125,0.0599981755154169,0.0288876725658335
GHA,East gonja municipal,2022,121313,23551,14131,0,0,158995,14131,0.0888770087109658,0.0296256695703219,0.00987522319010731
GHA,East mamprusi,2021,123457,34294,13717,0,0,171468,13717,0.0799974339235309,0.0266658113078436,0.00888860376928121
GHA,East mamprusi,2022,138889,48882,28201,0,0,215972,28201,0.130577111847832,0.0435257039492774,0.0145085679830925
GHA,Eastern,2020,3152910,165943,0,0,0,3318853,0,0,0,0
GHA,Eastern,2021,3219287,99566,0,0,0,3318853,0,0,0,0
GHA,Garu,2021,44256,17412,8706,2177,0,72551,10883,0.150004824192637,0.060003767464726,0.0266693620885844
GHA,Garu,2022,66032,14510,7255,0,0,87797,7255,0.0826338029773227,0.0275446009924409,0.00918153366414696
GHA,Greater accra,2020,4246942,707824,101118,0,0,5055884,101118,0.0200000632925914,0.00666668776419712,0.00222222925473237
GHA,Greater accra,2021,4499736,505588,50559,0,0,5055883,50559,0.0100000336241958,0.0033333445413986,0.00111111484713287
GHA,Gushegu,2021,124832,26631,13315,1664,0,166442,14979,0.0899953136828445,0.0333309300937664,0.0133319714975787
GHA,Gushegu,2022,140108,20015,8322,0,0,168445,8322,0.0494048502478554,0.0164682834159518,0.00548942780531727
GHA,Jaman south municipal,2021,103144,12135,6067,0,0,121346,6067,0.0499975277306215,0.0166658425768738,0.00555528085895795
GHA,Jaman south municipal,2022,107998,10839,5419,0,0,124256,5419,0.0436115761009529,0.014537192033651,0.00484573067788365
GHA,Jasikan,2021,70130,2922,0,0,0,73052,0,0,0,0
GHA,Jasikan,2022,71591,7163,0,0,0,78754,0,0,0,0
GHA,Jirapa,2021,81984,20496,9109,2277,0,113866,11386,0.0999947306483059,0.0399973067758008,0.0177762555206217
GHA,Jirapa,2022,94509,20081,4564,0,0,119154,4564,0.0383033721066855,0.0127677907022285,0.00425593023407616
GHA,Juaboso,2021,55716,10854,5789,0,0,72359,5789,0.08000386959466,0.0266679565315533,0.00888931884385111
GHA,Juaboso,2022,75492,10658,5329,0,0,91479,5329,0.0582538068846402,0.0194179356282134,0.00647264520940447
GHA,Karaga,2021,68593,25577,17439,4650,0,116259,22089,0.189998193688231,0.0766650323845896,0.0344432115649828
GHA,Karaga,2022,102803,12788,9301,0,0,124892,9301,0.074472344105307,0.024824114701769,0.00827470490058967
GHA,Kasena nankana west,2021,388608,129536,47104,23552,0,588800,70656,0.12,0.0533333333333333,0.0266666666666667
GHA,Kasena nankana west,2022,494592,70656,23552,5444,0,594244,28996,0.048794771171438,0.0193186637138953,0.00847538123135353
GHA,Ketu south,2021,166534,8765,0,0,0,175299,0,0,0,0
GHA,Ketu south,2022,248060,5259,0,0,0,253319,0,0,0,0
GHA,Kumbungu,2021,37072,12357,6473,2942,0,58844,9415,0.159999320236558,0.0699986404731154,0.0344432359761025
GHA,Kumbungu,2022,86257,19905,8847,0,0,115009,8847,0.0769244146110304,0.0256414715370102,0.00854715717900338
GHA,Kwahu afram plains north,2021,86261,18160,9080,0,0,113501,9080,0.0799992951603951,0.0266664317201317,0.00888881057337723
GHA,Kwahu afram plains north,2022,94206,16639,10649,0,0,121494,10649,0.0876504189507301,0.02921680631691,0.00973893543897001
GHA,Lambussie-karni,2021,55905,7986,2662,0,0,66553,2662,0.0399981969257584,0.0133327323085861,0.00444424410286205
GHA,Lambussie-karni,2022,58567,6655,2045,0,0,67267,2045,0.0304012368620572,0.0101337456206857,0.00337791520689524
GHA,Mamprugu moagduri,2021,61797,3987,664,0,0,66448,664,0.00999277630628461,0.0033309254354282,0.00111030847847607
GHA,Mamprugu moagduri,2022,63790,6875,2750,0,0,73415,2750,0.0374582850916025,0.0124860950305342,0.00416203167684473
GHA,Mion,2021,84437,26922,11014,0,0,122373,11014,0.0900035138470087,0.0300011712823362,0.0100003904274454
GHA,Mion,2022,102793,13461,6119,0,0,122373,6119,0.0500028601080304,0.0166676200360101,0.00555587334533671
GHA,Mpohor,2021,32887,10609,8487,1061,0,53044,9548,0.180001508181887,0.0666679234849056,0.0266675883333752
GHA,Mpohor,2022,39879,10495,6365,0,0,56739,6365,0.112180334514179,0.0373934448380596,0.0124644816126866
GHA,Nadowli-kaleo,2021,55502,15858,7929,0,0,79289,7929,0.100001261208995,0.0333337537363317,0.0111112512454439
GHA,Nadowli-kaleo,2022,64223,26199,6935,0,0,97357,6935,0.0712326797251353,0.0237442265750451,0.0079147421916817
GHA,Nandom,2021,50424,5932,2966,0,0,59322,2966,0.049998314284751,0.0166661047615837,0.00555536825386122
GHA,Nandom,2022,53390,5932,0,0,0,59322,0,0,0,0
GHA,Nanton,2021,62701,5573,1393,0,0,69667,1393,0.0199951196405759,0.00666503988019196,0.00222167996006399
GHA,Nanton,2022,65488,4861,3038,0,0,73387,3038,0.0413969776663442,0.0137989925554481,0.00459966418514935
GHA,North east,2020,494592,70656,23552,0,0,588800,23552,0.04,0.0133333333333333,0.00444444444444444
GHA,North east,2021,518144,58880,11776,0,0,588800,11776,0.02,0.00666666666666667,0.00222222222222222
GHA,North gonja,2021,31282,6174,2881,823,0,41160,3704,0.0899902818270165,0.0366618075801749,0.0166639671741713
GHA,North gonja,2022,38616,4939,2058,0,0,45613,2058,0.045118716155482,0.0150395720518273,0.00501319068394244
GHA,Northern,2020,1909935,38978,0,0,0,1948913,0,0,0,0
GHA,Northern,2021,1929424,19489,0,0,0,1948913,0,0,0,0
GHA,Oti,2020,729407,30392,0,0,0,759799,0,0,0,0
GHA,Oti,2021,744603,15196,0,0,0,759799,0,0,0,0
GHA,Sagnerigu,2021,208205,13290,0,0,0,221495,0,0,0,0
GHA,Sagnerigu,2022,328043,13668,6834,0,0,348545,6834,0.0196072243182372,0.00653574143941242,0.00217858047980414
GHA,Savannah,2020,576871,17841,0,0,0,594712,0,0,0,0
GHA,Savannah,2021,582818,11894,0,0,0,594712,0,0,0,0
GHA,Sawla-tuna-kalba,2021,80188,41477,16591,0,0,138256,16591,0.120002025228562,0.0400006750761872,0.0133335583587291
GHA,Sawla-tuna-kalba,2022,89866,34564,13826,0,0,138256,13826,0.100002893183659,0.0333342977278864,0.0111114325759621
GHA,Sekyere afram plains north,2021,26305,4871,1299,0,0,32475,1299,0.04,0.0133333333333333,0.00444444444444444
GHA,Sekyere afram plains north,2022,27091,4570,1632,0,0,33293,1632,0.0490193133691767,0.0163397711230589,0.00544659037435297
GHA,Sene east,2021,49531,17864,9744,4060,0,81199,13804,0.170002093621843,0.0733342364643243,0.0355559934372481
GHA,Sene east,2022,56839,28832,17299,2162,0,105132,19461,0.185110147243465,0.0685582569214575,0.0274226686451318
GHA,Sene west,2021,66068,7682,3073,0,0,76823,3073,0.0400010413548026,0.0133336804516009,0.00444456015053362
GHA,Sene west,2022,69141,6146,1536,0,0,76823,1536,0.0199940122098851,0.00666467073662835,0.00222155691220945
GHA,Sissala east,2021,49531,16025,7284,0,0,72840,7284,0.1,0.0333333333333333,0.0111111111111111
GHA,Sissala east,2022,74169,9674,0,0,0,83843,0,0,0,0
GHA,Sissala west,2021,51742,7665,4472,0,0,63879,4472,0.070007357660577,0.023335785886859,0.00777859529561967
GHA,Sissala west,2022,70139,12093,1612,0,0,83844,1612,0.0192261819569677,0.00640872731898924,0.00213624243966308
GHA,Suaman,2021,21846,3048,508,0,0,25402,508,0.0199984253208409,0.00666614177361363,0.00222204725787121
GHA,Suaman,2022,32910,5740,1148,0,0,39798,1148,0.0288456706367154,0.0096152235455718,0.0032050745151906
GHA,Tatale sanguli,2021,64661,17961,7185,0,0,89807,7185,0.0800048993953701,0.0266682997984567,0.00888943326615223
GHA,Tatale sanguli,2022,72744,17953,8977,1496,0,101170,10473,0.103518829692597,0.0394352739613192,0.0164310895851867
GHA,Tempane,2021,73023,11577,4453,0,0,89053,4453,0.0500039302437874,0.0166679767479291,0.00555599224930971
GHA,Tempane,2022,77476,10439,3480,0,0,91395,3480,0.0380764812079435,0.0126921604026478,0.00423072013421595
GHA,Twifo atti-morkwa,2021,59389,16051,4013,803,0,80256,4816,0.0600079744816587,0.0233378189792664,0.0100027135388978
GHA,Twifo atti-morkwa,2022,65007,32272,15128,0,0,112407,15128,0.134582365866894,0.0448607886222981,0.0149535962074327
GHA,Upper east,2020,1107310,156326,39082,0,0,1302718,39082,0.0300003531078867,0.0100001177026289,0.00333337256754297
GHA,Upper east,2021,1081256,195408,26054,0,0,1302718,26054,0.0199997236546973,0.00666657455156578,0.00222219151718859
GHA,Upper west,2020,859794,8685,0,0,0,868479,0,0,0,0
GHA,Upper west,2021,859794,8685,0,0,0,868479,0,0,0,0
GHA,Volta,2020,1793218,114461,0,0,0,1907679,0,0,0,0
GHA,Volta,2021,1812295,95384,0,0,0,1907679,0,0,0,0
GHA,Wa east,2021,72472,14866,5575,0,0,92913,5575,0.0600023678064426,0.0200007892688142,0.0066669297562714
GHA,Wa east,2022,89628,9291,1858,0,0,100777,1858,0.0184367464798516,0.00614558215995052,0.00204852738665017
GHA,Wa west,2021,65001,24113,13629,2097,0,104840,15726,0.15,0.0566673025562762,0.0233339692229429
GHA,Wa west,2022,75486,21331,11635,1939,0,110391,13574,0.122962922702032,0.0468425868050838,0.0195174928712989
GHA,Wassa amenfi east,2022,158132,35939,8985,0,0,203056,8985,0.0442488771570404,0.0147496257190135,0.00491654190633783
GHA,Wassa east,2021,70127,22040,8015,0,0,100182,8015,0.0800043920065481,0.0266681306688494,0.00888937688961645
GHA,Wassa east,2022,86157,10018,4007,0,0,100182,4007,0.0399972050867421,0.0133324016955807,0.0044441338985269
GHA,West gonja,2021,39883,11395,3988,1709,0,56975,5697,0.0999912242211496,0.0433289454439081,0.0211086733947638
GHA,West gonja,2022,54566,8883,3988,0,0,67437,3988,0.0591366757121462,0.019712225237382,0.00657074174579402
GHA,West mamprusi municipal,2021,500480,70656,17664,0,0,588800,17664,0.03,0.01,0.00333333333333333
GHA,West mamprusi municipal,2022,524032,52992,11776,0,0,588800,11776,0.02,0.00666666666666667,0.00222222222222222
GHA,Western,2020,1993194,221466,0,0,0,2214660,0,0,0,0
GHA,Western,2021,2037487,177173,0,0,0,2214660,0,0,0,0
GHA,Western north,2020,911130,37964,0,0,0,949094,0,0,0,0
GHA,Western north,2021,920621,28473,0,0,0,949094,0,0,0,0
GHA,Yendi municipal,2021,119792,35233,21140,0,0,176165,21140,0.120001135299293,0.0400003784330978,0.0133334594776993
GHA,Yendi municipal,2022,142694,21140,12332,0,0,176166,12332,0.0700021570564127,0.0233340523521376,0.00777801745071252
GIN,Beyla,2020,308561,84153,8015,0,0,400729,8015,0.0200010480898562,0.00666701602995208,0.00222233867665069
GIN,Beyla,2021,345851,68124,8235,0,0,422210,8235,0.019504511972715,0.006501503990905,0.00216716799696833
GIN,Beyla,2022,321147,131753,49407,0,0,502307,49407,0.0983601661931846,0.0327867220643949,0.0109289073547983
GIN,Boffa,2020,185370,54828,20887,0,0,261085,20887,0.0800007660340502,0.0266669220113501,0.00888897400378336
GIN,Boffa,2021,201188,65271,26109,0,0,292568,26109,0.0892407918842799,0.0297469306280933,0.00991564354269777
GIN,Boffa,2022,195823,75110,24143,0,0,295076,24143,0.0818195990185579,0.0272731996728526,0.00909106655761755
GIN,Boke,2020,602205,154620,56965,0,0,813790,56965,0.0699996313545263,0.0233332104515088,0.00777773681716959
GIN,Boke,2021,553377,187172,73241,0,0,813790,73241,0.0899998771181754,0.0299999590393918,0.00999998634646394
GIN,Boke,2022,425905,261222,119253,5679,0,812059,124932,0.153845964394213,0.0536130995407969,0.0194251074531941
GIN,Coyah,2020,246054,51801,25900,0,0,323755,25900,0.0799987644978456,0.0266662548326152,0.00888875161087173
GIN,Coyah,2021,252806,59875,29138,0,0,341819,29138,0.0852439448948128,0.0284146482982709,0.00947154943275697
GIN,Coyah,2022,242827,123077,36590,0,0,402494,36590,0.0909081874512415,0.0303027291504138,0.0101009097168046
GIN,Dabola,2020,160266,51196,11130,0,0,222592,11130,0.0500017970097757,0.0166672656699252,0.00555575522330842
GIN,Dabola,2021,158040,61749,22870,0,0,242659,22870,0.0942474830935593,0.0314158276978531,0.010471942565951
GIN,Dabola,2022,153229,107489,18296,0,0,279014,18296,0.0655737704918033,0.0218579234972678,0.00728597449908925
GIN,Dalaba,2020,137909,18059,8209,0,0,164177,8209,0.0500009136480749,0.016666971216025,0.00555565707200833
GIN,Dalaba,2021,132983,30363,15181,0,0,178527,15181,0.0850347566474539,0.0283449188824846,0.00944830629416154
GIN,Dalaba,2022,121452,72534,16868,0,0,210854,16868,0.0799984823622032,0.0266661607874011,0.00888872026246703
GIN,Dinguiraye,2020,166533,60338,14481,0,0,241352,14481,0.0599995028008883,0.0199998342669628,0.00666661142232093
GIN,Dinguiraye,2021,225657,65165,14481,0,0,305303,14481,0.0474315679832822,0.0158105226610941,0.00527017422036469
GIN,Dinguiraye,2022,210779,86791,14879,0,0,312449,14879,0.0476205716772977,0.0158735238924326,0.00529117463081086
GIN,Dubreka,2020,291928,85146,28382,0,0,405456,28382,0.0700001973087092,0.0233333991029031,0.00777779970096769
GIN,Dubreka,2021,358261,89200,32436,0,0,479897,32436,0.0675895035809768,0.0225298345269923,0.00750994484233075
GIN,Dubreka,2022,329101,145804,37492,0,0,512397,37492,0.0731698273018773,0.0243899424339591,0.00812998081131969
GIN,Faranah,2020,247876,75740,20656,0,0,344272,20656,0.0599990705023935,0.0199996901674645,0.00666656338915483
GIN,Faranah,2021,311274,79183,20656,0,0,411113,20656,0.050244093473084,0.0167480311576947,0.00558267705256489
GIN,Faranah,2022,304199,148562,28298,0,0,481059,28298,0.0588243853664519,0.019608128455484,0.00653604281849466
GIN,Forecariah,2020,235629,44740,17896,0,0,298265,17896,0.060000335272325,0.0200001117574416,0.00666670391914722
GIN,Forecariah,2021,275804,47722,23861,0,0,347387,23861,0.0686870838574846,0.0228956946191615,0.00763189820638718
GIN,Forecariah,2022,272740,107257,24516,0,0,404513,24516,0.0606062104308143,0.0202020701436048,0.00673402338120159
GIN,Fria,2020,103352,11880,3564,0,0,118796,3564,0.0300010101350214,0.0100003367116738,0.00333344557055793
GIN,Fria,2021,98600,19529,8544,0,0,126673,8544,0.0674492591159916,0.0224830863719972,0.00749436212399906
GIN,Fria,2022,92762,53704,9764,0,0,156230,9764,0.0624975996927607,0.0208325332309202,0.00694417774364008
GIN,Gaoual,2020,197450,30926,9516,0,0,237892,9516,0.0400013451482185,0.0133337817160728,0.00444459390535761
GIN,Gaoual,2021,192693,36663,19554,0,0,248910,19554,0.0785585151259491,0.0261861717086497,0.00872872390288324
GIN,Gaoual,2022,180872,105101,21998,0,0,307971,21998,0.0714288033613555,0.0238096011204518,0.00793653370681727
GIN,Gueckedou,2020,303365,49966,3569,0,0,356900,3569,0.01,0.00333333333333333,0.00111111111111111
GIN,Gueckedou,2021,319025,53535,11001,0,0,383561,11001,0.0286812267149163,0.00956040890497209,0.00318680296832403
GIN,Gueckedou,2022,308024,69672,18335,0,0,396031,18335,0.0462968807997354,0.0154322935999118,0.00514409786663726
GIN,Kankan,2020,417239,133285,28975,0,0,579499,28975,0.0500000862814259,0.016666695427142,0.00555556514238065
GIN,Kankan,2021,523955,144875,28975,0,0,697805,28975,0.0415230616003038,0.0138410205334346,0.00461367351114487
GIN,Kankan,2022,512047,244115,125035,5954,0,887151,130989,0.147651301751337,0.0514542244405593,0.0186428240513734
GIN,Kerouane,2020,183632,61211,10202,0,0,255045,10202,0.0400007841753416,0.0133335947251139,0.00444453157503796
GIN,Kerouane,2021,225359,63761,10202,0,0,299322,10202,0.0340836958192181,0.0113612319397394,0.00378707731324646
GIN,Kerouane,2022,220118,65511,13102,0,0,298731,13102,0.0438588562954631,0.0146196187651544,0.00487320625505146
GIN,Kindia,2020,426142,80913,32365,0,0,539420,32365,0.0599996292313967,0.0199998764104656,0.00666662547015519
GIN,Kindia,2021,460006,86307,37759,0,0,584072,37759,0.06464785163473,0.0215492838782433,0.00718309462608111
GIN,Kindia,2022,426752,188436,49880,0,0,665068,49880,0.0749998496394354,0.0249999498798118,0.00833331662660393
GIN,Kissidougou,2020,257592,73100,17405,0,0,348097,17405,0.0500004309143716,0.0166668103047905,0.00555560343493017
GIN,Kissidougou,2021,296850,80062,17405,0,0,394317,17405,0.0441396135596487,0.0147132045198829,0.00490440150662763
GIN,Kissidougou,2022,271815,114448,28612,0,0,414875,28612,0.0689653510093402,0.0229884503364467,0.00766281677881557
GIN,Koubia,2020,101760,13486,7356,0,0,122602,7356,0.0599990212231448,0.0199996737410483,0.00666655791368276
GIN,Koubia,2021,105812,15116,8582,0,0,129510,8582,0.0662651532700178,0.0220883844233393,0.00736279480777975
GIN,Koubia,2022,95735,54166,10077,0,0,159978,10077,0.062989911112778,0.0209966370375927,0.00699887901253089
GIN,Koundara,2020,135662,17556,6384,0,0,159602,6384,0.0399994987531485,0.0133331662510495,0.00444438875034983
GIN,Koundara,2021,129278,36076,9839,0,0,175193,9839,0.0561609196714481,0.0187203065571494,0.00624010218571645
GIN,Koundara,2022,113148,50834,13119,0,0,177101,13119,0.0740763744981677,0.0246921248327226,0.00823070827757419
GIN,Kouroussa,2020,244081,75863,9895,0,0,329839,9895,0.0299994845970307,0.00999982819901023,0.00333327606633674
GIN,Kouroussa,2021,240613,82460,33889,0,0,356962,33889,0.0949372762366863,0.0316457587455621,0.0105485862485207
GIN,Kouroussa,2022,291447,74556,40667,0,0,406670,40667,0.1,0.0333333333333333,0.0111111111111111
GIN,Labe,2020,331923,39050,19525,0,0,390498,19525,0.0500002560832578,0.0166667520277526,0.00555558400925087
GIN,Labe,2021,320208,100304,40122,0,0,460634,40122,0.0871016902790502,0.0290338967596834,0.00967796558656113
GIN,Labe,2022,236717,180547,60182,0,0,477446,60182,0.126049856947173,0.042016618982391,0.014005539660797
GIN,Lelouma,2020,148124,38032,14012,0,0,200168,14012,0.070001198992846,0.0233337329976153,0.00777791099920511
GIN,Lelouma,2021,170699,40033,16013,0,0,226745,16013,0.0706211823854991,0.0235403941284997,0.00784679804283324
GIN,Lelouma,2022,158359,90491,51415,2057,0,302322,53472,0.176871018318217,0.0612250073321381,0.0219203365947566
GIN,Lola,2020,160233,44275,6325,0,0,210833,6325,0.030000047430905,0.0100000158103017,0.00333333860343389
GIN,Lola,2021,192791,35842,2166,0,0,230799,2166,0.00938478936217228,0.00312826312072409,0.0010427543735747
GIN,Lola,2022,186292,64986,17330,0,0,268608,17330,0.0645178103407196,0.0215059367802399,0.00716864559341329
GIN,Macenta,2020,290840,41060,10265,0,0,342165,10265,0.0300001461283299,0.0100000487094433,0.00333334956981443
GIN,Macenta,2021,290840,94920,35156,0,0,420916,35156,0.083522603084701,0.0278408676949003,0.00928028923163344
GIN,Macenta,2022,256636,101951,42187,0,0,400774,42187,0.105263814518906,0.0350879381729686,0.0116959793909895
GIN,Mali,2020,303920,35340,14136,0,0,353396,14136,0.0400004527498896,0.0133334842499632,0.00444449474998774
GIN,Mali,2021,293318,127083,54464,0,0,474865,54464,0.114693649774146,0.0382312165913821,0.012743738863794
GIN,Mali,2022,203333,137976,94404,3631,0,439344,98035,0.223139498889253,0.0771346977918594,0.0275481424831365
GIN,Mamou,2020,287733,68147,22716,0,0,378596,22716,0.0600006339211191,0.0200002113070397,0.00666673710234657
GIN,Mamou,2021,272589,84531,48304,0,0,405424,48304,0.119144401910099,0.0397148006366997,0.0132382668788999
GIN,Mamou,2022,241518,169063,60380,0,0,470961,60380,0.128205944865923,0.0427353149553077,0.0142451049851026
GIN,Mandiana,2020,317888,78440,16514,0,0,412842,16514,0.040000775114935,0.0133335917049783,0.00444453056832611
GIN,Mandiana,2021,369031,94954,24771,0,0,488756,24771,0.0506817307613615,0.0168939102537872,0.00563130341792906
GIN,Mandiana,2022,330855,106043,25450,0,0,462348,25450,0.0550451175305181,0.0183483725101727,0.00611612417005757
GIN,Nzerekore,2020,326386,131529,29229,0,0,487144,29229,0.0600007390011988,0.0200002463337329,0.00666674877791098
GIN,Nzerekore,2021,409200,110113,15015,0,0,534328,15015,0.028100717162492,0.00936690572083065,0.00312230190694355
GIN,Nzerekore,2022,370380,125128,30031,0,0,525539,30031,0.0571432377045281,0.0190477459015094,0.00634924863383646
GIN,Pita,2020,293744,30741,17078,0,0,341563,17078,0.0499995608423629,0.0166665202807876,0.00555550676026255
GIN,Pita,2021,283497,87734,20494,0,0,391725,20494,0.0523173144425298,0.0174391048141766,0.00581303493805887
GIN,Pita,2022,245656,112300,115809,3509,0,477274,119318,0.249998952383746,0.0857837077513825,0.0302283849994389
GIN,Siguiri,2020,516238,216487,99917,0,0,832642,99917,0.119999951960146,0.0399999839867154,0.0133333279955718
GIN,Siguiri,2021,692950,233140,108243,0,0,1034333,108243,0.104650049838882,0.0348833499462939,0.0116277833154313
GIN,Siguiri,2022,675840,367862,68440,0,0,1112142,68440,0.0615389042046789,0.0205129680682263,0.0068376560227421
GIN,Telimele,2020,269025,55901,24457,0,0,349383,24457,0.0700005438158124,0.0233335146052708,0.00777783820175694
GIN,Telimele,2021,294356,66383,27951,0,0,388690,27951,0.0719107772260671,0.0239702590753557,0.00799008635845189
GIN,Telimele,2022,276408,122050,28718,0,0,427176,28718,0.0672275596007266,0.0224091865335755,0.00746972884452518
GIN,Tougue,2020,120656,22909,9164,0,0,152729,9164,0.0600017023616995,0.0200005674538998,0.00666685581796661
GIN,Tougue,2021,117601,31384,12554,0,0,161539,12554,0.0777149790453079,0.0259049930151027,0.00863499767170088
GIN,Tougue,2022,106706,69045,14123,0,0,189874,14123,0.0743809052318906,0.0247936350772969,0.00826454502576562
GIN,Yomou,2020,99724,35114,5618,0,0,140456,5618,0.0399982912798314,0.0133327637599438,0.00444425458664793
GIN,Yomou,2021,122665,22473,2886,0,0,148024,2886,0.0194968383505378,0.00649894611684592,0.00216631537228197
GIN,Yomou,2022,118336,37521,8659,0,0,164516,8659,0.0526331785358263,0.0175443928452754,0.00584813094842515
GMB,Banjul,2020,24564,1321,528,0,0,26413,528,0.0199901563623973,0.00666338545413244,0.00222112848471081
GMB,Banjul,2021,23904,5547,660,0,0,30111,660,0.021918900069742,0.00730630002324732,0.00243543334108244
GMB,Banjul,2022,19017,6603,792,0,0,26412,792,0.0299863698318946,0.00999545661063153,0.00333181887021051
GMB,Basse,2020,171492,29279,8365,0,0,209136,8365,0.0399978961058833,0.0133326320352944,0.00444421067843147
GMB,Basse,2021,152669,43919,16731,0,0,213319,16731,0.0784318321387218,0.0261439440462406,0.00871464801541354
GMB,Basse,2022,98294,62741,46010,2091,0,209136,48101,0.229998661158289,0.0799989799301252,0.0288881663393943
GMB,Brikama,2020,926101,194367,22867,0,0,1143335,22867,0.0200002623902881,0.00666675413009602,0.00222225137669867
GMB,Brikama,2021,891801,240100,34300,0,0,1166201,34300,0.0294117394857319,0.00980391316191063,0.00326797105397021
GMB,Brikama,2022,834634,251533,57167,0,0,1143334,57167,0.0500002623905176,0.0166667541301725,0.00555558471005751
GMB,Janjanbureh,2020,126019,24893,4667,0,0,155579,4667,0.0299976217870021,0.00999920726233403,0.00333306908744468
GMB,Janjanbureh,2021,115128,37339,9335,0,0,161802,9335,0.0576939716443555,0.0192313238814518,0.00641044129381727
GMB,Janjanbureh,2022,98015,46674,10891,0,0,155580,10891,0.0700025710245533,0.0233341903415178,0.00777806344717259
GMB,Kanifing,2020,388397,65513,14038,0,0,467948,14038,0.0299990597245848,0.00999968657486159,0.0033332288582872
GMB,Kanifing,2021,388397,70192,23397,0,0,481986,23397,0.0485429037357932,0.0161809679119311,0.00539365597064368
GMB,Kanifing,2022,350961,98269,18718,0,0,467948,18718,0.0400001709591664,0.0133333903197221,0.00444446343990738
GMB,Kerewan,2020,170034,33587,6298,0,0,209919,6298,0.0300020484091483,0.0100006828030494,0.00333356093434981
GMB,Kerewan,2021,153241,50381,12595,0,0,216217,12595,0.0582516638377186,0.0194172212792395,0.00647240709307984
GMB,Kerewan,2022,136447,62976,10496,0,0,209919,10496,0.0500002381871103,0.0166667460623701,0.00555558202079003
GMB,Kuntaur,2020,99546,27652,11061,0,0,138259,11061,0.0800020251846173,0.0266673417282058,0.00888911390940192
GMB,Kuntaur,2021,88485,41477,13826,1383,0,145171,15209,0.10476610342286,0.0380975998420254,0.0148162435258343
GMB,Kuntaur,2022,64980,40094,30416,2765,0,138255,33181,0.239998553397707,0.0866659433655202,0.0333329314993631
GMB,Mansa konko,2020,85256,15788,4210,0,0,105254,4210,0.0399984798677485,0.0133328266225828,0.00444427554086094
GMB,Mansa konko,2021,76835,31576,23156,0,0,131567,23156,0.17600158094355,0.0586671936478499,0.01955573121595
GMB,Mansa konko,2022,39997,37891,25261,2105,0,105254,27366,0.259999619966937,0.0933329533002705,0.0355552599742844
GNB,Bafata,2020,91212,81857,58469,2339,0,233877,60808,0.259999914484964,0.0900002993026249,0.0322225405281884
GNB,Bafata,2021,198745,51453,16371,0,0,266569,16371,0.0614137427832944,0.0204712475944315,0.00682374919814382
GNB,Bafata,2022,203592,65440,24237,0,0,293269,24237,0.0826442617528617,0.0275480872509539,0.00918269575031797
GNB,Biombo,2020,61652,44838,5605,0,0,112095,5605,0.0500022302511263,0.0166674100837088,0.00555580336123625
GNB,Biombo,2021,97749,39233,4711,0,0,141693,4711,0.0332479374422166,0.0110826458140722,0.0036942152713574
GNB,Biombo,2022,103638,17666,3533,0,0,124837,3533,0.0283009043793106,0.00943363479310354,0.00314454493103451
GNB,Bolama/bijagos,2020,13064,13064,9072,1089,0,36289,10161,0.280002204524787,0.103337099396511,0.041114387279892
GNB,Bolama/bijagos,2021,28505,11612,8346,726,0,49189,9072,0.18443147858261,0.0663969586696213,0.0254121856512635
GNB,Bolama/bijagos,2022,31836,7774,1481,0,0,41091,1481,0.0360419556593901,0.0120139852197967,0.00400466173993224
GNB,Cacheu,2020,121920,84083,4204,0,0,210207,4204,0.0199993339898291,0.00666644466327636,0.00222214822109212
GNB,Cacheu,2021,176881,35735,4314,0,0,216930,4314,0.0198865993638501,0.0066288664546167,0.0022096221515389
GNB,Cacheu,2022,181196,47456,10785,0,0,239437,10785,0.0450431637549752,0.0150143879183251,0.00500479597277502
GNB,Gabu,2020,115893,103016,38631,0,0,257540,38631,0.15,0.05,0.0166666666666667
GNB,Gabu,2021,205737,97865,25754,0,0,329356,25754,0.0781950230146103,0.0260650076715368,0.00868833589051226
GNB,Gabu,2022,227682,82295,41147,0,0,351124,41147,0.117186521001128,0.0390621736670426,0.0130207245556809
GNB,Oio,2020,162898,75184,12531,0,0,250613,12531,0.0500013965755966,0.0166671321918655,0.00555571073062185
GNB,Oio,2021,171412,72720,20049,0,0,264181,20049,0.0758911503855311,0.0252970501285104,0.00843235004283679
GNB,Oio,2022,179203,83109,36360,0,0,298672,36360,0.121738897519687,0.0405796325065624,0.0135265441688541
GNB,Quinara,2020,58164,12207,1436,0,0,71807,1436,0.0199980503293551,0.00666601677645169,0.00222200559215056
GNB,Quinara,2021,50266,18714,5988,0,0,74968,5988,0.0798740796072991,0.026624693202433,0.00887489773414435
GNB,Quinara,2022,56142,20211,7486,0,0,83839,7486,0.0892901871444077,0.0297633957148026,0.00992113190493419
GNB,Tombali,2020,33274,50951,17677,2080,0,103982,19757,0.190004039160624,0.0700025004327672,0.0277793806192952
GNB,Tombali,2021,93013,48872,14557,1040,0,157482,15597,0.0990398902731741,0.0352146065370434,0.0132057420318936
GNB,Tombali,2022,90875,25659,6415,0,0,122949,6415,0.0521761055396953,0.0173920351798984,0.00579734505996615
GTM,Alta Verapaz,2018,411369,548492,342807,68561,0,1371229,411368,0.299999489509046,0.116666387112097,0.0499998338878643
GTM,Alta Verapaz,2019,329095,521067,411369,109698,0,1371229,521067,0.379999985414544,0.153333250682417,0.068888809479185
GTM,Alta Verapaz,2020,531467,730767,531467,106293,0,1899994,637760,0.335664217887004,0.130536026254118,0.0559439778347838
GTM,Alta Verapaz,2021,352335,704670,311681,27103,0,1395789,338784,0.242718634406776,0.0873787752542349,0.033441300941618
GTM,Alta Verapaz,2022,379897,647232,414376,82875,0,1524380,497251,0.326198848056259,0.126855071132745,0.0543664382313538
GTM,Baja Verapaz,2018,96988,168113,48494,9699,0,323294,58193,0.180000247452783,0.0700002680738482,0.0300002130843408
GTM,Baja Verapaz,2019,90522,158414,58193,16165,0,323294,74358,0.230001175400719,0.0933340344495516,0.0422226621382807
GTM,Baja Verapaz,2020,131154,147549,59019,10752,0,348474,69771,0.200218667676785,0.0770243978029925,0.0325313605414847
GTM,Baja Verapaz,2021,116738,166769,60037,6671,0,350215,66708,0.190477278243365,0.0698418590484893,0.0275135749944082
GTM,Baja Verapaz,2022,124076,159395,91567,13566,0,388604,105133,0.270540190013484,0.101816587923267,0.0416965456980485
GTM,Chimaltenango,2018,434763,213568,99156,15255,0,762742,114411,0.149999606682207,0.0566666054838989,0.0233333595545195
GTM,Chimaltenango,2019,434763,213568,99156,15255,0,762742,114411,0.149999606682207,0.0566666054838989,0.0233333595545195
GTM,Chimaltenango,2020,293335,330002,146668,36667,0,806672,183335,0.227273290755102,0.090909316302041,0.0404041405786849
GTM,Chimaltenango,2021,261228,447820,149273,0,0,858321,149273,0.173912790203199,0.057970930067733,0.019323643355911
GTM,Chimaltenango,2022,355068,326463,167028,22777,0,871336,189805,0.217832156596307,0.081324158151008,0.0329170122407175
GTM,Chiquimula,2017,315240,63900,42600,0,0,421740,42600,0.101010101010101,0.0336700336700337,0.0112233445566779
GTM,Chiquimula,2018,150333,136667,113889,54667,0,455556,168556,0.370000614633547,0.163333743089031,0.0811113842815763
GTM,Chiquimula,2019,82000,150333,145778,77444,0,455555,223222,0.490000109756231,0.219999780487537,0.111110867208375
GTM,Chiquimula,2020,176632,158968,123642,22079,0,481321,145721,0.302752217335209,0.116207963777465,0.0489296932585299
GTM,Chiquimula,2021,179018,156640,125312,13426,0,474396,138738,0.292451875648193,0.10691770869344,0.041928402993842
GTM,Chiquimula,2022,183718,181380,113362,22672,0,501132,136034,0.271453429435757,0.105565000838103,0.0452420165190453
GTM,El Progreso,2018,135536,52129,20852,0,0,208517,20852,0.100001438731614,0.0333338129105381,0.0111112709701794
GTM,El Progreso,2019,135536,52129,20852,0,0,208517,20852,0.100001438731614,0.0333338129105381,0.0111112709701794
GTM,El Progreso,2020,77228,90742,42475,1931,0,212376,44406,0.209091422759634,0.0727279290817544,0.0262631684685024
GTM,El Progreso,2021,87475,87475,46653,1944,0,223547,48597,0.217390526377003,0.0753622280773171,0.0270532222157607
GTM,El Progreso,2022,88613,80736,35221,5870,0,210440,41091,0.195262307546094,0.0743854146866882,0.0309937907875562
GTM,Escuintla,2018,409288,286502,81858,40929,0,818577,122787,0.150000549734478,0.0666669109931014,0.0333334554965507
GTM,Escuintla,2019,343802,319245,98229,57300,0,818576,155529,0.189999462481187,0.0866663571861379,0.0444442544125408
GTM,Escuintla,2020,379987,316656,118746,15833,0,831222,134579,0.16190500251437,0.060317620723866,0.0243387312762281
GTM,Escuintla,2021,401240,337041,96297,0,0,834578,96297,0.115384062364452,0.0384613541214842,0.0128204513738281
GTM,Escuintla,2022,296526,411842,162634,8132,0,879134,170766,0.194243425916868,0.06783114595348,0.0246659401941759
GTM,Guatemala,2018,2062992,305628,178283,0,0,2546903,178283,0.0699999175469187,0.0233333058489729,0.00777776861632431
GTM,Guatemala,2019,2062992,305628,178283,0,0,2546903,178283,0.0699999175469187,0.0233333058489729,0.00777776861632431
GTM,Guatemala,2020,924043,1155054,346516,46202,0,2471815,392718,0.158878395025518,0.0591899744384862,0.0238836644328156
GTM,Guatemala,2021,1565480,1601059,462528,0,0,3629067,462528,0.127450939869669,0.042483646623223,0.0141612155410743
GTM,Guatemala,2022,1419493,1619666,647866,35993,0,3723018,683859,0.183684043429282,0.0644505792522805,0.0236319029346622
GTM,Guatemala (metropolitana),2020,663117,482267,120567,24113,0,1290064,144680,0.112149474754741,0.0436135984984724,0.0186914929974189
GTM,Huehuetenango,2017,858000,325000,130000,0,0,1313000,130000,0.099009900990099,0.033003300330033,0.011001100110011
GTM,Huehuetenango,2018,797488,434994,217497,0,0,1449979,217497,0.150000103449774,0.050000034483258,0.016666678161086
GTM,Huehuetenango,2019,797488,434994,217497,0,0,1449979,217497,0.150000103449774,0.050000034483258,0.016666678161086
GTM,Huehuetenango,2020,421686,685838,438936,41150,0,1587610,480086,0.302395424569006,0.10943829613906,0.0422393129015032
GTM,Huehuetenango,2021,377829,741665,349842,27987,0,1497323,377829,0.252336336248091,0.0903425646971295,0.0342678233086649
GTM,Huehuetenango,2022,610688,581608,399512,71342,0,1663150,470854,0.28310976159697,0.108668490514987,0.0457552101601045
GTM,Izabal,2018,220252,195780,63628,9789,0,489449,73417,0.149999284910175,0.0566664419241501,0.0233332674996669
GTM,Izabal,2019,220252,185991,73417,9789,0,489449,83206,0.16999932577245,0.0633331222115753,0.0255554942621419
GTM,Izabal,2020,198223,264297,110124,22025,0,594669,132149,0.222222782758139,0.0864200644952626,0.0370372238823428
GTM,Izabal,2021,156261,245554,89292,0,0,491107,89292,0.181817811597065,0.0606059371990218,0.0202019790663406
GTM,Izabal,2022,137432,238216,135701,27140,0,538489,162841,0.302403577417552,0.117601288048595,0.0504004930669171
GTM,Jalapa,2018,178420,130841,67403,19824,0,396488,87227,0.219999092028006,0.0899993610567449,0.0411106739394102
GTM,Jalapa,2019,130841,158595,87227,19824,0,396487,107051,0.269998764146113,0.106665960464446,0.0466662350986427
GTM,Jalapa,2020,197117,137982,86731,15769,0,437599,102500,0.234232710769449,0.0900893283576973,0.0380376148533754
GTM,Jalapa,2021,196443,140317,96217,8018,0,440995,104235,0.236363224072835,0.0848482787030843,0.0323231177980098
GTM,Jalapa,2022,206959,158913,77419,8149,0,451440,85568,0.189544568491937,0.0691985645933014,0.027077549372871
GTM,Jutiapa,2018,272532,179974,51421,10284,0,514211,61705,0.11999937768737,0.0466663166158121,0.019999788240841
GTM,Jutiapa,2019,267390,179974,51421,15426,0,514211,66847,0.129999163767403,0.0533328406691676,0.0244441376097447
GTM,Jutiapa,2020,273003,218402,136501,27300,0,655206,163801,0.249999236881225,0.0972218406628348,0.0416664546892292
GTM,Jutiapa,2021,138029,358874,99381,0,0,596284,99381,0.166667225684405,0.0555557418948018,0.0185185806316006
GTM,Jutiapa,2022,338375,178594,100459,0,0,617428,100459,0.162705611018613,0.0542352036728709,0.0180784012242903
GTM,Peten,2021,329877,248964,93361,0,0,672202,93361,0.138888310359089,0.0462961034530295,0.0154320344843432
GTM,Peten,2022,211250,307272,189392,37878,0,745792,227270,0.304736441259761,0.118508467061415,0.0507892578925789
GTM,Petén,2018,392408,235445,117722,39241,0,784816,156963,0.199999745163198,0.0833333333333333,0.0388889455192894
GTM,Petén,2019,392408,274686,94178,23544,0,784816,117722,0.149999490326395,0.0599996262393563,0.0266664061668241
GTM,Petén,2020,306738,368085,67482,6135,0,748440,73617,0.0983605900272567,0.0355192132969911,0.0136613044020451
GTM,Quetzaltenango,2018,658111,188032,94016,0,0,940159,94016,0.100000106364987,0.0333333687883291,0.011111122929443
GTM,Quetzaltenango,2019,592300,235040,112819,0,0,940159,112819,0.11999991490801,0.0399999716360034,0.0133333238786678
GTM,Quetzaltenango,2020,484057,313741,161352,17928,0,977078,179280,0.183485862950553,0.0672781497485359,0.026503513537302
GTM,Quetzaltenango,2021,363952,409446,181976,9099,0,964473,191075,0.198113373832134,0.0691825138357079,0.0251573196507891
GTM,Quetzaltenango,2022,299643,458829,230803,27696,0,1016971,258499,0.254185222587468,0.0938063458381147,0.0373207408186773
GTM,Quiche,2017,804000,168000,168000,0,0,1140000,168000,0.147368421052632,0.0491228070175439,0.016374269005848
GTM,Quiche,2022,447770,414187,308228,55041,0,1225226,363269,0.296491422806894,0.113804854505754,0.0479178716597772
GTM,Quiché,2018,680866,334244,136173,86656,0,1237939,222829,0.179999983844115,0.0833334006495204,0.0433334042397171
GTM,Quiché,2019,618970,247588,284726,86656,0,1237940,371382,0.3,0.12333338718624,0.0566667205195728
GTM,Quiché,2020,265724,531449,340127,31887,0,1169187,372014,0.318181779304765,0.115151525518729,0.0444444634510039
GTM,Quiché,2021,281311,584261,270491,10820,0,1146883,281311,0.245283084673851,0.0849057837634702,0.0303984316137256
GTM,Retalhuleu,2018,163124,144999,36250,18125,0,362498,54375,0.150000827590773,0.066667034484788,0.033333517242394
GTM,Retalhuleu,2019,155874,144999,43500,18125,0,362498,61625,0.170000937936209,0.0733337379332668,0.0355557517252203
GTM,Retalhuleu,2020,166982,148429,55661,11132,0,382204,66793,0.174757459367249,0.0679610888426076,0.0291260978721079
GTM,Retalhuleu,2021,188199,154323,52696,0,0,395218,52696,0.133334008066434,0.0444446693554781,0.0148148897851594
GTM,Retalhuleu,2022,162449,181788,57245,7633,0,409115,64878,0.158581327988463,0.0590795579075158,0.0238392627989685
GTM,Sacatepequez,2021,174313,198084,51502,3962,0,427861,55464,0.129630884796698,0.0462969671614535,0.0174901038732984
GTM,Sacatepequez,2022,155221,191984,68401,8047,0,423653,76448,0.180449566036355,0.0664812948332716,0.0263813912696371
GTM,Sacatepéquez,2018,314182,36963,18481,0,0,369626,18481,0.0499991883687836,0.0166663961229279,0.00555546537430929
GTM,Sacatepéquez,2019,314182,36963,18481,0,0,369626,18481,0.0499991883687836,0.0166663961229279,0.00555546537430929
GTM,Sacatepéquez,2020,155964,194956,58487,7798,0,417205,66285,0.158878728682542,0.0591899266148137,0.0238835424631376
GTM,San Marcos,2017,516000,552000,84000,0,0,1152000,84000,0.0729166666666667,0.0243055555555556,0.00810185185185185
GTM,San Marcos,2018,735201,306334,159294,24507,0,1225336,183801,0.150000489661611,0.0566669060567877,0.023333463909763
GTM,San Marcos,2019,649428,367601,183800,24507,0,1225336,208307,0.169999902067678,0.0633333768588099,0.0255556208437704
GTM,San Marcos,2020,586105,398551,293053,58611,0,1336320,351664,0.263158524904215,0.102339509498723,0.0438598372977863
GTM,San Marcos,2021,535173,475710,237855,23785,0,1272523,261640,0.205607285683638,0.0747661666364118,0.0290756587067145
GTM,San Marcos,2022,513639,476951,289488,48248,0,1328326,337736,0.254256861643904,0.0968597568167252,0.0403582320069688
GTM,Santa Rosa,2018,195324,142423,48831,20346,0,406924,69177,0.169999803403092,0.0733331039702746,0.0355553698806984
GTM,Santa Rosa,2019,183116,142423,61039,20346,0,406924,81385,0.200000491492269,0.0833333333333333,0.0388887796683847
GTM,Santa Rosa,2020,198464,167592,92617,22052,0,480725,114669,0.238533465078787,0.0948019484459237,0.0417945117617488
GTM,Santa Rosa,2021,200896,165181,102680,8929,0,477686,111609,0.233645114154486,0.0841124364819847,0.0321913000032099
GTM,Santa Rosa,2022,167140,228464,90346,4517,0,490467,94863,0.1934136241582,0.0675410714006583,0.0245602660321693
GTM,Solola,2022,175646,219558,125090,19245,0,539539,144335,0.267515415938421,0.101061585291641,0.0416137150831028
GTM,Sololá,2018,365815,140698,28140,28140,0,562793,56280,0.100001243796565,0.0500006218982823,0.0277781232768235
GTM,Sololá,2019,309536,168838,56279,28140,0,562793,84419,0.150000088842612,0.066666903580298,0.0333335505041621
GTM,Sololá,2020,219615,163543,112144,28036,0,523338,140180,0.26785748407339,0.107142993629356,0.0476191082797139
GTM,Sololá,2021,213408,189696,94848,14227,0,512179,109075,0.212962655634065,0.080246684590088,0.0329216500047401
GTM,Suchitepequez,2022,225511,294417,136285,12390,0,668603,148675,0.222366636105432,0.0802992707680542,0.0308844627446249
GTM,Suchitepéquez,2018,268350,243387,74888,37444,0,624069,112332,0.179999326997495,0.0799997008877758,0.0399998504438879
GTM,Suchitepéquez,2019,255868,249628,74888,43685,0,624069,118573,0.189999823737439,0.086666698714405,0.0444445156616407
GTM,Suchitepéquez,2020,254226,242120,121060,30265,0,647671,151325,0.233644859813084,0.0934579439252336,0.0415368639667705
GTM,Suchitepéquez,2021,244975,275597,122488,12249,0,655309,134737,0.205608346596796,0.0747667639744507,0.0290760202862738
GTM,Totonicapan,2017,347820,142290,21080,0,0,511190,21080,0.0412371134020619,0.013745704467354,0.00458190148911799
GTM,Totonicapan,2022,150282,243794,145273,25047,0,564396,170320,0.301773931778397,0.115384115644571,0.0483232419160385
GTM,Totonicapán,2018,263258,184280,78977,0,0,526515,78977,0.149999525179719,0.0499998417265732,0.0166666139088577
GTM,Totonicapán,2019,263258,184280,78977,0,0,526515,78977,0.149999525179719,0.0499998417265732,0.0166666139088577
GTM,Totonicapán,2020,146006,233610,121672,9734,0,511022,131406,0.257143528067285,0.0920638772238116,0.0349208709866372
GTM,Totonicapán,2021,123466,271625,128405,0,0,523496,128405,0.245283631584578,0.0817612105281925,0.0272537368427308
GTM,Zacapa,2018,149528,59811,37382,2492,0,249213,39874,0.159999678989459,0.0566663857824431,0.0211109015625634
GTM,Zacapa,2019,119623,84733,42366,2492,0,249214,44858,0.179997913439855,0.0633324505578873,0.0233329142379196
GTM,Zacapa,2020,125827,99056,64252,8032,0,297167,72284,0.243243697988,0.0900907570490667,0.0360366019406222
GTM,Zacapa,2021,121713,100075,62209,5409,0,289406,67618,0.233644084780551,0.0841113637358359,0.0321904560068247
GTM,Zacapa,2022,115883,110365,62838,8196,0,297282,71034,0.238944840252689,0.0888382074932219,0.0357393541037354
HND,Atlántida,2021,204193,179884,126405,19447,0,529929,145852,0.275229323173482,0.103975564022099,0.0428134922057693
HND,Atlántida,2022,210355,195330,100169,15025,0,520879,115194,0.22115308929713,0.083332853375416,0.0341877224204982
HND,Choluteca,2019,306486,117462,93970,23492,0,541410,117462,0.216955726713581,0.086782044414892,0.0385696607007628
HND,Choluteca,2020,164447,140954,164447,46985,0,516833,211432,0.409091524728491,0.166666989143495,0.0757577614260527
HND,Choluteca,2021,190114,166349,123574,38023,0,518060,161597,0.311927189900784,0.12844072115199,0.0591235678407049
HND,Choluteca,2022,213893,175003,87502,38890,0,515288,126392,0.245284190588564,0.106918849264877,0.0524112513563073
HND,Colón,2021,124330,148506,72526,24175,0,369537,96701,0.261681509564671,0.109033736811199,0.0508822902412719
HND,Colón,2022,149283,142174,78196,14217,0,383870,92413,0.240740354807617,0.0925921101761881,0.0390942535522732
HND,Comayagua,2019,196712,281017,73064,11241,0,562034,84305,0.149999822074821,0.0566667971451312,0.0233335033507265
HND,Comayagua,2020,168610,269776,129268,39342,0,606996,168610,0.277777777777778,0.114197347813385,0.0524689527516564
HND,Comayagua,2021,140508,252915,196712,39342,0,629477,236054,0.375000198577549,0.145833234044559,0.0624998565828811
HND,Comayagua,2022,221487,233144,128229,11657,0,594517,139886,0.235293523986698,0.0849670124375473,0.0326795626627255
HND,Copan,2019,244179,118020,56975,20348,0,439522,77323,0.175925209659585,0.0740736527409322,0.0349791617054689
HND,Copán,2019,203483,113950,73254,16279,0,406966,89533,0.220001179459709,0.0866673546848303,0.0377782036937839
HND,Copán,2020,174995,162786,101741,20348,0,459870,122089,0.265485898188619,0.103244395155153,0.0442475288910151
HND,Copán,2021,165171,165171,103232,20646,0,454220,123878,0.272726872440668,0.106060205774001,0.0454542341205192
HND,Copán,2022,169962,169962,114724,21245,0,475893,135969,0.285713385151704,0.11011859108385,0.0466267277168047
HND,Cortés,2021,535613,660589,446344,321368,0,1963914,767712,0.390909174230643,0.184848555826104,0.0979798504415163
HND,Cortés,2022,741109,796692,370554,37055,0,1945410,407609,0.209523442359194,0.076190280369348,0.0296295154006382
HND,El Paraíso,2019,216315,147879,96140,24035,0,484369,120175,0.248106299123189,0.0992425196492757,0.0441077865107892
HND,El Paraíso,2020,188210,134436,112030,44812,0,479488,156842,0.327103076615056,0.140187032835024,0.0674974602539005
HND,El Paraíso,2021,183343,163522,138746,39642,0,525253,178388,0.339623000725365,0.138365067246958,0.0628932893079885
HND,El Paraíso,2022,199068,173547,148025,25522,0,546162,173547,0.317757368692805,0.121495697857656,0.0508829492592552
HND,Fco. Morazán,2019,19537,24817,9504,2640,0,56498,12144,0.214945661793338,0.0872243265248327,0.039458623904091
HND,Francisco Morazán,2019,144190,159779,66250,19485,0,389704,85735,0.220000307926016,0.0899999315719965,0.0411109742551042
HND,Francisco Morazán,2020,140293,155882,136396,35073,0,467644,171469,0.366665668756576,0.147221675747649,0.065740416023965
HND,Francisco Morazán,2021,502496,753744,569495,133999,0,1959734,703494,0.358974228135043,0.142450114828509,0.0626780641318329
HND,Francisco Morazán,2022,689764,689764,362126,34488,0,1776142,396614,0.223300839685115,0.0809060686964593,0.0312836598775448
HND,Gracias a Dios,2021,0,62557,46917,0,0,109474,46917,0.428567513747556,0.142855837915852,0.0476186126386174
HND,Gracias a Dios,2022,18405,43305,43305,10826,0,115841,54131,0.46728705725952,0.18691424740233,0.083072679122437
HND,Intibucá,2019,88517,104138,52069,15621,0,260345,67690,0.260001152317118,0.106667434878078,0.0488894010298301
HND,Intibucá,2020,88517,101534,72896,20828,0,283775,93724,0.330275746630253,0.134557307726192,0.0611626973639131
HND,Intibucá,2021,66252,119253,76852,15900,0,278257,92752,0.333332135400008,0.130157851674292,0.0560840438076231
HND,Intibucá,2022,71339,123471,85058,13719,0,293587,98777,0.336448820962781,0.127725909753043,0.0529595050946473
HND,Islas de la Bahía,2021,26228,28476,24730,3747,0,83181,28477,0.342349815462666,0.129132053393604,0.0530543166241222
HND,Islas de la Bahía,2022,29879,33811,18085,786,0,82561,18871,0.228570390378024,0.0793635413007756,0.0285701212167704
HND,La Paz,2019,110774,99401,48596,13032,0,271803,61628,0.226737747559814,0.0915614127388832,0.0411752466144802
HND,La Paz,2020,61850,92775,68477,11045,0,234147,79522,0.339624253140121,0.128931824879243,0.0534597686258822
HND,La Paz,2021,62875,94313,65121,11228,0,233537,76349,0.326924641491498,0.125000892078486,0.0523509717470418
HND,La Paz,2022,60293,104354,74207,11595,0,250449,85802,0.342592703504506,0.129629851453456,0.0534981395635661
HND,Lempira,2019,189625,118068,60823,42934,0,411450,103757,0.252174018714303,0.11884068538097,0.0628020145555691
HND,Lempira,2020,168158,128802,71557,21467,0,389984,93024,0.238532862886683,0.0978595703071579,0.0448522674434507
HND,Lempira,2021,109160,145547,109160,25471,0,389338,134631,0.345794656570897,0.137071987150839,0.060228730135084
HND,Lempira,2022,97796,157978,120364,18807,0,394945,139171,0.352380711238274,0.133333333333333,0.055026508613717
HND,Ocotepeque,2019,92704,60176,27648,4879,0,185407,32527,0.175435663162664,0.0672502476533608,0.0282645447283244
HND,Ocotepeque,2020,69934,65055,40660,8132,0,183781,48792,0.26548990374413,0.103246073678273,0.0442483172906884
HND,Ocotepeque,2021,74467,59574,39716,4964,0,178721,44680,0.249998601171659,0.0925912455727083,0.0370360008678953
HND,Ocotepeque,2022,78775,65075,41100,6850,0,191800,47950,0.25,0.0952380952380953,0.0396825396825397
HND,Olancho,2019,268298,205505,85627,11417,0,570847,97044,0.170000017517829,0.0633333742082671,0.0255555925376385
HND,Olancho,2020,245464,256881,114169,28542,0,645056,142711,0.22123815606707,0.088495159076628,0.0393311243950568
HND,Olancho,2021,162097,243146,173676,34735,0,613654,208411,0.339622979724731,0.132075512693907,0.0566037394217444
HND,Olancho,2022,178473,279608,148728,23796,0,630605,172524,0.273584890700201,0.103773360503009,0.0429767181251867
HND,Santa Barbara,2019,254526,138832,60161,13883,0,467402,74044,0.158416095780506,0.0627061929559566,0.0275026161158441
HND,Santa Bárbara,2019,273037,111066,69416,9255,0,462774,78671,0.169998746688448,0.0633325698216984,0.0255550705575988
HND,Santa Bárbara,2020,198993,152715,115694,23139,0,490541,138833,0.283020175683582,0.11006351490837,0.0471701425342406
HND,Santa Bárbara,2021,178440,173744,122091,23479,0,497754,145570,0.292453702029517,0.113207863054173,0.0482181514920579
HND,Santa Bárbara,2022,178785,193281,144961,33824,0,550851,178785,0.324561451281744,0.12865487521429,0.056530108262791
HND,Valle,2019,138920,46865,46865,9373,0,242023,56238,0.232366345347343,0.0903646898573001,0.0387277242245572
HND,Valle,2020,74984,65611,46865,18746,0,206206,65611,0.318181818181818,0.136363636363636,0.0656565656565657
HND,Valle,2021,56907,66392,70185,13278,0,206762,83463,0.403667018117449,0.155961927240015,0.0662581454361375
HND,Valle,2022,71841,77666,50483,9708,0,209698,60191,0.287036595484936,0.111110581248589,0.0473246711408258
HND,Yoro,2019,329663,230142,49760,12440,0,622005,62200,0.0999991961479409,0.0399996784591764,0.0177776348707451
HND,Yoro,2020,311003,248802,124401,31100,0,715306,155501,0.217390878868624,0.0869562583472435,0.0386471741542159
HND,Yoro,2021,189126,233256,201735,31521,0,655638,233256,0.355769494751677,0.13461544327815,0.0555555555555556
HND,Yoro,2022,194137,271791,194137,32356,0,692421,226493,0.327103019694666,0.124610605397583,0.0519210454654354
HTI,Artibonite HT01,2018,47071,40346,33622,13449,0,134488,47071,0.350001487121528,0.150000991414352,0.0722228831651234
HTI,Artibonite HT01,2019,40346,47071,36312,10759,0,134488,47071,0.350001487121528,0.143333729899074,0.0655556216498457
HTI,Artibonite ht03,2017,124475,260996,79213,25816,0,490500,105029,0.214126401630989,0.0889194699286442,0.0413358251217579
HTI,Artibonite ht03,2018,120460,120460,120460,40153,0,401533,160613,0.399999501908934,0.166666251590778,0.077777473388793
HTI,Artibonite ht03,2019,120460,132506,140536,60230,0,453732,200766,0.442477056941102,0.191740204937423,0.0934119700616223
HTI,Artibonite ht03,2020,100383,140536,152582,60230,0,453731,212812,0.469026802224225,0.200590217551809,0.0963620392797593
HTI,Artibonite ht03,2021,100383,140536,140536,60230,0,441685,200766,0.454545660368815,0.196969937096951,0.0959597903483252
HTI,Artibonite ht03,2022,100383,80306,160613,60230,0,401532,220843,0.550000996184613,0.23333383142564,0.111111387829059
HTI,Artibonite ht04,2017,146581,306904,68710,24736,0,546931,93446,0.170855190142815,0.072027367254736,0.0340595472229993
HTI,Artibonite ht04,2018,192387,183226,68710,13742,0,458065,82452,0.180000654928886,0.0700002546945666,0.0300001091548143
HTI,Artibonite ht04,2019,187807,183226,114516,45807,0,531356,160323,0.301724267722582,0.129310669306454,0.0622608320347689
HTI,Artibonite ht04,2020,137420,160323,137420,45807,0,480970,183227,0.380953073996299,0.158730620759438,0.0740743820935933
HTI,Artibonite ht04,2021,137420,160323,137420,68710,0,503873,206130,0.409091179721874,0.181818302098611,0.0909091510493054
HTI,Artibonite ht04,2022,137420,114516,137420,68710,0,458066,206130,0.450000654927456,0.200000291078869,0.100000145539435
HTI,Artibonite_ht01,2021,188815,220284,188815,31469,0,629383,220284,0.349999920557117,0.133333227409489,0.0555554672856856
HTI,Artibonite_ht01,2022,188815,188815,188815,62938,0,629383,251753,0.399999682228468,0.166666401857057,0.0777775835840639
HTI,Artibonite_ht01 + ht05,2019,177450,207025,147875,59150,0,591500,207025,0.35,0.15,0.0722222222222222
HTI,Artibonite_ht01 + ht05,2020,177450,188815,220284,62938,0,649487,283222,0.436070313955476,0.177658162005809,0.0807536477934808
HTI,Artibonite_ht01 + ht05,2021,157346,188815,188815,94407,0,629383,283222,0.449999443899819,0.199999576304624,0.0999996998824422
HTI,Bas plateau ht03,2021,126538,90384,90384,54231,0,361537,144615,0.400000553193726,0.183333932626536,0.0944449208057082
HTI,Bas plateau ht03,2022,126538,72307,108461,54231,0,361537,162692,0.45000096808902,0.200000737591634,0.100000522460741
HTI,Ca1-ouest ht07,2019,51149,28416,22733,11366,0,113664,34099,0.299998240427928,0.133331573761261,0.0666652981106106
HTI,Ca1-ouest ht07,2020,39782,28416,28416,17050,0,113664,45466,0.400003519144144,0.183335679429429,0.0944460085085085
HTI,Ca2-ouest ht07,2019,126315,57416,34449,11483,0,229663,45932,0.199997387476433,0.083332244781847,0.0388883808981953
HTI,Ca2-ouest ht07,2020,103348,57416,45933,22966,0,229663,68899,0.300000435420595,0.133333043052937,0.0666662796261382
HTI,Ca3-ouest ht07,2019,53178,23740,16143,1899,0,94960,18042,0.189995787700084,0.0699978938500421,0.0277766076944678
HTI,Ca3-ouest ht07,2020,50329,23740,16143,1899,0,92111,18042,0.195872371378011,0.0721629338515487,0.0286357402119906
HTI,Carrefour P+TP,2020,102998,102998,102998,34333,0,343327,137331,0.400000582535018,0.166667152112515,0.0777781337713997
HTI,Carrefour P+TP,2021,102998,102998,102998,34333,0,343327,137331,0.400000582535018,0.166667152112515,0.0777781337713997
HTI,Carrefour_P+TP,2021,85832,137331,85832,34333,0,343328,120165,0.350000582533321,0.150000388355547,0.0722224811259204
HTI,Carrefour_P+TP,2022,85832,120164,85832,51499,0,343327,137331,0.400000582535018,0.183333478967088,0.0944444606259727
HTI,Centre ht03,2017,247660,304268,206011,92467,0,850406,298478,0.350982942265224,0.153238570753264,0.0752423613609918
HTI,Centre ht03,2018,212280,247660,212280,35380,0,707600,247660,0.35,0.133333333333333,0.0555555555555556
HTI,Centre ht03,2019,212280,247660,226432,70760,0,757132,297192,0.392523364485981,0.161993769470405,0.0747663551401869
HTI,Centre ht03,2020,212280,247660,212280,70760,0,742980,283040,0.380952380952381,0.158730158730159,0.0740740740740741
HTI,Centre ht03,2021,176900,247660,212280,70760,0,707600,283040,0.4,0.166666666666667,0.0777777777777778
HTI,Cite Soleil P+TP,2020,115237,76825,134443,57619,0,384124,192062,0.5,0.216667013776801,0.10555590266569
HTI,Cite Soleil P+TP,2021,76825,96031,153650,57619,0,384125,211269,0.550000650829808,0.233333767219872,0.111111400368804
HTI,Cite Soleil P_TP,2021,57619,96031,153650,76825,0,384125,230475,0.6,0.266666666666667,0.133333333333333
HTI,Cite Soleil P_TP,2022,57619,76825,172856,76825,0,384125,249681,0.649999349170192,0.283333116390064,0.138888816574466
HTI,Croix de Bouquet P+ TP,2021,27302,23402,19501,7801,0,78006,27302,0.34999871804733,0.15000128195267,0.0722237890532637
HTI,Croix de Bouquet P+ TP,2022,27302,19501,23402,7801,0,78006,31203,0.400007691716022,0.166670939842234,0.0777803416831184
HTI,Croix des Bouquets P+TP,2020,19501,27302,23402,7801,0,78006,31203,0.400007691716022,0.166670939842234,0.0777803416831184
HTI,Croix des Bouquets P+TP,2021,15601,19501,31202,11701,0,78005,42903,0.550003204922761,0.233335469948508,0.111112535521227
HTI,Cs1-ouest ht07,2019,48016,48016,57619,38412,0,192063,96031,0.499997396687545,0.233331424237533,0.122220891640301
HTI,Cs1-ouest ht07,2020,48016,48016,57619,38412,0,192063,96031,0.499997396687545,0.233331424237533,0.122220891640301
HTI,Cs2-ouest ht07,2019,76825,48016,48016,19206,0,192063,67222,0.349999739668755,0.149999392560427,0.0722216726340373
HTI,Cs2-ouest ht07,2020,76825,48016,48016,19206,0,192063,67222,0.349999739668755,0.149999392560427,0.0722216726340373
HTI,Cxb1-ouest ht07,2019,3793,2371,2371,948,0,9483,3319,0.349994727406939,0.149987697282857,0.0722110911924262
HTI,Cxb1-ouest ht07,2020,3793,2371,2371,948,0,9483,3319,0.349994727406939,0.149987697282857,0.0722110911924262
HTI,Cxb2-ouest ht07,2019,34262,13705,17131,3426,0,68524,20557,0.299997081314576,0.116664720876384,0.0499987028064782
HTI,Cxb2-ouest ht07,2020,30835,17131,17131,3426,0,68523,20557,0.300001459364009,0.116666423439332,0.049999432469552
HTI,Cxb3-ouest ht07,2019,55407,41260,17683,3537,0,117887,21220,0.180002884117842,0.0700020641235534,0.0300014232084774
HTI,Cxb3-ouest ht07,2020,55407,41260,17683,3537,0,117887,21220,0.180002884117842,0.0700020641235534,0.0300014232084774
HTI,De1-zone métropolitaine,2019,24721,34609,24721,14832,0,98883,39553,0.399997977407643,0.183331142191614,0.0944427027676929
HTI,De1-zone métropolitaine,2020,24721,29665,29665,14832,0,98883,44497,0.449996460463376,0.199997303210191,0.0999980897738854
HTI,De2-zone métropolitaine,2019,77654,90596,51769,38827,0,258846,90596,0.349999613669904,0.166666666666667,0.0888889747400213
HTI,De2-zone métropolitaine,2020,77654,77654,64712,38827,0,258847,103539,0.400000772657207,0.183333526497635,0.0944444659071447
HTI,De3-zone métropolitaine,2019,71679,41353,20677,4135,0,137844,24812,0.180000580366211,0.0699994196337889,0.0299992906635198
HTI,De3-zone métropolitaine,2020,71679,41353,20677,4135,0,137844,24812,0.180000580366211,0.0699994196337889,0.0299992906635198
HTI,Delmas P+TP,2020,107318,125205,107318,17886,0,357727,125204,0.349998742057491,0.13333258788592,0.0555550896509225
HTI,Delmas P+TP,2021,89432,125205,125205,35773,0,375615,160978,0.428571808900071,0.174603428155603,0.0793652484000314
HTI,Delmas P+TP,2022,89432,107318,143091,17886,0,357727,160977,0.44999958068583,0.166666200762034,0.0666662939429602
HTI,Grande-anse ht07,2017,56851,58038,41077,19807,0,175773,60884,0.346378567811894,0.153021226240663,0.076048211171353
HTI,Grande-anse ht07,2018,61461,30730,46096,15365,0,153652,61461,0.400001301642673,0.166666666666667,0.0777774885238504
HTI,Grande-anse ht07,2019,46096,38413,53778,23048,0,161335,76826,0.476189295565129,0.206349107963761,0.100529264504843
HTI,Grande-anse ht07,2020,46096,53778,53778,23048,0,176700,76826,0.434782116581777,0.188405961139408,0.0917877130101239
HTI,Grande-anse ht07,2021,30730,46096,61461,23048,0,161335,84509,0.523810704434872,0.222222910920342,0.105820532157037
HTI,Grande-anse ht07,2022,30730,46096,61461,23048,0,161335,84509,0.523810704434872,0.222222910920342,0.105820532157037
HTI,Grande-anse ht08,2017,152676,105877,65676,47576,0,371805,113252,0.304600529847635,0.144186692845264,0.0764976862124561
HTI,Grande-anse ht08,2018,93748,80356,66963,26785,0,267852,93748,0.349999253318997,0.149999502212665,0.0722218903639987
HTI,Grande-anse ht08,2019,66963,93748,80356,40178,0,281245,120534,0.428572952408043,0.190476867736908,0.095238433868454
HTI,Grande-anse ht08,2020,66963,80356,93748,53570,0,294637,147318,0.499998302996569,0.227271750210146,0.116161016210908
HTI,Grande-anse ht08,2021,66963,80356,93748,40178,0,281245,133926,0.476189798929759,0.206349149910813,0.100529194593089
HTI,Grande-anse ht08,2022,53570,66963,107141,40178,0,267852,147319,0.550001493362006,0.233334080014336,0.111111525933891
HTI,Haut plateau ht03,2021,86516,86516,103819,69213,0,346064,173032,0.5,0.233333525975927,0.122222414864816
HTI,Haut plateau ht03,2022,86516,69213,121122,69213,0,346064,190335,0.549999422072218,0.25,0.127777906206174
HTI,La gonave & artibon ht01,2017,217144,332502,224893,50031,0,824570,274924,0.333414992056466,0.131363417700539,0.0572711972435465
HTI,Nippes ht01,2017,88426,96321,26812,26325,0,237884,53137,0.223373577037548,0.111345585803725,0.0617070131287145
HTI,Nippes ht01,2018,44213,50529,55266,7895,0,157903,63161,0.399998733399619,0.149999261149778,0.0611106537276401
HTI,Nippes ht01,2019,55266,55266,53687,23685,0,187904,77372,0.411763453678474,0.179270620458674,0.0877676307523464
HTI,Nippes ht01,2020,55266,63161,39476,23685,0,181588,63161,0.347825847522964,0.159419491743214,0.0821248589603327
HTI,Nippes ht01,2021,47371,47371,55266,15790,0,165798,71056,0.428569705304045,0.174602025758252,0.0793643134684643
HTI,Nippes ht01,2022,47371,55266,55266,15790,0,173693,71056,0.409089600617181,0.166665707119266,0.0757569069821147
HTI,Nippes ht07,2017,93951,109050,66347,16777,0,286125,83124,0.290516382699869,0.116383864860929,0.0518246687054027
HTI,Nippes ht07,2018,58719,63752,36909,8388,0,167768,45297,0.269997854179581,0.106665156644891,0.0466656334938725
HTI,Nippes ht07,2019,58719,63752,36909,8388,0,167768,45297,0.269997854179581,0.106665156644891,0.0466656334938725
HTI,Nippes ht07,2021,50331,33554,50331,33554,0,167770,83885,0.5,0.233333333333333,0.122222222222222
HTI,Nippes ht07,2022,41942,58719,58719,25165,0,184545,83884,0.454544961933404,0.196969122255638,0.0959591307148813
HTI,Nippes ht07 + ht08,2019,41942,41942,58719,25165,0,167768,83884,0.5,0.216666269292515,0.105555158181404
HTI,Nippes ht07 + ht08,2020,41942,58719,62075,30198,0,192934,92273,0.478261996330351,0.211593947498454,0.105313503869487
HTI,Nippes ht07 + ht08,2021,41942,50331,58719,16777,0,167769,75496,0.449999701971163,0.183333432676279,0.0833334989049096
HTI,Nord ht02,2017,263387,375126,151647,47888,0,838048,199535,0.238094953988316,0.0984124218819606,0.0455024321067794
HTI,Nord ht02,2021,140915,169098,169098,84549,0,563660,253647,0.45,0.2,0.1
HTI,Nord ht02,2022,140915,140915,197281,84549,0,563660,281830,0.5,0.216666666666667,0.105555555555556
HTI,Nord ht02 + ht03,2019,319256,199535,199535,79814,0,798140,279349,0.35,0.15,0.0722222222222222
HTI,Nord ht02 + ht03,2020,359163,119721,199535,119721,0,798140,319256,0.4,0.183333333333333,0.0944444444444444
HTI,Nord ht02 +ht03,2018,239442,319256,199535,39907,0,798140,239442,0.3,0.116666666666667,0.05
HTI,Nord ht02 +ht03,2019,159628,319256,239442,79814,0,798140,319256,0.4,0.166666666666667,0.0777777777777778
HTI,Nord ht02 +ht03,2020,159628,239442,319256,79814,0,798140,399070,0.5,0.2,0.0888888888888889
HTI,Nord ht02 +ht03,2021,159628,199535,319256,119721,0,798140,438977,0.55,0.233333333333333,0.111111111111111
HTI,Nord ht03,2021,70344,58620,70344,35172,0,234480,105516,0.45,0.2,0.1
HTI,Nord ht03,2022,70344,46896,82068,35172,0,234480,117240,0.5,0.216666666666667,0.105555555555556
HTI,Nord-est ht02,2017,99100,225728,80748,33400,0,438976,114148,0.260032439131069,0.112039534431647,0.0542545479580762
HTI,Nord-est ht02,2021,98492,118190,137888,39397,0,393967,177285,0.449999619257451,0.183333460247517,0.0833335448569719
HTI,Nord-est ht02,2022,98492,98492,137888,59095,0,393967,196983,0.499998730858168,0.216666201314662,0.105555372235069
HTI,Nord-est ht02 + ht03,2019,91760,128463,128463,18352,0,367038,146815,0.399999455097292,0.149999909182882,0.0611111413834838
HTI,Nord-est ht02 + ht03,2020,91760,128463,110111,36704,0,367038,146815,0.399999455097292,0.166666666666667,0.0777778988672684
HTI,Nord-est ht02 +Ht03,2018,112811,131613,112811,18802,0,376037,131613,0.350000132965639,0.133333510620852,0.0555557032951545
HTI,Nord-est ht02 +Ht03,2019,94010,131613,112811,37604,0,376038,150415,0.399999468138858,0.166666666666667,0.0777778959691426
HTI,Nord-est ht02 +Ht03,2020,78793,137888,137888,39397,0,393966,177285,0.450000761487032,0.183333925601025,0.0833337563816844
HTI,Nord-est ht02 +Ht03,2021,78793,118190,137888,59095,0,393966,196983,0.5,0.216666751276337,0.105555640165226
HTI,Nord-ouest ht01,2017,141942,122136,162164,45300,0,471542,207464,0.439969292236959,0.178679028944753,0.0809080751143176
HTI,Nord-ouest ht01,2018,122136,145243,52816,9903,0,330098,62719,0.190001151173288,0.0733337776458304,0.031111299607322
HTI,Nord-ouest ht01,2019,115534,132039,82525,66020,0,396118,148545,0.375001893375206,0.180556467180655,0.0972227130972757
HTI,Nord-ouest ht01,2020,66020,99029,115534,66020,0,346603,181554,0.523809661197393,0.238095650258846,0.121693503326092
HTI,Nord-ouest ht01,2021,66020,82525,132039,99029,0,379613,231068,0.608693590577773,0.289853965310285,0.154588722959669
HTI,Nord-ouest ht01,2022,66020,82525,99029,82525,0,330099,181554,0.549998636772605,0.266666464707053,0.144444545424252
HTI,Nord-ouest ht02,2017,138745,155394,85439,29401,0,408979,114840,0.280796813528323,0.11756186340456,0.0551625715093766
HTI,Nord-ouest ht02,2018,69372,83247,102671,22199,0,277489,124870,0.449999819812677,0.176666462454368,0.0766665024959948
HTI,Nord-ouest ht02,2019,83247,83247,105446,27749,0,299689,133195,0.444444073689725,0.17901224269159,0.0802468929827625
HTI,Nord-ouest ht02,2020,83247,83247,97121,55498,0,319113,152619,0.478260052081864,0.217391122684859,0.111111111111111
HTI,Nord-ouest ht02,2021,97121,69372,83247,69372,0,319112,152619,0.47826155080348,0.231884103386899,0.125603758763903
HTI,Nord-ouest ht02,2022,97121,83247,83247,13874,0,277489,97121,0.349999459438032,0.133332612584042,0.0555549549311464
HTI,Ouest HT01 La gonave,2018,26123,26123,26123,8708,0,87077,34831,0.400002296817759,0.166668580681466,0.0777791813886305
HTI,Ouest HT01 La gonave,2019,21769,26123,26123,13062,0,87077,39185,0.450004019431078,0.200003062423679,0.100002169216772
HTI,Ouest ht05,2017,237893,124375,31719,18815,0,412802,50534,0.122417042553088,0.0559985981980061,0.0287948109639865
HTI,Ouest ht05,2018,105730,79298,66081,13216,0,264325,79297,0.299998108389294,0.116665720861313,0.0499994745525815
HTI,Ouest ht05,2019,79298,79298,79298,26433,0,264327,105731,0.400000756638558,0.166667297198798,0.0777782401680074
HTI,Ouest ht05,2020,59565,69493,69493,19855,0,218406,89348,0.40909132532989,0.166666666666667,0.0757574832600244
HTI,Ouest ht05,2021,49638,69493,69493,29783,0,218407,99276,0.45454587078253,0.196970182579618,0.0959599890723893
HTI,Ouest ht05,2022,49638,59565,59565,29783,0,198551,89348,0.450000251824468,0.200000671531915,0.100000615570922
HTI,Ouest ht06,2017,108141,62121,16822,6488,0,193572,23310,0.120420308722336,0.0513125176506244,0.0245524490456609
HTI,Ouest ht06,2018,42055,36047,36047,6008,0,120157,42055,0.35000041612224,0.133333888162987,0.0555560179136001
HTI,Ouest ht06,2019,42055,36047,42055,12016,0,132173,54071,0.409092628600395,0.16666792764029,0.0757584546179796
HTI,Ouest ht06,2020,42055,42055,42055,12016,0,138181,54071,0.391305606414775,0.159421338678979,0.0724645372534735
HTI,Ouest ht06,2021,48062,42055,42055,12016,0,144188,54071,0.375003467694954,0.152779704274974,0.0694456003427624
HTI,Ouest ht06,2022,48062,24031,36047,12016,0,120156,48063,0.400004993508439,0.166669440838022,0.0777794422805908
HTI,Ouest ht07,2017,904525,504803,110553,86315,0,1606196,196868,0.122567855977726,0.0587688758615594,0.0315315745331758
HTI,Ouest ht07,2018,301508,351759,301508,50251,0,1005026,351759,0.349999900500087,0.133333200666782,0.0555554450000962
HTI,Ouest ht07,2019,251257,331659,351759,70352,0,1005027,422111,0.419999661700631,0.163333257050142,0.0699999988944465
HTI,Ouest ht07,2021,351759,251257,251257,150754,0,1005027,402011,0.400000198999629,0.183333383083241,0.0944444499722119
HTI,Ouest ht07,2022,351759,251257,251257,150754,0,1005027,402011,0.400000198999629,0.183333383083241,0.0944444499722119
HTI,Ouest ht07 + ht03,2019,301508,301508,251257,150754,0,1005027,402011,0.400000198999629,0.183333383083241,0.0944444499722119
HTI,Ouest ht07 + ht03,2020,301508,267253,267253,201005,0,1037019,468258,0.45154235361165,0.215123991620854,0.114781246373821
HTI,Ouest ht07 + ht03,2021,190895,229074,267253,76358,0,763580,343611,0.45,0.183333333333333,0.0833333333333333
HTI,Ouest_ht01-la gonave,2019,30477,21769,21769,13062,0,87077,34831,0.400002296817759,0.183335821552572,0.0944464222597369
HTI,Ouest_ht01-la gonave,2020,30477,26123,26123,17415,0,100138,43538,0.434780003595039,0.202896669263084,0.106278890686408
HTI,Ouest_ht01-la gonave,2021,21769,26123,30477,17415,0,95784,47892,0.5,0.227271778167544,0.116160667056433
HTI,Ouest_ht01-la gonave,2022,21769,17415,34831,13062,0,87077,47893,0.550007464657717,0.233337544165892,0.111113663130843
HTI,Pap1-zone métropolitaine,2019,148698,111524,92936,18587,0,371745,111523,0.299998654991997,0.116665994162665,0.0499996263866659
HTI,Pap1-zone métropolitaine,2020,148698,92936,111524,18587,0,371745,130111,0.350000672504001,0.133333333333333,0.0555554061102219
HTI,Pap2-zone métropolitaine,2019,233486,175114,145929,29186,0,583715,175115,0.300000856582408,0.11666709495787,0.0500002379395576
HTI,Pap2-zone métropolitaine,2020,233486,145929,175114,29186,0,583715,204300,0.349999571708796,0.133333333333333,0.0555556507313786
HTI,Pap3-zone métropolitaine,2019,98109,53514,26757,0,0,178380,26757,0.15,0.05,0.0166666666666667
HTI,Pap3-zone métropolitaine,2020,98109,53514,26757,0,0,178380,26757,0.15,0.05,0.0166666666666667
HTI,Petion Ville P+TP,2020,67559,42224,50669,8445,0,168897,59114,0.350000296038414,0.133333728051219,0.0555558844871266
HTI,Petion Ville P+TP,2021,59114,50669,59114,8445,0,177342,67559,0.380953186498404,0.142857679887825,0.058201416221513
HTI,Petion Ville P+TP,2022,50669,59114,50669,8445,0,168897,59114,0.350000296038414,0.133333728051219,0.0555558844871266
HTI,Port au Prince P+TP,2020,382184,238865,286638,47773,0,955460,334411,0.35,0.133333333333333,0.0555555555555556
HTI,Port au Prince P+TP,2021,334411,286638,334411,95546,0,1051006,429957,0.409090909090909,0.166666666666667,0.0757575757575758
HTI,Port au Prince P+TP,2022,286638,238865,334411,95546,0,955460,429957,0.45,0.183333333333333,0.0833333333333333
HTI,Pv1 + Pv2- ouest ht07,2019,67559,59114,33779,8445,0,168897,42224,0.24999851980793,0.0999998026410574,0.0444445760170729
HTI,Pv1 + Pv2- ouest ht07,2020,67559,50669,42224,8445,0,168897,50669,0.299999407923172,0.116666765346138,0.0500002302520997
HTI,Pv3-ouest ht07,2019,80725,56508,24218,0,0,161451,24218,0.150002167840397,0.0500007226134658,0.0166669075378219
HTI,Pv3-ouest ht07,2020,80725,53279,24218,3229,0,161451,27447,0.170002043963803,0.063333973362403,0.0255557413704468
HTI,Sud ht01,2017,42571,59127,12298,10879,0,124875,23177,0.185601601601602,0.0909069069069069,0.0496621065509954
HTI,Sud ht01,2018,37841,33111,18920,4730,0,94602,23650,0.249994714699478,0.0999978858797911,0.0444435048354627
HTI,Sud ht01,2019,33111,33111,23651,9460,0,99333,33111,0.333333333333333,0.142856184081155,0.0687821100070806
HTI,Sud ht01,2020,28381,42571,28381,9460,0,108793,37841,0.347825687314441,0.144926603733696,0.0676320065527092
HTI,Sud ht01,2021,33111,37841,28381,9460,0,108793,37841,0.347825687314441,0.144926603733696,0.0676320065527092
HTI,Sud ht01,2022,33111,33111,28381,9460,0,104063,37841,0.363635490039687,0.151513986719583,0.0707061000440972
HTI,Sud ht07,2017,186716,225157,121936,19847,0,553656,141783,0.256085005852009,0.0973107248303399,0.0404029457521156
HTI,Sud ht07,2018,172071,128138,54916,10983,0,366108,65899,0.179998798168846,0.0699993808748602,0.0299996479484499
HTI,Sud ht07,2019,159847,146444,79924,19981,0,406196,99905,0.245952692788703,0.0983810771154812,0.0437249231624361
HTI,Sud ht07,2020,159847,139866,99905,19981,0,419599,119886,0.285715647558741,0.111111640717288,0.0476192745931234
HTI,Sud ht07,2021,119885,119885,119885,79924,0,439579,199809,0.454546281783252,0.212121901486043,0.11111161664532
HTI,Sud ht07,2022,119885,119885,119885,59943,0,419598,179828,0.428572109495279,0.190476757912732,0.0952385113582259
HTI,Sud ht08,2017,117636,137996,60778,18946,0,335356,79724,0.237729457650974,0.0980748816183399,0.0452461132514568
HTI,Sud ht08,2018,67867,90489,56556,11311,0,226223,67867,0.300000442041702,0.11666659299305,0.0499998280948936
HTI,Sud ht08,2019,56556,101800,67867,22622,0,248845,90489,0.363635998312202,0.15151466441627,0.070706664791336
HTI,Sud ht08,2020,56556,101800,67867,33933,0,260156,101800,0.391303679330863,0.173912319275102,0.0869559460904654
HTI,Sud ht08,2021,56556,90489,67867,33933,0,248845,101800,0.409089995780506,0.181817329395139,0.0909084414439153
HTI,Sud ht08,2022,56556,67867,79178,45245,0,248846,124423,0.5,0.22727309259542,0.116161981484309
HTI,Sud-est ht01,2017,196138,142991,92963,27921,0,460013,120884,0.26278387784693,0.107826662869673,0.0494302455703547
HTI,Sud-est ht01,2018,111021,111021,129525,18504,0,370071,148029,0.400001621310505,0.150000945764461,0.0611116965843491
HTI,Sud-est ht01,2019,111021,129525,129525,37007,0,407078,166532,0.40909113241197,0.166666666666667,0.0757575261306733
HTI,Sud-est ht01,2020,129525,92518,129525,55511,0,407079,185036,0.454545677865967,0.196969957510295,0.0959598068734133
HTI,Sud-est ht01,2021,129525,111021,111021,74014,0,425581,185035,0.434782097885009,0.202898312346338,0.106280068371891
HTI,Sud-est ht01,2022,129525,129525,92518,55511,0,407079,148029,0.363637033597901,0.166667076087606,0.0858588463991838
HTI,Sud-est ht07,2017,68389,131435,41419,12767,0,254010,54186,0.21332231014527,0.087861370287259,0.0404564124771991
HTI,Sud-est ht07,2018,64115,64115,74801,10686,0,213717,85487,0.400000935816992,0.150000545893245,0.0611114490450248
HTI,Sud-est ht07,2019,64115,64115,79075,21372,0,228677,100447,0.439252745138339,0.177570692869564,0.079958971727711
HTI,Sud-est ht07,2020,64115,64115,74801,21372,0,224403,96173,0.428572701790974,0.174604023416205,0.079365645240433
HTI,Sud-est ht07,2021,53429,64115,74801,32057,0,224402,106858,0.47619005178207,0.206348428267128,0.100528416760001
HTI,Sud-est ht07,2022,53429,64115,64115,32057,0,213716,96172,0.44999906417863,0.19999906417863,0.0999992721389341
HTI,Ta1 + Ta2- ouest ht07,2019,14200,11045,4733,1578,0,31556,6311,0.199993662061098,0.0833333333333333,0.0388902973197561
HTI,Ta1 + Ta2- ouest ht07,2020,14200,11045,4733,1578,0,31556,6311,0.199993662061098,0.0833333333333333,0.0388902973197561
HTI,Ta3-ouest ht07,2019,19649,18714,7018,1404,0,46785,8422,0.180014962060489,0.0700081935093157,0.0300048686069847
HTI,Ta3-ouest ht07,2020,19649,18714,7018,1404,0,46785,8422,0.180014962060489,0.0700081935093157,0.0300048686069847
HTI,Tabarre P+TP,2020,12622,9467,7889,1578,0,31556,9467,0.300006337938902,0.116670891959268,0.0500028168617343
HTI,Tabarre P+TP,2021,12622,9467,9467,1578,0,33134,11045,0.333343393493089,0.126989396591618,0.0529130869264871
HTI,Tabarre P+TP,2022,12622,7889,9467,1578,0,31556,11045,0.350012675877805,0.133339671272236,0.0555590766327235
HTI,Ville de Jérémie,2021,14836,8478,12716,6358,0,42388,19074,0.449985845050486,0.199993708911327,0.0999968544556636
HTI,Ville de Jérémie,2022,16955,12716,12716,4239,0,46626,16955,0.36363831338738,0.151517751183174,0.0707092370970894
HTI,Ville de jérémie,2017,15490,28612,4968,390,0,49460,5358,0.108329963606955,0.0387383744439951,0.0146650491980051
HTI,Ville des Cayes,2021,34712,17356,26034,8678,0,86780,34712,0.4,0.166666666666667,0.0777777777777778
HTI,Ville des Cayes,2022,34712,39051,26034,4339,0,104136,30373,0.291666666666667,0.111111111111111,0.0462962962962963
HTI,Ville des cayes,2017,42338,41672,2770,0,0,86780,2770,0.0319197971882922,0.0106399323960974,0.00354664413203247
KEN,BANGLADESH,2020,16342,65366,73537,16342,0,171587,89879,0.523810078852128,0.206350131420212,0.0899478916752953
KEN,Baringo,2019,246294,351849,105555,35185,0,738883,140740,0.190476706054951,0.0793652941895627,0.0370371372884626
KEN,Baringo,2020,566766,166696,33339,0,0,766801,33339,0.0434780340662049,0.0144926780220683,0.00483089267402277
KEN,Baringo,2021,400070,233374,100017,33339,0,766800,133356,0.173912363067293,0.0724634846113719,0.0338162928186402
KEN,Baringo,2022,200035,233374,266713,33339,0,733461,300052,0.409090599227498,0.151514986254666,0.0606059642041105
KEN,DANDORA,2020,73918,103485,103485,44351,0,325239,147836,0.454545734060184,0.196970023070214,0.0959598599457288
KEN,Embu,2020,231503,108943,13618,0,0,354064,13618,0.038461972976637,0.012820657658879,0.00427355255295967
KEN,Embu,2021,190650,163414,27236,0,0,381300,27236,0.0714293207448204,0.0238097735816068,0.00793659119386893
KEN,Embu,2022,204268,68089,27236,0,0,299593,27236,0.0909100012350088,0.0303033337450029,0.0101011112483343
KEN,Embu (Mbeere),2019,65766,120571,43844,0,0,230181,43844,0.19047619047619,0.0634920634920635,0.0211640211640212
KEN,GITHURAI,2020,64918,86557,54098,32459,0,238032,86557,0.363635981716744,0.166666666666667,0.0858586707296125
KEN,Garissa,2019,107988,172780,129585,43195,0,453548,172780,0.380951960983182,0.158729983742992,0.0740739924133964
KEN,Garissa,2020,504812,336541,84135,0,0,925488,84135,0.0909087962242622,0.0303029320747541,0.0101009773582514
KEN,Garissa,2021,336541,378609,210338,84135,0,1009623,294473,0.291666295240897,0.12499979365235,0.0601850613765953
KEN,Garissa,2022,378609,252406,210338,126203,0,967556,336541,0.347825862275672,0.159420229940179,0.0821255938789188
KEN,Isiolo,2019,31093,69959,46640,15547,0,163239,62187,0.380956756657416,0.158732492439511,0.0740754354045296
KEN,Isiolo,2020,147401,120601,26800,13400,0,308202,40200,0.13043393618471,0.0579706383043156,0.0289853191521578
KEN,Isiolo,2021,80401,147401,80401,26800,0,335003,107201,0.320000119401916,0.13333313433014,0.0622219966852702
KEN,Isiolo,2022,67001,120601,93801,40200,0,321603,134001,0.416665889310734,0.180554907758945,0.0879624879121153
KEN,KANGEMI,2020,30074,52629,60148,15037,0,157888,75185,0.476191984191326,0.19047679367653,0.0846563527451245
KEN,KAWANGWARE,2020,58313,102048,116626,29157,0,306144,145783,0.476190942824292,0.190476812654611,0.084656603138102
KEN,KAYOLE,2020,55162,73549,64356,9194,0,202261,73550,0.36363906042193,0.13636505966713,0.0555563795733675
KEN,KIBRA,2020,24011,42020,48023,18009,0,132063,66032,0.500003786071799,0.212123506710181,0.101011554249781
KEN,KONDELE,2020,24823,41371,16548,4137,0,86879,20685,0.238089757018382,0.0952359028073528,0.042327067914379
KEN,Kajiado,2019,522433,304752,87072,0,0,914257,87072,0.095237991068157,0.031745997022719,0.010581999007573
KEN,Kajiado,2020,782488,503028,55892,0,0,1341408,55892,0.0416666666666667,0.0138888888888889,0.00462962962962963
KEN,Kajiado,2021,726596,503028,111784,0,0,1341408,111784,0.0833333333333333,0.0277777777777778,0.00925925925925926
KEN,Kajiado,2022,614812,447136,111784,0,0,1173732,111784,0.0952380952380952,0.0317460317460318,0.0105820105820106
KEN,Kilifi,2019,559990,629989,209996,0,0,1399975,209996,0.149999821425383,0.0499999404751275,0.0166666468250425
KEN,Kilifi,2020,1017651,436136,145379,72689,0,1671855,218068,0.130434756602696,0.0579709364747541,0.0289854350074884
KEN,Kilifi,2021,726894,726894,218068,0,0,1671856,218068,0.130434678584759,0.0434782261949195,0.0144927420649732
KEN,Kilifi,2022,726894,581515,218068,0,0,1526477,218068,0.142857049270968,0.0476190164236561,0.015873005474552
KEN,Kitui,2019,219537,658612,274422,0,0,1152571,274422,0.238095527303741,0.0793651757679136,0.0264550585893046
KEN,Kitui,2020,965759,284047,56809,0,0,1306615,56809,0.0434779946656054,0.0144926648885351,0.00483088829617838
KEN,Kitui,2021,852140,454475,170428,0,0,1477043,170428,0.115384589345063,0.0384615297816877,0.0128205099272292
KEN,Kitui,2022,624903,340856,227237,56809,0,1249805,284046,0.227272254471698,0.0909088484470244,0.0404039030088694
KEN,Kwale,2019,287070,410100,123030,0,0,820200,123030,0.15,0.05,0.0166666666666667
KEN,Kwale,2020,520092,303387,86682,43341,0,953502,130023,0.136363636363636,0.0606060606060606,0.0303030303030303
KEN,Kwale,2021,433410,346728,130023,43341,0,953502,173364,0.181818181818182,0.0757575757575758,0.0353535353535354
KEN,Kwale,2022,433410,346728,130023,43341,0,953502,173364,0.181818181818182,0.0757575757575758,0.0353535353535354
KEN,Laikipia,2019,252856,202285,75857,0,0,530998,75857,0.142857411892324,0.0476191372974412,0.0158730457658137
KEN,Laikipia,2020,440776,207424,25928,0,0,674128,25928,0.0384615384615385,0.0128205128205128,0.00427350427350427
KEN,Laikipia,2021,440776,233352,51856,0,0,725984,51856,0.0714285714285714,0.0238095238095238,0.00793650793650794
KEN,Laikipia,2022,207424,259280,77784,0,0,544488,77784,0.142857142857143,0.0476190476190476,0.0158730158730159
KEN,Lamu,2019,38443,64072,32036,0,0,134551,32036,0.238095592006005,0.0793651973353351,0.026455065778445
KEN,Lamu county,2020,100744,79156,14392,0,0,194292,14392,0.0740740740740741,0.0246913580246914,0.00823045267489712
KEN,Lamu county,2021,57568,79156,21588,7196,0,165508,28784,0.173913043478261,0.072463768115942,0.0338164251207729
KEN,Lamu county,2022,57568,64764,14392,7196,0,143920,21588,0.15,0.0666666666666667,0.0333333333333333
KEN,MATHARE,2020,41313,72297,82626,30985,0,227221,113611,0.500002200500834,0.212122412394394,0.101010812283098
KEN,MUKURU,2020,161957,215942,161957,53986,0,593842,215943,0.363637129068001,0.151515610774134,0.0707073598701338
KEN,MWEMBE TAYARI,2020,23126,61668,61668,15417,0,161879,77085,0.476189005368207,0.190475602147283,0.0846558231765702
KEN,Makueni,2019,335658,575413,239756,0,0,1150827,239756,0.208333659185959,0.0694445530619864,0.0231481843539955
KEN,Makueni,2020,888888,296296,49383,0,0,1234567,49383,0.0400002592001892,0.0133334197333964,0.00444447324446547
KEN,Makueni,2021,592592,444444,98765,0,0,1135801,98765,0.0869562537803717,0.0289854179267906,0.00966180597559686
KEN,Makueni,2022,592592,345679,98765,0,0,1037036,98765,0.0952377738092024,0.0317459246030675,0.0105819748676892
KEN,Mandera,2019,142223,320003,213335,71112,0,746673,284447,0.380952572277289,0.158730350055067,0.0740742228823357
KEN,Mandera,2020,433729,390356,86746,43373,0,954204,130119,0.136363922180163,0.0606061876356279,0.0303030938178139
KEN,Mandera,2021,346983,390356,173491,43373,0,954203,216864,0.227272393819764,0.0909090273942407,0.0404040509898488
KEN,Mandera,2022,260237,303610,260237,216864,0,1040948,477101,0.45833317322287,0.222222115481913,0.120370299210164
KEN,Marsabit,2019,47390,157968,94781,31594,0,331733,126375,0.380953959961777,0.15873106785678,0.074074632309719
KEN,Marsabit,2020,252882,252882,68968,22989,0,597721,91957,0.153846025152203,0.064102371061638,0.0299143654722595
KEN,Marsabit,2021,183914,206903,114946,45979,0,551742,160925,0.291667119776997,0.125000453110331,0.0601855376043312
KEN,Marsabit,2022,45979,183914,183914,137936,0,551743,321850,0.58333318229683,0.27777787846878,0.148148282402818
KEN,Meru,2019,310393,310393,193996,0,0,814782,193996,0.238095588758711,0.0793651962529036,0.0264550654176345
KEN,Meru,2020,718883,308093,38244,0,0,1065220,38244,0.0359024426878955,0.0119674808959652,0.00398916029865505
KEN,Meru,2021,667534,359441,51349,0,0,1078324,51349,0.0476192684202522,0.0158730894734174,0.00529102982447246
KEN,Meru,2022,420687,191221,152977,38244,0,803129,191221,0.238095000927622,0.0952379173623831,0.0423279171562449
KEN,Narok,2019,592745,484974,0,0,0,1077719,0,0,0,0
KEN,Narok,2020,1099979,173681,0,0,0,1273660,0,0,0,0
KEN,Narok,2021,984192,173681,57894,0,0,1215767,57894,0.0476193217943899,0.0158731072647966,0.00529103575493221
KEN,Narok,2022,984192,347362,115787,57894,0,1505235,173681,0.115384640936465,0.0512821364548836,0.0256411051356691
KEN,Nyeri,2019,79115,87906,17581,0,0,184602,17581,0.0952373213724662,0.0317457737908221,0.0105819245969407
KEN,Nyeri,2020,188956,29835,0,0,0,218791,0,0,0,0
KEN,Nyeri,2021,159121,59670,19890,0,0,238681,19890,0.0833329841922901,0.02777766139743,0.00925922046581001
KEN,Nyeri,2022,109396,69615,19890,0,0,198901,19890,0.0999994972373191,0.033333165745773,0.011111055248591
KEN,OBUNGA,2020,27421,41131,18281,9140,0,95973,27421,0.285715774228168,0.126983630812833,0.0634912365399065
KEN,Samburu,2019,85134,127701,70945,14189,0,297969,85134,0.285714285714286,0.111111111111111,0.0476190476190476
KEN,Samburu,2020,201713,108614,31033,15516,0,356876,46549,0.130434660778534,0.0579706490022678,0.0289851688292603
KEN,Samburu,2021,170680,139647,31033,15516,0,356876,46549,0.130434660778534,0.0579706490022678,0.0289851688292603
KEN,Samburu,2022,77582,124131,108614,31033,0,341360,139647,0.409090110147645,0.166666666666667,0.0757577533005234
KEN,TANA RIVER,2020,126377,157972,47391,0,0,331740,47391,0.142855850967625,0.0476186169892084,0.0158728723297361
KEN,TANA RIVER,2021,126377,126377,63189,15797,0,331740,78986,0.238096099354916,0.095238238781375,0.0423279944802824
KEN,TANA RIVER,2022,110580,157972,94783,31594,0,394929,126377,0.319999291011802,0.133332826913192,0.0622218733550137
KEN,Taita,2020,306604,68134,17034,0,0,391772,17034,0.0434793706543602,0.0144931235514534,0.0048310411838178
KEN,Taita,2021,306604,34067,17034,0,0,357705,17034,0.0476202457332159,0.0158734152444053,0.00529113841480177
KEN,Taita,2022,204403,119235,34067,0,0,357705,34067,0.0952376958667058,0.0317458986222353,0.0105819662074118
KEN,Taita taveta,2019,143269,179087,53726,0,0,376082,53726,0.142857142857143,0.0476190476190476,0.0158730158730159
KEN,Tana river,2019,75762,136371,90914,15152,0,318199,106066,0.333332285770854,0.126983428609141,0.0529095873267288
KEN,Tana river,2020,126377,142174,47391,0,0,315942,47391,0.149999050458629,0.0499996834862095,0.0166665611620698
KEN,Tana river,2021,110580,157972,47391,15797,0,331740,63188,0.190474467956834,0.0793643616486807,0.0370367021027177
KEN,Tharaka,2020,120236,46758,6680,0,0,173674,6680,0.0384628672109815,0.0128209557369938,0.00427365191233128
KEN,Tharaka,2021,106876,46758,20039,0,0,173673,20039,0.115383508087037,0.0384611693623457,0.0128203897874486
KEN,Tharaka,2022,46758,73477,20039,0,0,140274,20039,0.142856124442163,0.0476187081473877,0.0158729027157959
KEN,Tharaka-nithi,2019,79223,237669,99029,0,0,415921,99029,0.238095696057665,0.0793652320192216,0.0264550773397405
KEN,Turkana,2019,216731,487644,325096,108365,0,1137836,433461,0.380952087998622,0.158729963427653,0.0740739438724034
KEN,Turkana,2020,463488,556186,92698,46349,0,1158721,139047,0.12000041424985,0.0533335174443776,0.0266667587221888
KEN,Turkana,2021,370790,417139,278093,92698,0,1158720,370791,0.320000517812759,0.133333621007088,0.0622223948264752
KEN,Turkana,2022,231744,370790,324442,139046,0,1066022,463488,0.434782771837729,0.188405742720757,0.0917873489790392
KEN,Wajir,2019,137670,206505,114725,22945,0,481845,137670,0.285714285714286,0.111111111111111,0.0476190476190476
KEN,Wajir,2020,312504,429693,117189,39063,0,898449,156252,0.173913043478261,0.072463768115942,0.0338164251207729
KEN,Wajir,2021,273442,429695,195316,39063,0,937516,234379,0.25,0.0972221629639743,0.0416666074084187
KEN,Wajir,2022,117189,390632,312505,156253,0,976579,468758,0.480000081918616,0.213333483517462,0.106666798646659
KEN,West pokot,2019,324709,259767,97413,0,0,681889,97413,0.142857561861241,0.0476191872870805,0.0158730624290268
KEN,West pokot,2020,590179,93186,0,0,0,683365,0,0,0,0
KEN,West pokot,2021,528055,124248,62124,0,0,714427,62124,0.0869564000240752,0.0289854666746917,0.00966182222489725
KEN,West pokot,2022,496993,93186,62124,0,0,652303,62124,0.095237949235248,0.031745983078416,0.010581994359472
LAC,Candelaria,2018,8100,15930,2970,540,0,27540,3510,0.127450980392157,0.0490196078431373,0.0206971677559913
LAC,Candelaria,2019,8100,14310,3510,1080,0,27000,4590,0.17,0.07,0.0322222222222222
LAC,Cayaguanca,2018,10680,3000,960,360,0,15000,1320,0.088,0.0373333333333333,0.0177777777777778
LAC,Cayaguanca,2019,9602,3600,1200,0,0,14402,1200,0.0833217608665463,0.0277739202888488,0.00925797342961626
LAC,Cayaguanca,2020,9642,2401,1200,0,0,13243,1200,0.0906139092350676,0.0302046364116892,0.0100682121372297
LAC,Cayaguanca,2021,9144,2772,1446,0,0,13362,1446,0.108217332734621,0.0360724442448735,0.0120241480816245
LAC,Cayaguanca,2022,8431,3563,1425,0,0,13419,1425,0.106192711826515,0.0353975706088382,0.0117991902029461
LAC,Ch`orti`,2021,81764,108217,48097,2405,0,240483,50502,0.210002370229912,0.0733343590468626,0.0266671656624377
LAC,Ch`orti`,2022,72145,96193,93788,9619,0,271745,103407,0.380529540561924,0.138642231994456,0.0540801118695836
LAC,Chorti,2018,54000,61570,63000,5400,0,183970,68400,0.371799749959233,0.133717453932706,0.0510952872750992
LAC,Chorti,2019,72000,104003,59746,2213,0,237962,61959,0.260373505013406,0.0898911030612731,0.0320303241694052
LAC,Chorti,2020,55321,92401,84087,13277,0,245086,97364,0.397264633638804,0.150479151535923,0.0621981218384114
LAC,Chorti,2021,33000,99001,103401,13200,0,248602,116601,0.469026797853597,0.174041238606286,0.069813061305487
LAC,Chorti,2022,67335,69740,84169,19239,0,240483,103408,0.430001289072408,0.170000928686574,0.0744450866704831
LAC,Guija,2019,111818,49888,8601,1720,0,172027,10321,0.0599963959145948,0.0233316087978438,0.00999907637237824
LAC,Guija,2020,94615,68811,30965,3441,0,197832,34406,0.173915241214768,0.0637695957512772,0.0251217643702176
LAC,Guija,2021,77412,77412,27524,1720,0,184068,29244,0.158876067540257,0.0560734800906911,0.0207676873039674
LAC,Guija,2022,52068,61660,21924,1370,0,137022,23294,0.17000189750551,0.0600000973079749,0.022221897862306
LAC,Guisayote,2018,30810,20000,4000,780,0,55590,4780,0.085986688253283,0.0333393296156383,0.0142311766704643
LAC,Guisayote,2019,27300,6240,3900,1560,0,39000,5460,0.14,0.06,0.0288888888888889
LAC,Güija,2021,76732,46587,13702,0,0,137021,13702,0.0999992701848622,0.0333330900616207,0.0111110300205402
LAC,Güija,2022,68511,60290,20553,1370,0,150724,21923,0.145451288447759,0.0515135833266987,0.0191910747827523
LAC,GÜIJA,2018,46020,22420,8260,0,0,76700,8260,0.107692307692308,0.0358974358974359,0.011965811965812
LAC,GÜIJA,2019,35400,12980,9440,1180,0,59000,10620,0.18,0.0666666666666667,0.0266666666666667
LAC,Ocotepeque,2020,48866,22120,16590,2765,0,90341,19355,0.214243809565978,0.0816166893584677,0.0340069538993616
LAC,Ocotepeque,2021,76869,37805,13845,2443,0,130962,16288,0.124371955223653,0.0476754071155501,0.0200371948436272
LAC,Ocotepeque,2022,71829,50406,18902,1260,0,142397,20162,0.141590061588376,0.0501461875367225,0.0186817294059722
LAC,Ocotopeque,2019,47696,13825,6912,691,0,69124,7603,0.109990741276546,0.0399957564184171,0.0155533694680735
LAC,Ocotopeque,2020,40092,15207,12442,1382,0,69123,13824,0.199991319821188,0.0733282216724776,0.0288857061566579
LAC,Santa Ana,2018,27300,2700,0,0,0,30000,0,0,0,0
LAC,Sensenti,2018,26400,23010,6000,0,0,55410,6000,0.108283703302653,0.036094567767551,0.0120315225891837
LAC,Sensenti,2019,22000,10000,8000,0,0,40000,8000,0.2,0.0666666666666667,0.0222222222222222
LAC,Sesecapa,2018,33120,12880,5060,920,0,51980,5980,0.115044247787611,0.0442477876106195,0.0186823992133727
LAC,Sesecapa,2019,27600,8740,8280,1380,0,46000,9660,0.21,0.08,0.0333333333333333
LBR,Bomi,2020,49740,44213,13264,3316,0,110533,16580,0.150000452353596,0.0600001809414383,0.0266667470850837
LBR,Bomi,2021,51258,55267,29616,10252,0,146393,39868,0.272335425874188,0.114122032246533,0.0536030487189354
LBR,Bong,2020,245390,131459,43820,17528,0,438197,61348,0.140000958473016,0.0600004107741495,0.028889086669035
LBR,Bong,2021,212672,180998,113124,26292,0,533086,139416,0.261526282813655,0.103615551712106,0.0454985999757388
LBR,Gbarpolu,2020,93137,10957,5479,0,0,109573,5479,0.0500031942175536,0.0166677314058512,0.00555591046861707
LBR,Gbarpolu,2021,82180,28216,14672,3386,0,128454,18058,0.140579507060893,0.0556463792486026,0.0244064887906263
LBR,Grand bassa,2020,180610,72827,29131,8739,0,291307,37870,0.130000308952411,0.0533331960211507,0.0244442384761704
LBR,Grand bassa,2021,203915,99319,63203,6019,0,372456,69222,0.185852825568658,0.0673377078992776,0.0260370799951314
LBR,Grand cape mount,2020,100187,50094,16698,0,0,166979,16698,0.100000598877703,0.0333335329592344,0.0111111776530781
LBR,Grand cape mount,2021,124148,66792,37934,12070,0,240944,50004,0.207533700776944,0.0858761095247582,0.0397575093521039
LBR,Grand gedeh,2020,115213,36210,13167,0,0,164590,13167,0.0799987848593475,0.0266662616197825,0.00888875387326083
LBR,Grand gedeh,2021,106984,68135,42585,10220,0,227924,52805,0.231678103227392,0.0921725370445119,0.0406885141050916
LBR,Grand kru,2020,45659,22829,7610,0,0,76098,7610,0.100002628189966,0.0333342093966552,0.0111114031322184
LBR,Grand kru,2021,36534,51624,11913,2383,0,102454,14296,0.13953579167236,0.0542650034812371,0.0232570497762682
LBR,Lofa,2020,309231,36380,18190,0,0,363801,18190,0.049999862562225,0.016666620854075,0.00555554028469166
LBR,Lofa,2021,289679,109140,29104,0,0,427923,29104,0.0680122358461686,0.0226707452820562,0.00755691509401873
LBR,Margibi,2020,226190,35859,13792,0,0,275841,13792,0.049999818736156,0.0166666062453853,0.00555553541512844
LBR,Margibi,2021,176880,99852,28529,0,0,305261,28529,0.0934577296149852,0.0311525765383284,0.0103841921794428
LBR,Maryland,2020,94671,44656,23221,16076,0,178624,39297,0.219998432461483,0.103332512241729,0.0544439716947331
LBR,Maryland,2021,131328,46242,33294,12504,0,223368,45798,0.20503384549264,0.0870044052863436,0.0414413285102014
LBR,Montserrado,2020,881628,440814,146938,0,0,1469380,146938,0.1,0.0333333333333333,0.0111111111111111
LBR,Montserrado,2021,690609,587752,191019,0,0,1469380,191019,0.129999727776341,0.0433332425921137,0.0144444141973712
LBR,Montserrado Rural,2021,72733,53035,30306,7576,0,163650,37882,0.231481820959365,0.0925919136368266,0.04115150897919
LBR,Nimba,2020,394620,151777,60711,0,0,607108,60711,0.100000329430678,0.0333334431435593,0.0111111477145198
LBR,Nimba,2021,456956,187790,75116,0,0,719862,75116,0.104347777768517,0.0347825925895056,0.0115941975298352
LBR,River cess,2021,50537,29156,18466,5831,0,103990,24297,0.23364746610251,0.0965733884668398,0.0446517293329487
LBR,River gee,2020,75474,8776,3510,0,0,87760,3510,0.0399954421148587,0.0133318140382862,0.00444393801276208
LBR,River gee,2021,57045,29093,17274,3637,0,107049,20911,0.195340451568908,0.0764385156953046,0.0330295264577696
LBR,Rivercess,2020,81749,9396,2819,0,0,93964,2819,0.030000851389894,0.0100002837966313,0.00333342793221045
LBR,Rivercess,2021,79869,9396,4698,0,0,93963,4698,0.0499984036269596,0.0166661345423198,0.00555537818077328
LBR,Sinoe,2020,110325,17491,6727,0,0,134543,6727,0.049998885114796,0.0166662950382653,0.00555543167942178
LBR,Sinoe,2021,84145,40363,20691,9656,0,154855,30347,0.195970423944981,0.0861085101116098,0.0425595270127252
LSO,Berea,2017,104514,45289,26129,6968,0,182900,33097,0.18095680699836,0.0730180426462548,0.0328054188688415
LSO,Berea,2018,106970,71313,23177,5348,0,206808,28525,0.137929867316545,0.0545965339832115,0.0239454523573126
LSO,Berea,2019,80677,80677,26892,8964,0,197210,35856,0.181816337913899,0.0757568074641245,0.0353531768165914
LSO,Berea,2020,63176,90251,63176,9025,0,225628,72201,0.320000177282961,0.119999881811359,0.0488887313040344
LSO,Berea,2021,72692,81778,45432,0,0,199902,45432,0.227271362967854,0.0757571209892848,0.0252523736630949
LSO,Berea,2022,100631,64038,45432,9086,0,219187,54518,0.24872825486913,0.0967271477475093,0.041454202221036
LSO,Butha-Buthe,2017,70709,8319,4991,1664,0,85683,6655,0.0776700162225879,0.0323634793366245,0.015103475731605
LSO,Butha-Buthe,2018,57365,29967,11130,0,0,98462,11130,0.113038532631878,0.0376795108772928,0.0125598369590976
LSO,Butha-Buthe,2019,44522,29967,11130,0,0,85619,11130,0.129994510564244,0.0433315035214146,0.0144438345071382
LSO,Butha-buthe,2019,51371,29967,17124,0,0,98462,17124,0.173914809774329,0.0579716032581097,0.0193238677527032
LSO,Butha-buthe,2020,25860,47411,25860,4310,0,103441,30170,0.291663847023907,0.111110036961489,0.0462958487339536
LSO,Butha-buthe,2021,43394,39054,13018,0,0,95466,13018,0.136362684096956,0.0454542280323187,0.0151514093441062
LSO,Butha-buthe,2022,48057,34715,13107,0,0,95879,13107,0.136703553437145,0.0455678511457149,0.0151892837152383
LSO,Leribe,2017,208868,4973,27352,14919,0,256112,42271,0.165048884862873,0.0744335811415839,0.0377560511720567
LSO,Leribe,2018,174026,104928,33270,0,0,312224,33270,0.106558112124628,0.0355193707082095,0.0118397902360698
LSO,Leribe,2019,127961,104928,38388,12796,0,284073,51184,0.180179038486586,0.0750745993694109,0.0350348130390584
LSO,Leribe,2020,103064,115947,77298,12883,0,309192,90181,0.291666666666667,0.111111111111111,0.0462962962962963
LSO,Leribe,2021,155648,90795,38912,0,0,285355,38912,0.136363477072419,0.0454544923574729,0.015151497452491
LSO,Leribe,2022,143648,91412,39177,0,0,274237,39177,0.142858184708847,0.0476193949029489,0.0158731316343163
LSO,Mafeteng,2017,103177,29906,11963,13458,0,158504,25421,0.160380810578913,0.0817623950604822,0.0461222149318349
LSO,Mafeteng,2018,90803,46171,23086,4617,0,164677,27703,0.168226285395046,0.0654209958484387,0.0280373768717618
LSO,Mafeteng,2019,80030,46171,53866,7695,0,187762,61561,0.327867193574845,0.12294997567843,0.0500905993284643
LSO,Mafeteng,2020,61980,38738,54233,15495,0,170446,69728,0.409091442450982,0.166666666666667,0.0757574572331152
LSO,Mafeteng,2021,70202,62402,39001,0,0,171605,39001,0.227271932635995,0.0757573108786652,0.0252524369595551
LSO,Mafeteng,2022,70679,62826,39001,0,0,172506,39001,0.226084889800935,0.0753616299336448,0.0251205433112149
LSO,Maseru,2017,131435,62376,26733,15594,0,236138,42327,0.179246881061074,0.0817615123360069,0.0419288721002126
LSO,Maseru,2018,158207,77957,36686,6879,0,279729,43565,0.155740019804883,0.0601105593866445,0.0255016660966706
LSO,Maseru,2019,107764,91714,80250,11464,0,291192,91714,0.314960575839996,0.118109929759975,0.0481186906844205
LSO,Maseru,2020,69253,80795,80795,23084,0,253927,103879,0.409090014059159,0.16666601031005,0.0757571182969033
LSO,Maseru,2021,116207,81345,58104,11621,0,267277,69725,0.260871679942532,0.101450305613028,0.0434788211813545
LSO,Maseru,2022,116998,81898,58499,11621,0,269016,70120,0.260653641419098,0.101283938501799,0.043360907075333
LSO,Mohale's hoek,2017,105190,30490,19818,10671,0,166169,30489,0.183481876884377,0.0825665436994867,0.0417927932807363
LSO,Mohale's hoek,2018,95713,47072,28243,10983,0,182011,39226,0.215514446929032,0.0919523179002002,0.0440602185826376
LSO,Mohale's hoek,2019,78453,47072,39227,12552,0,177304,51779,0.292035148671209,0.120942937929582,0.0560462382248693
LSO,Mohale's hoek,2020,63189,39493,55291,15797,0,173770,71088,0.409092478563619,0.166666666666667,0.0757572269858625
LSO,Mohale's hoek,2021,87476,55667,23857,0,0,167000,23857,0.14285628742515,0.0476187624750499,0.0158729208250166
LSO,Mohale's hoek,2022,80065,55667,40032,0,0,175764,40032,0.227759950843176,0.075919983614392,0.0253066612047973
LSO,Mokhotlong,2017,56772,37848,4731,0,0,99351,4731,0.0476190476190476,0.0158730158730159,0.00529100529100529
LSO,Mokhotlong,2018,69144,29216,9739,0,0,108099,9739,0.0900933403639257,0.0300311134546419,0.0100103711515473
LSO,Mokhotlong,2019,58432,48693,14608,4869,0,126602,19477,0.153844331053222,0.0641011463747282,0.02991351725179
LSO,Mokhotlong,2020,44122,39219,24512,4902,0,112755,29414,0.260866480422154,0.101447090299026,0.043476761316325
LSO,Mokhotlong,2021,44422,39486,24679,4936,0,113523,29615,0.260872246152762,0.101450807325388,0.0434791970692185
LSO,Mokhotlong,2022,54662,34550,24847,4936,0,118995,29783,0.250287827219631,0.0972561872347578,0.0416366700748397
LSO,Qacha's nek,2017,29842,14921,6928,2665,0,54356,9593,0.176484656707631,0.0751710942674222,0.0359522816657264
LSO,Qacha's nek,2018,31263,17551,9873,2742,0,61429,12615,0.205359032378844,0.0833319767536506,0.0376966362250186
LSO,Qacha's nek,2019,24682,21939,13712,5485,0,65818,19197,0.291667932784345,0.125001266117678,0.0601861699433792
LSO,Qacha's nek,2020,16566,19327,22088,2761,0,60742,24849,0.409090909090909,0.151515151515152,0.0606060606060606
LSO,Qacha's nek,2021,25018,25018,13899,0,0,63935,13899,0.217392664424806,0.0724642214749355,0.0241547404916452
LSO,Qacha's nek,2022,22390,25018,13994,0,0,61402,13994,0.227907885736621,0.0759692952455403,0.0253230984151801
LSO,Quthing,2017,68815,42869,3384,5641,0,120709,9025,0.0747665874127033,0.0404996037301831,0.0238848065273601
LSO,Quthing,2018,77794,38317,23222,5806,0,145139,29028,0.200001377989376,0.0800014698553341,0.0355567191910284
LSO,Quthing,2019,52250,35994,40639,5806,0,134689,46445,0.344831426471353,0.129312712990667,0.0526835071081446
LSO,Quthing,2020,29225,46760,46760,5845,0,128590,52605,0.409090909090909,0.151515151515152,0.0606060606060606
LSO,Quthing,2021,52963,47078,29424,0,0,129465,29424,0.227273780558452,0.0757579268528174,0.0252526422842725
LSO,Quthing,2022,53323,41473,29624,0,0,124420,29624,0.238096769008198,0.0793655896693993,0.0264551965564665
LSO,Thaba tseka,2017,72223,39172,12241,8569,0,132205,20810,0.157407057221739,0.0740743542226088,0.0390950081733335
LSO,Thaba tseka,2018,81895,31498,17639,5040,0,136072,22679,0.166669116350168,0.0679027769612166,0.0308651955500683
LSO,Thaba tseka,2019,71815,50397,37798,6300,0,166310,44098,0.265155432625819,0.101012166035316,0.0420887365629113
LSO,Thaba tseka,2020,57082,57082,31712,6342,0,152218,38054,0.249996715237357,0.0972202148672737,0.0416653892589722
LSO,Thaba tseka,2021,51084,63856,25542,0,0,140482,25542,0.181816887572785,0.0606056291909284,0.0202018763969761
LSO,Thaba tseka,2022,70719,63856,32145,0,0,166720,32145,0.19280830134357,0.06426943378119,0.02142314459373
MDG,4 commune de taolanaro,2017,5205,18591,18219,9296,0,51311,27515,0.536239792637056,0.239136507441549,0.119972109077759
MDG,5 communes de Taolagnaro,2018,12614,21023,5351,3058,0,42046,8409,0.199995243304952,0.09090837019772,0.0464649827966196
MDG,Amboasary-atsimo,2019,89942,128489,51395,25698,0,295524,77093,0.260868829604364,0.115942078026376,0.0579712270031838
MDG,Amboasary-atsimo,2020,115640,128489,121968,54208,0,420305,176176,0.419162275014573,0.182711760903788,0.0895645886783275
MDG,Amboasary-atsimo,2021,27104,55672,139180,83508,27836,333300,250524,0.751647164716472,0.38974297429743,0.241269460279361
MDG,Amboasary-atsimo,2022,43199,129598,125262,55672,0,353731,180934,0.511501677828633,0.222962269822737,0.109295230305263
MDG,Amboasary-atsimo,2023,14400,100799,115198,57599,0,287996,172797,0.599997916637731,0.266665740727881,0.13333287036394
MDG,Amboasary-sud,2017,90725,153535,81420,58157,0,383837,139577,0.363636126793405,0.171716987505981,0.0909089593296692
MDG,Amboasary-sud,2018,83544,88318,71609,23870,0,267341,95479,0.357143124324365,0.148809946846911,0.0694448081081632
MDG,Ambovombe-androy,2017,197127,326155,136197,53762,0,713241,189959,0.266332137384138,0.113903061284101,0.0547181418654035
MDG,Ambovombe-androy,2018,139716,139716,123749,59878,0,463059,183627,0.396552059240831,0.175287238415263,0.0871645585839674
MDG,Ambovombe-androy,2019,181155,155793,90577,18115,0,445640,108692,0.24390090656135,0.0948501032223319,0.0406499017642542
MDG,Ambovombe-androy,2020,181155,163039,133748,38214,0,516156,171962,0.333158967443951,0.135731574691889,0.0616962485932332
MDG,Ambovombe-androy,2021,57321,117737,176605,117737,0,469400,294342,0.627060076693652,0.292628177815651,0.153281494105951
MDG,Ambovombe-androy,2022,63333,168889,190000,78491,0,500713,268491,0.53621735405312,0.230991938828564,0.111832526816759
MDG,Ambovombe-androy,2023,42222,168889,190000,21111,0,422222,211111,0.5,0.183333254385923,0.0722221432748122
MDG,Ampanihy,2017,86273,293327,155291,51764,0,586655,207055,0.352941677817457,0.14705917447222,0.0686276905127848
MDG,Ampanihy,2018,46032,141638,169965,70819,0,428454,240784,0.561983316762126,0.242424313150692,0.117539131647997
MDG,Ampanihy,2019,179268,119512,99594,19919,0,418293,119513,0.285715993334816,0.111111908000692,0.0476194650373994
MDG,Ampanihy,2020,179268,199187,147062,21009,0,546526,168071,0.307526082931096,0.115322357338291,0.0469832277980472
MDG,Ampanihy,2021,63027,147062,168071,42018,0,420178,210089,0.5,0.200000158662916,0.0888890475518048
MDG,Ampanihy ouest,2019,59756,179268,139431,39837,0,418292,179268,0.428571428571429,0.174602908972679,0.0793648137345841
MDG,Ampanihy ouest,2021,86304,151033,151033,107880,0,496250,258913,0.521739042821159,0.246376490344249,0.130434480828435
MDG,Ampanihy ouest,2022,137674,172609,206511,86304,0,603098,292815,0.485518108168158,0.209539743126324,0.101646830200067
MDG,Ampanihy ouest,2023,68837,160620,206511,22946,0,458914,229457,0.5,0.183333551239085,0.0722224401279736
MDG,Beheloka commune de toliary,2017,2846,7115,7115,2846,0,19922,9961,0.5,0.214285714285714,0.103174603174603
MDG,Bekily,2017,80691,193234,78568,21235,0,373728,99803,0.267047157290864,0.107955518451922,0.0486117057206192
MDG,Bekily,2018,63704,93432,53086,31852,0,242074,84938,0.350876178358684,0.160818592661748,0.0828461085820406
MDG,Bekily,2019,106522,111256,59179,11836,0,288793,71015,0.24590277465174,0.0956290491805549,0.0409839881468349
MDG,Bekily,2020,118358,94686,74901,37451,0,325396,112352,0.345277753875278,0.153457120964404,0.0767287312143426
MDG,Bekily,2021,49934,102564,115385,49934,0,317817,165319,0.520170412532999,0.225761995110394,0.110168570103061
MDG,Bekily,2022,39500,131667,124137,41379,0,336683,165516,0.491607832887315,0.204836597036381,0.0955904119503113
MDG,Bekily,2023,27586,68965,124137,55172,0,275860,179309,0.65,0.283333333333333,0.138888888888889
MDG,Beloha,2017,35285,82736,48668,30418,0,197107,79086,0.401233847605615,0.18518537308839,0.096022295842698
MDG,Beloha,2018,12485,31212,62424,31212,0,137333,93636,0.681817188876672,0.303029861722965,0.151514930861483
MDG,Beloha,2019,46396,85059,46396,15465,0,193316,61861,0.319999379254692,0.133332643616324,0.0622216704486149
MDG,Beloha,2020,38663,92791,57091,16312,0,204857,73403,0.358313360051158,0.145979878647056,0.0663546875245768
MDG,Beloha,2021,32623,58632,75384,33504,0,200143,108888,0.544051003532474,0.237150437437232,0.116250214430016
MDG,Beloha,2022,27034,81102,75384,18023,0,201543,93407,0.46345941064686,0.184294832037497,0.0813038518937508
MDG,Beloha,2023,18023,72090,63079,27034,0,180226,90113,0.5,0.216666851619633,0.105555740508522
MDG,Betioky atsimo,2019,108071,154387,108071,15439,0,385968,123510,0.320000621813207,0.120000449087316,0.0488891997954926
MDG,Betioky atsimo,2020,154387,179120,92632,0,0,426139,92632,0.217375081839494,0.0724583606131646,0.0241527868710549
MDG,Betioky atsimo,2021,97702,195404,117063,33447,0,443616,150510,0.339279917766717,0.138225402149607,0.0628298648681142
MDG,Betioky atsimo,2022,106709,188923,124494,35570,0,455696,160064,0.351251711667427,0.143102711749353,0.0650467758232584
MDG,Betioky atsimo,2023,71139,88924,142279,53355,0,355697,195634,0.550001827398038,0.233334364173252,0.111111735862577
MDG,Betioky-sud,2017,34267,114223,114223,34267,0,296980,148490,0.5,0.205128291467439,0.0940171803563278
MDG,Betioky-sud,2018,35161,84387,128924,35161,0,283633,164085,0.578511668247348,0.234159400821954,0.105601252322544
MDG,Betroka,2020,66718,100077,44479,11120,0,222394,55599,0.250002248262093,0.100001199073116,0.0444451439037624
MDG,Betroka,2021,66718,137039,68520,22840,0,295117,91360,0.309572135796989,0.128988389915412,0.0601945819605257
MDG,Betroka,2022,70892,137039,79940,11420,0,299291,91360,0.305254752064045,0.114470532024017,0.0466361426764513
MDG,Betroka,2023,59077,118153,59077,0,0,236307,59077,0.250001057945808,0.0833336859819359,0.027777895327312
MDG,Brickaville,2018,202263,25283,20686,0,0,248232,20686,0.0833333333333333,0.0277777777777778,0.00925925925925926
MDG,Farafangana,2017,110617,244120,228862,57216,0,640815,286078,0.446428376364473,0.178571558614161,0.0793652527553888
MDG,Farafangana,2018,234149,148295,78050,46830,0,507324,124880,0.246154331354322,0.112820735204064,0.0581197726808816
MDG,Farafangana,2019,243704,142161,81235,0,0,467100,81235,0.173913508884607,0.0579711696282024,0.0193237232094008
MDG,Farafangana,2020,264013,192781,42840,0,0,499634,42840,0.0857427637030306,0.0285809212343435,0.00952697374478118
MDG,Farafangana,2021,175988,219985,64260,0,0,460233,64260,0.139624929111993,0.0465416430373311,0.0155138810124437
MDG,Farafangana,2022,219985,257244,93543,0,0,570772,93543,0.163888557953088,0.054629519317696,0.0182098397725653
MDG,Farafangana,2023,116929,233859,116929,0,0,467717,116929,0.249999465488746,0.0833331551629155,0.0277777183876385
MDG,Manakara,2021,103050,247321,61830,0,0,412201,61830,0.149999636099864,0.0499998786999546,0.0166666262333182
MDG,Manakara,2022,144270,267931,61830,0,0,474031,61830,0.130434507447825,0.043478169149275,0.0144927230497584
MDG,Manakara Atsimo,2020,100341,240818,60205,0,0,401364,60205,0.150000996601589,0.0500003322005295,0.0166667774001765
MDG,Manakara Atsimo,2021,60205,280955,60205,0,0,401365,60205,0.150000622874441,0.0500002076248137,0.0166667358749379
MDG,Manakara atsimo,2019,308236,114161,38054,0,0,460451,38054,0.0826450588661986,0.0275483529553995,0.00918278431846651
MDG,Manakara atsimo,2020,266377,95135,19027,0,0,380539,19027,0.0500001313925774,0.0166667104641925,0.00555557015473082
MDG,Manakara atsimo,2022,84436,168871,168871,21109,0,443287,189980,0.428571106303591,0.158730122922621,0.063492099299601
MDG,Manakara atsimo,2023,84436,189980,147762,0,0,422178,147762,0.349999289399258,0.116666429799753,0.0388888099332509
MDG,Manakara-sud,2017,191643,313968,89705,28543,0,623859,118248,0.189542829389333,0.0784317182782221,0.0363110895250369
MDG,Manakara-sud,2018,292020,125152,41717,29202,0,488091,70919,0.145298725032832,0.0683759107762009,0.0360873052133493
MDG,Mananjary,2018,302142,85220,27115,15494,0,429971,42609,0.0990973809861595,0.0450441231307848,0.0230224829116382
MDG,Mananjary,2022,92771,92771,139156,46385,0,371083,185541,0.499998652592547,0.208332547345652,0.0972217356584197
MDG,Mananjary,2023,61847,123694,123694,0,0,309235,123694,0.4,0.133333333333333,0.0444444444444444
MDG,Morombe,2018,78769,65879,15754,11457,0,171859,27211,0.158333284843971,0.0749994666170136,0.0398142922072422
MDG,Nosy-varika,2022,56522,98913,127174,0,0,282609,127174,0.449999823077114,0.149999941025705,0.0499999803419015
MDG,Nosy-varika,2023,70652,113044,98913,0,0,282609,98913,0.349999469231341,0.11666648974378,0.0388888299145934
MDG,Taolagnaro,2019,15690,17651,7845,3923,0,45109,11768,0.260879203706577,0.115948775927938,0.0579756195486981
MDG,Taolagnaro,2020,144068,162077,36017,18009,0,360171,54026,0.150000971760636,0.0666674070557226,0.0333338577755813
MDG,Taolagnaro,2021,126060,184948,73979,18495,0,403482,92474,0.229189901903926,0.0916761259899244,0.0407450366779408
MDG,Taolagnaro,2022,133946,221938,92474,18495,0,466853,110969,0.237695805746134,0.0924373767902673,0.0396160866244597
MDG,Taolagnaro,2023,114811,172216,95676,0,0,382703,95676,0.25000065324808,0.0833335510826934,0.0277778503608978
MDG,Taolagnaro (5 communes),2021,8140,12209,16279,6105,0,42733,22384,0.523810638148504,0.222224822346508,0.105822458313507
MDG,Toamasina ii,2018,234711,45245,36762,5656,0,322374,42418,0.131580090205786,0.0497083098099309,0.0204682897642007
MDG,Toliara 2,2021,200115,180103,80046,0,0,460264,80046,0.17391323240575,0.0579710774685832,0.0193236924895277
MDG,Toliara 2,2022,164414,200115,100057,0,0,464586,100057,0.215368091160732,0.0717893637202441,0.023929787906748
MDG,Toliara II,2019,277114,166268,55423,0,0,498805,55423,0.111111556620323,0.0370371855401075,0.0123457285133692
MDG,Toliara II,2020,221691,147794,36949,0,0,406434,36949,0.0909102092836721,0.0303034030945574,0.0101011343648525
MDG,Toliara ii,2018,150863,168967,39224,18104,0,377158,57328,0.151999957577461,0.0666670201878258,0.0328892518372789
MDG,Toliara ii,2019,221691,155184,48033,18474,0,443382,66507,0.149999323382546,0.0638884754004448,0.0305552924265457
MDG,Toliary-II,2022,212817,170254,85127,0,0,468198,85127,0.181818375986228,0.0606061253287427,0.0202020417762476
MDG,Toliary-II,2023,148972,170254,85127,21282,0,425635,106409,0.250000587357713,0.100000391571808,0.0444447054923167
MDG,Tsihombe,2018,44010,47783,45268,18862,0,155923,64130,0.411292753474471,0.177420906473067,0.0860225168120732
MDG,Tsihombe,2019,59880,67365,37425,11976,0,176646,49401,0.279661016949153,0.115819209039548,0.0536723163841808
MDG,Tsihombe,2020,82335,78947,47368,7895,0,216545,55263,0.255203306472096,0.0972207470348734,0.0405089011521855
MDG,Tsihombe,2021,24323,78947,72970,40539,0,216779,113509,0.523616217438036,0.236874112959896,0.120514953529222
MDG,Tsihombe,2022,43614,78505,81078,24323,0,227520,105401,0.463260372714487,0.190055086732302,0.0871083372401938
MDG,Tsihombe,2023,34891,52337,61059,26168,0,174455,87227,0.499997133931386,0.21666523363236,0.105554759425385
MDG,Tsiombe,2017,23284,71077,55146,30637,0,180144,85783,0.476191269206857,0.215420256387483,0.109599974341514
MDG,Tuléar II,2018,84483,114656,72414,48276,0,319829,120690,0.377357900628148,0.176100353626469,0.0922430423757696
MDG,Vangaindrano,2017,91943,242730,183886,55166,0,573725,239052,0.416666521417055,0.170940200734963,0.0783476404200619
MDG,Vangaindrano,2018,218235,146745,75254,37627,0,477861,112881,0.236221411665735,0.10498729407366,0.0524936470368301
MDG,Vangaindrano,2019,177665,159898,71066,10660,0,419289,81726,0.19491567868463,0.0734465567504355,0.0301319614871843
MDG,Vangaindrano,2020,224866,159898,37478,0,0,422242,37478,0.0887595265274416,0.0295865088424805,0.00986216961416018
MDG,Vangaindrano,2021,149910,211692,56216,0,0,417818,56216,0.134546620777468,0.0448488735924892,0.0149496245308297
MDG,Vangaindrano,2022,211692,204584,81834,0,0,498110,81834,0.164289012467126,0.0547630041557086,0.0182543347185695
MDG,Vangaindrano,2023,122750,184126,102292,0,0,409168,102292,0.25,0.0833333333333333,0.0277777777777778
MDG,Vatomandry,2018,145348,32490,10260,0,0,188098,10260,0.0545460345139236,0.0181820115046412,0.00606067050154707
MDG,Vohipeno,2017,40795,101989,93490,23797,0,260071,117287,0.450980693733634,0.180827543247805,0.0806096113069978
MDG,Vohipeno,2018,104345,83476,20869,8695,0,217385,29564,0.135998343951975,0.0586655012995377,0.0284436470879878
MDG,Vohipeno,2019,86361,57574,28787,0,0,172722,28787,0.166666666666667,0.0555555555555556,0.0185185185185185
MDG,Vohipeno,2020,79164,68315,22772,0,0,170251,22772,0.13375545518088,0.04458515172696,0.01486171724232
MDG,Vohipeno,2021,54569,91087,23387,0,0,169043,23387,0.138349414054412,0.0461164713514707,0.0153721571171569
MDG,Vohipeno,2022,70160,85751,55890,0,0,211801,55890,0.263879773938744,0.0879599246462481,0.0293199748820827
MDG,Vohipeno,2023,39921,71858,47906,0,0,159685,47906,0.30000313116448,0.100001043721493,0.0333336812404978
MLI,Abeibara,2020,11670,2843,449,0,0,14962,449,0.0300093570378292,0.0100031190126097,0.00333437300420324
MLI,Abeibara,2021,11532,2992,1076,0,0,15600,1076,0.068974358974359,0.022991452991453,0.00766381766381766
MLI,Abeibara,2022,9379,4305,1691,0,0,15375,1691,0.109983739837398,0.0366612466124661,0.0122204155374887
MLI,Ansongo,2020,128469,47936,15340,0,0,191745,15340,0.0800020861039401,0.0266673620346467,0.00888912067821557
MLI,Ansongo,2021,84368,74883,43353,5752,0,208356,49105,0.235678358194628,0.0877616515323133,0.0353886830446181
MLI,Ansongo,2022,61089,82766,53206,0,0,197061,53206,0.269997614951715,0.0899992049839052,0.0299997349946351
MLI,Bafoulabe,2020,278406,50928,10186,0,0,339520,10186,0.030001178133836,0.0100003927112787,0.00333346423709289
MLI,Bafoulabe,2021,300081,50928,13581,0,0,364590,13581,0.0372500617131572,0.0124166872377191,0.00413889574590636
MLI,Bafoulabe,2022,282635,55829,10468,0,0,348932,10468,0.0300001146355164,0.0100000382118388,0.00333334607061293
MLI,Bamako,2020,2020129,378993,0,0,0,2399122,0,0,0,0
MLI,Bamako,2021,2359972,401115,24687,0,0,2785774,24687,0.00886181003914891,0.0029539366797163,0.000984645559905434
MLI,Bamako,2022,2300272,372496,30859,0,0,2703627,30859,0.0114139265512587,0.00380464218375291,0.00126821406125097
MLI,Banamba,2020,244248,27756,5551,0,0,277555,5551,0.0199996397110483,0.00666654657034942,0.00222218219011647
MLI,Banamba,2021,242462,41633,11102,0,0,295197,11102,0.037608783287093,0.0125362610956977,0.00417875369856589
MLI,Banamba,2022,231052,42787,11410,0,0,285249,11410,0.0400001402283619,0.0133333800761206,0.00444446002537354
MLI,Bandiagara,2020,378058,54659,22775,0,0,455492,22775,0.0500008781712961,0.016666959390432,0.00555565313014401
MLI,Bandiagara,2021,250521,187248,117030,0,0,554799,117030,0.210941259807606,0.070313753269202,0.0234379177564007
MLI,Bandiagara,2022,46812,234060,140436,46812,0,468120,187248,0.4,0.166666666666667,0.0777777777777778
MLI,Bankass,2020,311650,50018,23085,0,0,384753,23085,0.0599995321673905,0.0199998440557968,0.00666661468526561
MLI,Bankass,2021,177939,153901,67221,3848,0,402909,71069,0.176389705864103,0.0619800831784183,0.0227823707641731
MLI,Bankass,2022,90947,177939,126534,0,0,395420,126534,0.319998988417379,0.10666632947246,0.0355554431574866
MLI,Baroueli,2020,280051,14740,0,0,0,294791,0,0,0,0
MLI,Baroueli,2021,271207,48474,3030,0,0,322711,3030,0.00938920582192736,0.00312973527397579,0.00104324509132526
MLI,Baroueli,2022,218133,75741,9089,0,0,302963,9089,0.0300003630806402,0.0100001210268801,0.00333337367562669
MLI,Bla,2020,391609,20611,0,0,0,412220,0,0,0,0
MLI,Bla,2021,366876,59311,16489,0,0,442676,16489,0.0372484616288211,0.0124161538762737,0.0041387179587579
MLI,Bla,2022,343156,67784,12709,0,0,423649,12709,0.0299988905910317,0.00999963019701057,0.00333321006567019
MLI,Bougouni,2020,586367,79959,0,0,0,666326,0,0,0,0
MLI,Bougouni,2021,616319,86622,13327,0,0,716268,13327,0.0186061641731866,0.00620205472439552,0.00206735157479851
MLI,Bougouni,2022,595775,82176,6848,0,0,684799,6848,0.0100000146028251,0.00333333820094169,0.00111111273364723
MLI,Bourem,2020,109906,42272,13527,3382,0,169087,16909,0.100001774234566,0.0400011039681742,0.017778487471604
MLI,Bourem,2021,104264,62562,25363,5073,0,197262,30436,0.154292261053827,0.0600031092320535,0.0257159401089808
MLI,Bourem,2022,74723,52132,46919,0,0,173774,46919,0.270000115092016,0.0900000383640054,0.0300000127880018
MLI,Diema,2020,249263,49237,9232,0,0,307732,9232,0.0300001299832322,0.0100000433277441,0.00333334777591469
MLI,Diema,2021,262499,76933,15387,0,0,354819,15387,0.0433657724079038,0.0144552574693013,0.00481841915643375
MLI,Diema,2022,215059,79066,22138,0,0,316263,22138,0.0699987036106026,0.0233329012035342,0.0077776337345114
MLI,Dioila,2020,625229,85259,0,0,0,710488,0,0,0,0
MLI,Dioila,2021,671771,99468,14210,0,0,785449,14210,0.0180915629149697,0.00603052097165655,0.00201017365721885
MLI,Dioila,2022,627960,94924,7302,0,0,730186,7302,0.0100001917319697,0.00333339724398989,0.0011111324146633
MLI,Dire,2020,133855,22309,3187,0,0,159351,3187,0.0199998744909037,0.00666662483030124,0.00222220827676708
MLI,Dire,2021,135928,44618,7968,0,0,188514,7968,0.0422674178045132,0.0140891392681711,0.00469637975605702
MLI,Dire,2022,103174,49131,11464,0,0,163769,11464,0.0700010380474937,0.0233336793491646,0.00777789311638819
MLI,Djenne,2020,257423,36342,9086,0,0,302851,9086,0.03000155191827,0.01000051730609,0.00333350576869667
MLI,Djenne,2021,245309,84037,43575,0,0,372921,43575,0.116847804226632,0.0389492680755442,0.0129830893585147
MLI,Djenne,2022,108936,130724,71587,0,0,311247,71587,0.230000610447651,0.076666870149217,0.0255556233830723
MLI,Douentza,2020,172021,129016,50173,7168,0,358378,57341,0.160001450981924,0.0600008929119533,0.0244450149159702
MLI,Douentza,2021,111097,154103,110494,36831,0,412525,147325,0.357129870916914,0.148803910874088,0.0694417173369964
MLI,Douentza,2022,36831,147325,128910,55247,0,368313,184157,0.500001357541005,0.216667164431702,0.105555751644812
MLI,Gao,2020,281322,48031,13723,0,0,343076,13723,0.0399998834077581,0.0133332944692527,0.00444443148975089
MLI,Gao,2021,246554,102923,39306,0,0,388783,39306,0.101100099541389,0.0337000331804631,0.0112333443934877
MLI,Gao,2022,182236,89331,78612,7147,0,357326,85759,0.240002126909321,0.0866678234068237,0.0333340174269746
MLI,Goundam,2020,186915,26388,6597,0,0,219900,6597,0.03,0.01,0.00333333333333333
MLI,Goundam,2021,153930,54975,31640,0,0,240545,31640,0.131534640088133,0.0438448800293777,0.0146149600097926
MLI,Goundam,2022,119778,67799,38419,0,0,225996,38419,0.169998584045735,0.0566661946819118,0.0188887315606373
MLI,Gourma-rharous,2020,96807,40336,20975,3227,0,161345,24202,0.150001549474728,0.0566673897548731,0.0233337120938224
MLI,Gourma-rharous,2021,81251,58036,32269,4840,0,176396,37109,0.210373251094129,0.0792705050001134,0.0325208936458625
MLI,Gourma-rharous,2022,54720,61353,41455,8291,0,165819,49746,0.300001809201599,0.116667370245066,0.0500003015335999
MLI,Kadiolo,2020,318336,35371,0,0,0,353707,0,0,0,0
MLI,Kadiolo,2021,327162,42445,3537,0,0,373144,3537,0.00947891430654117,0.00315963810218039,0.0010532127007268
MLI,Kadiolo,2022,316257,43622,3635,0,0,363514,3635,0.00999961487040389,0.0033332049568013,0.00111106831893377
MLI,Kangaba,2020,128384,14589,2918,0,0,145891,2918,0.0200012337978354,0.00666707793261179,0.0022223593108706
MLI,Kangaba,2021,134942,20425,5836,0,0,161203,5836,0.0362028001960261,0.012067600065342,0.00402253335511402
MLI,Kangaba,2022,130444,17992,1499,0,0,149935,1499,0.00999766565511722,0.00333255521837241,0.00111085173945747
MLI,Kati,2020,1181741,194640,13903,0,0,1390284,13903,0.0100001150844,0.00333337169480001,0.00111112389826667
MLI,Kati,2021,1243081,222445,27806,0,0,1493332,27806,0.0186201059108089,0.00620670197026962,0.00206890065675654
MLI,Kati,2022,1200216,200036,28577,0,0,1428829,28577,0.0200002939470014,0.00666676464900045,0.00222225488300015
MLI,Kayes,2020,604020,134227,7457,0,0,745704,7457,0.00999994635941339,0.0033333154531378,0.00111110515104593
MLI,Kayes,2021,674413,186426,29828,0,0,890667,29828,0.0334895084245852,0.0111631694748617,0.00372105649162057
MLI,Kayes,2022,628430,114957,22991,0,0,766378,22991,0.029999556354697,0.00999985211823234,0.00333328403941078
MLI,Kenieba,2020,240525,42951,2863,0,0,286339,2863,0.00999863797806097,0.00333287932602032,0.00111095977534011
MLI,Kenieba,2021,247193,48678,5886,0,0,301757,5886,0.019505761258231,0.00650192041941032,0.00216730680647011
MLI,Kenieba,2022,238365,47084,8828,0,0,294277,8828,0.029998946570748,0.00999964885691599,0.00333321628563866
MLI,Kidal,2020,40849,7295,486,0,0,48630,486,0.00999383096853794,0.00333127698951265,0.00111042566317088
MLI,Kidal,2021,42982,7781,1999,0,0,52762,1999,0.0378871157272279,0.0126290385757426,0.00420967952524755
MLI,Kidal,2022,37984,8996,2999,0,0,49979,2999,0.0600052021849177,0.0200017340616392,0.00666724468721307
MLI,Kita,2020,527959,81708,18856,0,0,628523,18856,0.0300004932198185,0.0100001644066062,0.00333338813553539
MLI,Kita,2021,542596,94278,19378,0,0,656252,19378,0.029528290961399,0.00984276365379966,0.00328092121793322
MLI,Kita,2022,523218,103352,19378,0,0,645948,19378,0.0299993188306179,0.00999977294353931,0.00333325764784644
MLI,Kolokani,2020,297310,33785,6757,0,0,337852,6757,0.0199998816049631,0.00666662720165437,0.00222220906721812
MLI,Kolokani,2021,298608,43921,13514,0,0,356043,13514,0.0379560895734504,0.0126520298578168,0.00421734328593893
MLI,Kolokani,2022,281247,52083,13889,0,0,347219,13889,0.0400006912064144,0.0133335637354715,0.00444452124515716
MLI,Kolondieba,2020,263475,29275,0,0,0,292750,0,0,0,0
MLI,Kolondieba,2021,270780,35130,2928,0,0,308838,2928,0.0094806986186933,0.00316023287289777,0.00105341095763259
MLI,Kolondieba,2022,261754,36104,3009,0,0,300867,3009,0.0100010968301608,0.00333369894338695,0.00111123298112898
MLI,Koro,2020,426777,68495,31613,0,0,526885,31613,0.059999810205263,0.0199999367350877,0.00666664557836256
MLI,Koro,2021,237098,210754,146203,0,0,594055,146203,0.246110208650714,0.0820367362169047,0.0273455787389682
MLI,Koro,2022,119128,227427,173278,21660,0,541493,194938,0.36000096030789,0.133333825798918,0.0533336123971645
MLI,Koulikoro,2020,278501,21423,6121,0,0,306045,6121,0.0200003267493343,0.00666677558311142,0.00222225852770381
MLI,Koulikoro,2021,270495,40889,9181,0,0,320565,9181,0.0286400573986555,0.00954668579955183,0.00318222859985061
MLI,Koulikoro,2022,261060,47179,6291,0,0,314530,6291,0.0200012717387849,0.00666709057959495,0.00222236352653165
MLI,Koutiala,2020,750690,92782,0,0,0,843472,0,0,0,0
MLI,Koutiala,2021,762834,101217,17337,0,0,881388,17337,0.0196701112336451,0.00655670374454837,0.00218556791484946
MLI,Koutiala,2022,719491,112691,34674,0,0,866856,34674,0.0399997231374069,0.0133332410458023,0.0044444136819341
MLI,Macina,2020,295023,37736,10292,0,0,343051,10292,0.0300013700586793,0.0100004566862264,0.00333348556207548
MLI,Macina,2021,296151,56410,24014,0,0,376575,24014,0.0637695014273385,0.0212565004757795,0.00708550015859317
MLI,Macina,2022,260895,81089,10577,0,0,352561,10577,0.0300004821860614,0.0100001607286871,0.00333338690956238
MLI,Menaka,2020,64097,11078,3957,0,0,79132,3957,0.050005054845069,0.016668351615023,0.00555611720500767
MLI,Menaka,2021,45897,28464,24398,4880,0,103639,29278,0.282499831144646,0.109862117542624,0.0470843772882581
MLI,Menaka,2022,9759,36596,28464,6506,0,81325,34970,0.43000307408546,0.170001024695153,0.0744447860094955
MLI,Mopti,2020,498541,26803,10721,0,0,536065,10721,0.0199994403663735,0.00666648012212449,0.00222216004070816
MLI,Mopti,2021,473798,60602,21443,0,0,555843,21443,0.0385774400325272,0.0128591466775091,0.00428638222583635
MLI,Mopti,2022,451761,71621,27546,0,0,550928,27546,0.0499992739523132,0.0166664246507711,0.00555547488359035
MLI,Nara,2020,288244,42182,21091,0,0,351517,21091,0.0599999431037475,0.0199999810345825,0.00666666034486083
MLI,Nara,2021,303461,52728,28121,0,0,384310,28121,0.0731726991231037,0.0243908997077012,0.00813029990256708
MLI,Nara,2022,234821,101154,25288,0,0,361263,25288,0.0699988650927441,0.0233329550309147,0.00777765167697156
MLI,Niafunke,2020,214150,30593,10198,0,0,254941,10198,0.0400014120914251,0.013333804030475,0.00444460134349167
MLI,Niafunke,2021,178163,65501,18340,0,0,262004,18340,0.0699989313140257,0.0233329771046753,0.00777765903489175
MLI,Niafunke,2022,162443,73361,26201,0,0,262005,26201,0.100001908360527,0.0333339694535092,0.0111113231511697
MLI,Niono,2020,455975,53020,21208,0,0,530203,21208,0.0399997736715937,0.0133332578905312,0.00444441929684375
MLI,Niono,2021,434767,190716,119879,5449,0,750811,125328,0.166923500055274,0.0580603285425138,0.0209662174191197
MLI,Niono,2022,217962,179818,136226,10898,0,544904,147124,0.269999853185148,0.0966665687900988,0.0366666014156214
MLI,Nioro,2020,269454,53225,9980,0,0,332659,9980,0.0300006913986996,0.0100002304662332,0.00333341015541106
MLI,Nioro,2021,256411,79838,23932,0,0,360181,23932,0.0664443710245682,0.0221481236748561,0.00738270789161869
MLI,Nioro,2022,143590,119659,78633,0,0,341882,78633,0.230000409498014,0.0766668031660046,0.0255556010553349
MLI,San,2020,441152,38783,4848,0,0,484783,4848,0.0100003506723627,0.0033334502241209,0.00111115007470696
MLI,San,2021,448401,48478,9964,0,0,506843,9964,0.0196589476425639,0.00655298254752129,0.00218432751584043
MLI,San,2022,433454,49822,14947,0,0,498223,14947,0.0300006222113391,0.0100002074037797,0.00333340246792657
MLI,Segou,2020,920505,80924,10115,0,0,1011544,10115,0.00999956502139304,0.00333318834046435,0.00111106278015478
MLI,Segou,2021,890159,176730,20792,0,0,1087681,20792,0.0191158988710844,0.00637196629036148,0.00212398876345383
MLI,Segou,2022,779691,218313,41584,0,0,1039588,41584,0.0400004617213742,0.0133334872404581,0.00444449574681936
MLI,Sikasso,2020,961223,106803,0,0,0,1068026,0,0,0,0
MLI,Sikasso,2021,976896,128163,21361,0,0,1126420,21361,0.0189636192539195,0.00632120641797317,0.00210706880599106
MLI,Sikasso,2022,932991,131716,32929,0,0,1097636,32929,0.0299999271160931,0.00999997570536438,0.00333332523512146
MLI,Tenenkou,2020,163357,59187,14205,0,0,236749,14205,0.0600002534329606,0.0200000844776535,0.00666669482588452
MLI,Tenenkou,2021,187351,66290,23675,0,0,277316,23675,0.0853719222836043,0.0284573074278681,0.0094857691426227
MLI,Tenenkou,2022,163020,58395,21898,0,0,243313,21898,0.0899993013114795,0.0299997671038265,0.00999992236794216
MLI,Tessalit,2020,19475,3478,232,0,0,23185,232,0.0100064697002372,0.00333548990007907,0.00111182996669302
MLI,Tessalit,2021,19300,3710,1191,0,0,24201,1191,0.0492128424445271,0.0164042808148424,0.00546809360494745
MLI,Tessalit,2022,16679,5242,1906,0,0,23827,1906,0.0799932849288622,0.0266644283096207,0.00888814276987358
MLI,Tin-essako,2020,9792,1749,117,0,0,11658,117,0.010036026762738,0.00334534225424601,0.00111511408474867
MLI,Tin-essako,2021,9559,2396,958,0,0,12913,958,0.0741888019824983,0.0247296006608328,0.00824320022027758
MLI,Tin-essako,2022,7188,3115,1677,0,0,11980,1677,0.139983305509182,0.046661101836394,0.0155537006121313
MLI,Tombouctou,2020,155420,24053,5551,0,0,185024,5551,0.0300015133171913,0.0100005044390638,0.00333350147968792
MLI,Tombouctou,2021,116565,55507,12952,0,0,185024,12952,0.0700017295053615,0.0233339098351205,0.00777796994504016
MLI,Tombouctou,2022,63590,51910,14275,0,0,129775,14275,0.109998073588904,0.0366660245296346,0.0122220081765449
MLI,Tominian,2020,295623,25706,0,0,0,321329,0,0,0,0
MLI,Tominian,2021,282770,46233,6427,0,0,335430,6427,0.0191604805771696,0.00638682685905654,0.00212894228635218
MLI,Tominian,2022,241073,75955,13209,0,0,330237,13209,0.0399985464984239,0.013332848832808,0.00444428294426932
MLI,Yanfolila,2020,275103,34002,0,0,0,309105,0,0,0,0
MLI,Yanfolila,2021,285907,37093,3091,0,0,326091,3091,0.00947894912769748,0.00315964970923249,0.00105321656974416
MLI,Yanfolila,2022,276377,38121,3177,0,0,317675,3177,0.010000786967813,0.00333359565593767,0.00111119855197922
MLI,Yelimane,2020,207767,46170,2565,0,0,256502,2565,0.00999992202789842,0.00333330734263281,0.00111110244754427
MLI,Yelimane,2021,226707,61560,7695,0,0,295962,7695,0.0259999594542543,0.00866665315141809,0.00288888438380603
MLI,Yelimane,2022,218799,36906,7908,0,0,263613,7908,0.0299985205585461,0.00999950685284868,0.00333316895094956
MLI,Yorosso,2020,279817,27674,0,0,0,307491,0,0,0,0
MLI,Yorosso,2021,268613,41082,6320,0,0,316015,6320,0.0199990506779741,0.00666635022599138,0.00222211674199713
MLI,Yorosso,2022,249652,50562,15801,0,0,316015,15801,0.0500007911016882,0.0166669303672294,0.00555564345574314
MLI,Youwarou,2020,138774,15770,3154,0,0,157698,3154,0.0200002536493805,0.00666675121646015,0.00222225040548672
MLI,Youwarou,2021,134518,31540,9462,0,0,175520,9462,0.05390838650866,0.0179694621695533,0.00598982072318444
MLI,Youwarou,2022,111828,38897,11345,0,0,162070,11345,0.0700006170173382,0.0233335390057794,0.0077778463352598
MOZ,Acolhedores em Ancuabe,2020,22664,12591,10073,5037,0,50365,15110,0.300009927529038,0.133339951686025,0.0666710789017947
MOZ,Acolhedores em Ancuabe,2021,25183,15110,12591,5037,0,57921,17628,0.304345574144093,0.130436283903938,0.0628039340941397
MOZ,Acolhedores em Balama,2020,3525,4113,2938,1175,0,11751,4113,0.350012764871075,0.150001418319008,0.0722208039032139
MOZ,Acolhedores em Balama,2021,4746,5424,4068,0,0,14238,4068,0.285714285714286,0.0952380952380952,0.0317460317460317
MOZ,Acolhedores em Chiure,2020,10774,5387,6734,4040,0,26935,10774,0.4,0.18333023946538,0.0944413505764907
MOZ,Acolhedores em Chiure,2021,10774,6734,9427,4040,0,30975,13467,0.434769975786925,0.188399246704331,0.0917836965294592
MOZ,Acolhedores em Metuge,2020,23114,29718,9906,3302,0,66040,13208,0.2,0.0833333333333333,0.0388888888888889
MOZ,Acolhedores em Metuge,2021,26416,29718,16510,6604,0,79248,23114,0.291666666666667,0.125,0.0601851851851852
MOZ,Acolhedores em Montepuez,2020,17253,19717,9859,2465,0,49294,12324,0.250010143222299,0.100005409718559,0.0444476001136041
MOZ,Acolhedores em Montepuez,2021,19717,19717,9859,4929,0,54222,14788,0.272730625945188,0.121211562342469,0.0606047565768712
MOZ,Acolhedores em Namuno,2020,264,198,165,33,0,660,198,0.3,0.116666666666667,0.05
MOZ,Acolhedores em Namuno,2021,26636,20717,14798,0,0,62151,14798,0.238097536644624,0.0793658455482079,0.0264552818494026
MOZ,Acolhedores em Pemba,2020,35862,57378,35862,14345,0,143447,50207,0.350003834168717,0.150001975177824,0.0722233453625536
MOZ,Acolhedores em Pemba,2021,51926,77888,60580,17309,0,207703,77889,0.375001805462608,0.152779048288502,0.0694453137412555
MOZ,Alto molocue,2017,279134,0,0,0,0,279134,0,0,0,0
MOZ,Alto molócuè,2021,202126,181913,20213,0,0,404252,20213,0.0500009894818084,0.0166669964939361,0.00555566549797871
MOZ,Alto molócuè,2022,202126,202126,0,0,0,404252,0,0,0,0
MOZ,Ancuabe,2017,120585,18341,55022,6114,0,200062,61136,0.305585268566744,0.11204859826787,0.0441407608085938
MOZ,Ancuabe,2018,141138,13129,8206,1641,0,164114,9847,0.0600009749320594,0.0233333739555025,0.00999982397060038
MOZ,Ancuabe,2021,73523,85777,85777,0,0,245077,85777,0.350000204017513,0.116666734672504,0.0388889115575014
MOZ,Ancuabe,2022,73523,85777,85777,0,0,245077,85777,0.350000204017513,0.116666734672504,0.0388889115575014
MOZ,Angoche,2017,226642,0,0,0,0,226642,0,0,0,0
MOZ,Angonia,2017,383901,0,0,0,0,383901,0,0,0,0
MOZ,Balama,2017,145663,0,0,0,0,145663,0,0,0,0
MOZ,Balama,2018,112193,47049,19905,1810,0,180957,21715,0.120000884187956,0.0433344201476962,0.0166675569948171
MOZ,Balama,2019,126670,63335,27144,0,0,217149,27144,0.12500172692483,0.0416672423082768,0.0138890807694256
MOZ,Balama,2021,110795,88636,22159,0,0,221590,22159,0.1,0.0333333333333333,0.0111111111111111
MOZ,Balama,2022,110795,88636,22159,0,0,221590,22159,0.1,0.0333333333333333,0.0111111111111111
MOZ,Barue,2017,225299,0,0,0,0,225299,0,0,0,0
MOZ,Bilene,2017,120284,6331,0,0,0,126615,0,0,0,0
MOZ,Boane,2017,134280,0,0,0,0,134280,0,0,0,0
MOZ,Boane,2021,118620,131801,13180,0,0,263601,13180,0.0499998103193842,0.0166666034397947,0.00555553447993158
MOZ,Boane,2022,118620,131801,13180,0,0,263601,13180,0.0499998103193842,0.0166666034397947,0.00555553447993158
MOZ,Buzi,2017,179851,52059,46674,0,0,278584,46674,0.16754013152227,0.0558467105074233,0.0186155701691411
MOZ,Buzi,2018,148972,28376,0,0,0,177348,0,0,0,0
MOZ,Buzi,2019,26602,35470,97541,26602,0,186215,124143,0.66666487662111,0.269840417438624,0.121692667078377
MOZ,Búzi,2020,35483,115320,26612,0,0,177415,26612,0.149998590874503,0.0499995302915011,0.016666510097167
MOZ,Búzi,2021,113808,115320,26612,0,0,255740,26612,0.104058809728631,0.0346862699095435,0.0115620899698478
MOZ,Búzi,2022,134500,62077,10346,0,0,206923,10346,0.0499992750926673,0.0166664250308891,0.00555547501029637
MOZ,Cabo Delgado (Conflito afetado),2020,51275,136734,119643,34184,0,341836,153827,0.450002340303537,0.183334503485102,0.0833339834176493
MOZ,Cabo Delgado (Conflito afetado),2021,34184,153826,136734,34184,0,358928,170918,0.476190210850087,0.19047645581658,0.0846564089610049
MOZ,Cabo Delgado (Nao Afectado),2020,517851,863085,258926,86309,0,1726171,345235,0.200000463453505,0.0833335747153671,0.0388890272812549
MOZ,Cabo Delgado (Nao Afectado),2021,517851,776777,345234,172617,0,1812479,517851,0.285714206895639,0.126984091953617,0.0634920459768086
MOZ,Cabo delgado,2018,1469965,793315,69998,0,0,2333278,69998,0.0299998542822587,0.00999995142741957,0.00333331714247319
MOZ,Cabo delgado,2019,1026642,1259970,46666,0,0,2333278,46666,0.0200001885759005,0.00666672952530017,0.00222224317510006
MOZ,Cahora Bassa,2019,58995,62100,31050,3105,0,155250,34155,0.22,0.08,0.0311111111111111
MOZ,Cahora Bassa,2020,69863,62100,38813,7763,0,178539,46576,0.260872974532175,0.101451223542195,0.0434794514239341
MOZ,Cahora bassa,2017,75140,5656,16159,0,0,96955,16159,0.166664947656129,0.055554982552043,0.0185183275173477
MOZ,Cahora-bassa,2017,29104,43262,15732,1573,0,89671,17305,0.19298323872824,0.0701750473025467,0.0272898831407156
MOZ,Cahora-bassa,2018,79783,26594,19946,6649,0,132972,26595,0.200004512228138,0.0833358401267435,0.038890392964935
MOZ,Caia,2017,89873,27461,11234,0,0,128568,11234,0.0873778856325058,0.0291259618775019,0.00970865395916731
MOZ,Caia,2018,76780,86378,9598,19195,0,191951,28793,0.150001823382009,0.0833337674719069,0.0500000289425716
MOZ,Caia,2019,76780,76780,47988,9598,0,211146,57586,0.272730717134116,0.106062471780979,0.0454556457511759
MOZ,Changara,2017,196342,21112,21112,0,0,238566,21112,0.0884954268420479,0.029498475614016,0.00983282520467199
MOZ,Changara,2018,64227,38536,25691,0,0,128454,25691,0.200001556977595,0.0666671856591984,0.0222223952197328
MOZ,Changara,2019,38536,51381,32113,12845,0,134875,44958,0.333330861909175,0.142855730614767,0.0687822057460612
MOZ,Changara,2021,55564,55564,27782,0,0,138910,27782,0.2,0.0666666666666667,0.0222222222222222
MOZ,Changara,2022,55564,62510,20837,0,0,138911,20837,0.15000251959888,0.0500008398662933,0.0166669466220978
MOZ,Chemba,2017,51673,18045,16404,0,0,86122,16404,0.190473978774297,0.063491326258099,0.0211637754193663
MOZ,Chemba,2018,39566,30774,15827,1759,0,87926,17586,0.200009098560153,0.0733381858987482,0.0288917195520476
MOZ,Cheringoma,2017,24039,6780,1541,0,0,32360,1541,0.0476205191594561,0.0158735063864854,0.00529116879549513
MOZ,Cheringoma,2018,28100,26344,2927,1171,0,58542,4098,0.0700010249051963,0.0300012526619066,0.0144454693496407
MOZ,Chibabava,2017,108966,30734,2794,0,0,142494,2794,0.0196078431372549,0.0065359477124183,0.00217864923747277
MOZ,Chibabava,2021,70617,70617,15693,0,0,156927,15693,0.100001911716913,0.0333339705723043,0.0111113235241014
MOZ,Chibabava,2022,70617,78463,7846,0,0,156926,7846,0.0499980882709048,0.0166660294236349,0.00555534314121164
MOZ,Chibuto,2017,211635,11139,15594,0,0,238368,15594,0.0654198550140958,0.021806618338032,0.00726887277934398
MOZ,Chibuto,2018,83972,77343,59665,0,0,220980,59665,0.270001810118563,0.0900006033728542,0.0300002011242848
MOZ,Chibuto,2019,55245,77343,99441,11049,0,243078,110490,0.454545454545455,0.166666666666667,0.0656565656565657
MOZ,Chibuto,2020,54289,97720,65147,0,0,217156,65147,0.300000920996887,0.100000306998962,0.0333334356663208
MOZ,Chibuto,2021,91360,119435,65147,11420,0,287362,76567,0.266447894989595,0.102062903237032,0.0428522599060109
MOZ,Chibuto,2022,79940,114201,34260,0,0,228401,34260,0.149999343260318,0.0499997810867728,0.0166665936955909
MOZ,Chicualacuala,2017,19086,5090,5090,0,0,29266,5090,0.173921957219982,0.0579739857399941,0.0193246619133314
MOZ,Chicualacuala,2018,12630,6864,5491,2471,0,27456,7962,0.289991258741259,0.126663267288267,0.0622207653457654
MOZ,Chicualacuala,2019,8237,6864,12355,1373,0,28829,13728,0.476187172638663,0.174604275787113,0.068784904089632
MOZ,Chifunde,2017,170394,18322,18322,0,0,207038,18322,0.0884958316830727,0.0294986105610242,0.00983287018700807
MOZ,Chifunde,2018,77605,38803,23282,15521,0,155211,38803,0.250001610710581,0.116666988808783,0.0611110753175426
MOZ,Chigubo,2017,17813,4750,5938,0,0,28501,5938,0.20834356689239,0.0694478556307966,0.0231492852102655
MOZ,Chigubo,2018,7904,7904,7439,0,0,23247,7439,0.319998279347873,0.106666093115958,0.0355553643719859
MOZ,Chigubo,2019,5812,5812,11624,1162,0,24410,12786,0.523801720606309,0.190468387272976,0.074068004916018
MOZ,Chinde,2017,111413,0,0,0,0,111413,0,0,0,0
MOZ,Chinde (Luabo sub-district),2017,25919,39154,15993,1654,0,82720,17647,0.21333413926499,0.0777764345583495,0.0303688480550183
MOZ,Chiure,2017,198896,41731,57629,5962,0,304218,63591,0.209031023805298,0.0762096040777776,0.0297582654543781
MOZ,Chiure,2018,177110,82229,50603,6325,0,316267,56928,0.179999810286878,0.0666662450819508,0.0266662872404224
MOZ,Chiuta,2017,96012,10324,10324,0,0,116660,10324,0.0884964855134579,0.029498828504486,0.00983294283482866
MOZ,Chiuta,2019,31163,41550,28046,3116,0,103875,31162,0.299995186522262,0.109997593261131,0.043331996256184
MOZ,Chiuta,2020,50103,44536,27835,5567,0,128041,33402,0.260869565217391,0.101449275362319,0.0434782608695652
MOZ,Chiúre,2021,157887,177623,59208,0,0,394718,59208,0.150000760036279,0.0500002533454264,0.0166667511151421
MOZ,Chiúre,2022,157887,177623,59208,0,0,394718,59208,0.150000760036279,0.0500002533454264,0.0166667511151421
MOZ,Chokwe,2017,201467,10604,0,0,0,212071,0,0,0,0
MOZ,Chongoene,2017,143147,7534,0,0,0,150681,0,0,0,0
MOZ,Chuita,2018,51938,31163,15581,5194,0,103876,20775,0.19999807462744,0.0833333333333333,0.0388893167494577
MOZ,Chókwè,2020,65106,119360,32553,0,0,217019,32553,0.150000691183721,0.0500002303945738,0.0166667434648579
MOZ,Chókwè,2021,93482,119360,32553,0,0,245395,32553,0.132655514578537,0.0442185048595122,0.0147395016198374
MOZ,Cidade da Beira,2019,320295,320295,53383,0,0,693973,53383,0.0769237419899621,0.0256412473299874,0.00854708244332913
MOZ,Cidade da Beira,2021,503864,179952,35990,0,0,719806,35990,0.0499995832210346,0.0166665277403449,0.00555550924678162
MOZ,Cidade da Beira,2022,359903,345507,14396,0,0,719806,14396,0.0199998332884138,0.00666661109613794,0.00222220369871265
MOZ,Cidade da Matola,2021,581981,698377,12933,0,0,1293291,12933,0.0100000695899067,0.00333335652996889,0.00111111884332296
MOZ,Cidade da Matola,2022,581981,711310,0,0,0,1293291,0,0,0,0
MOZ,Cidade de Beira,2020,236836,266441,88814,0,0,592091,88814,0.150000591125351,0.0500001970417836,0.0166667323472612
MOZ,Cidade de Beira,2021,266441,296045,88814,0,0,651300,88814,0.136364194687548,0.045454731562516,0.0151515771875053
MOZ,Cidade de Chimoio,2020,145334,199835,18167,0,0,363336,18167,0.0500005504546756,0.0166668501515585,0.00555561671718617
MOZ,Cidade de Chimoio,2021,190783,238479,47696,0,0,476958,47696,0.100000419324133,0.0333334731080445,0.0111111577026815
MOZ,Cidade de Chimoio,2022,405413,47696,23848,0,0,476957,23848,0.0500003144937594,0.0166667714979198,0.0055555904993066
MOZ,Cidade de Inhambane,2020,24636,36954,16424,4106,0,82120,20530,0.25,0.1,0.0444444444444444
MOZ,Cidade de Inhambane,2021,28742,49271,16424,4106,0,98543,20530,0.208335447469633,0.083334178987853,0.0370374128834902
MOZ,Cidade de Inhambane,2022,69801,8212,4106,0,0,82119,4106,0.0500006088724899,0.0166668696241633,0.00555562320805444
MOZ,Cidade de Lichinga,2020,108992,108992,24220,0,0,242204,24220,0.0999983484996119,0.033332782833204,0.011110927611068
MOZ,Cidade de Lichinga,2021,133353,121102,24220,0,0,278675,24220,0.0869112765766574,0.0289704255255525,0.00965680850851749
MOZ,Cidade de Lichinga,2022,226700,26671,13335,0,0,266706,13335,0.049998875165913,0.016666291721971,0.00555543057399034
MOZ,Cidade de Matola,2020,412879,454167,165152,0,0,1032198,165152,0.160000310018039,0.0533334366726797,0.0177778122242266
MOZ,Cidade de Matola,2021,412879,536742,165152,0,0,1114773,165152,0.148148546834199,0.0493828489447328,0.0164609496482443
MOZ,Cidade de Maxixe,2020,38998,64997,12999,12999,0,129993,25998,0.199995384366851,0.0999976921834253,0.0555542734352363
MOZ,Cidade de Maxixe,2021,51997,64997,12999,12999,0,142992,25998,0.181814367237328,0.090907183618664,0.0505039908992578
MOZ,Cidade de Nampula,2020,342096,342096,76021,0,0,760213,76021,0.0999996053737571,0.0333332017912524,0.0111110672637508
MOZ,Cidade de Nampula,2021,430918,478798,76021,0,0,985737,76021,0.0771209764876433,0.0257069921625478,0.00856899738751592
MOZ,Cidade de Nampula,2022,383038,526678,47880,0,0,957596,47880,0.0500002088563444,0.0166667362854481,0.00555557876181605
MOZ,Cidade de Pemba,2020,60159,60159,60159,20053,0,200530,80212,0.4,0.166666666666667,0.0777777777777778
MOZ,Cidade de Pemba,2021,59851,80212,164591,20053,0,324707,184644,0.568648042696955,0.210135085887687,0.0837688541772531
MOZ,Cidade de Pemba,2022,59851,74814,164591,0,0,299256,164591,0.550000668324111,0.183333556108037,0.0611111853693456
MOZ,Cidade de Quelimane,2020,192413,122445,34984,0,0,349842,34984,0.0999994283133529,0.0333331427711176,0.0111110475903725
MOZ,Cidade de Quelimane,2021,192413,205315,34984,0,0,432712,34984,0.0808482316182588,0.0269494105394196,0.0089831368464732
MOZ,Cidade de Quelimane,2022,205315,205315,0,0,0,410630,0,0,0,0
MOZ,Cidade de Tete,2020,122935,153669,30734,0,0,307338,30734,0.100000650749338,0.0333335502497793,0.0111111834165931
MOZ,Cidade de Tete,2021,237664,190131,47533,0,0,475328,47533,0.100000420762084,0.0333334735873614,0.0111111578624538
MOZ,Cidade de Tete,2022,237664,213898,23766,0,0,475328,23766,0.0499991584758314,0.0166663861586105,0.00555546205287016
MOZ,Cidade de Xai-Xai,2020,42589,78080,21294,0,0,141963,21294,0.149996830159971,0.0499989433866571,0.016666314462219
MOZ,Cidade de Xai-Xai,2021,56785,78594,23578,0,0,158957,23578,0.148329422422416,0.049443140807472,0.016481046935824
MOZ,Cidade de Xai-Xai,2022,133610,15719,7859,0,0,157188,7859,0.0499974552764842,0.0166658184254947,0.00555527280849825
MOZ,Cidade de lichinga,2017,124488,14684,0,0,0,139172,0,0,0,0
MOZ,Cidade de xai-xai,2017,125573,6609,6609,0,0,138791,6609,0.0476183614211296,0.0158727871403765,0.00529092904679218
MOZ,Cidades de Maputo e Matola,2020,1336095,728779,364389,0,0,2429263,364389,0.149999814758633,0.0499999382528775,0.0166666460842925
MOZ,Cuamba,2017,139493,11747,0,0,0,151240,0,0,0,0
MOZ,Derre,2021,63950,51160,12790,0,0,127900,12790,0.1,0.0333333333333333,0.0111111111111111
MOZ,Derre,2022,63950,57555,6395,0,0,127900,6395,0.05,0.0166666666666667,0.00555555555555556
MOZ,Deslocados de Chiure,2020,2359,1348,2359,674,0,6740,3033,0.45,0.183333333333333,0.0833333333333333
MOZ,Deslocados de Chiure,2021,11797,10112,16853,5056,0,43818,21909,0.5,0.205128790299268,0.0940176791881571
MOZ,Deslocados de Namuno,2020,1345,896,598,149,0,2988,747,0.25,0.0999553770638108,0.0443998215082552
MOZ,Deslocados de Namuno,2021,1642,1277,1277,547,0,4743,1824,0.384566729917774,0.166631527162836,0.0811722538477757
MOZ,Deslocados em Ancuabe,2020,2450,1960,3920,490,0,8820,4410,0.5,0.185185185185185,0.0740740740740741
MOZ,Deslocados em Ancuabe,2021,18050,24067,21058,9025,0,72200,30083,0.416662049861496,0.180554016620499,0.0879624499846107
MOZ,Deslocados em Balama,2020,1231,2051,3692,1231,0,8205,4923,0.6,0.250010156408694,0.116676823075361
MOZ,Deslocados em Balama,2021,6998,9998,8998,2999,0,28993,11997,0.413789535405098,0.172409432161786,0.0804562020717644
MOZ,Deslocados em Metuge,2020,31075,54381,46613,23306,0,155375,69919,0.450001609010459,0.2,0.0999996424421203
MOZ,Deslocados em Metuge,2021,66425,77495,88566,44283,0,276769,132849,0.479999566425431,0.213333140633525,0.106666570316762
MOZ,Doa,2018,35165,26374,21978,4396,0,87913,26374,0.300001137488199,0.116668372898965,0.0500014534571426
MOZ,Doa,2019,21978,35165,35165,8791,0,101099,43956,0.434781748583072,0.173912040013584,0.0772938736617903
MOZ,Dondo,2017,79620,22748,2492,0,0,104860,2492,0.0237650200267023,0.00792167334223409,0.0026405577807447
MOZ,Dondo,2019,46115,55337,92229,0,0,193681,92229,0.476190230327188,0.158730076775729,0.0529100255919097
MOZ,Dondo,2020,67684,96691,29007,0,0,193382,29007,0.14999844866637,0.0499994828887901,0.0166664942962634
MOZ,Dondo,2021,87022,96691,38676,0,0,222389,38676,0.173911479434684,0.0579704931448948,0.0193234977149649
MOZ,Dôa,2021,44226,39312,14742,0,0,98280,14742,0.15,0.05,0.0166666666666667
MOZ,Dôa,2022,44226,44226,9828,0,0,98280,9828,0.1,0.0333333333333333,0.0111111111111111
MOZ,Erati,2017,271538,0,0,0,0,271538,0,0,0,0
MOZ,Funhalouro,2017,48839,4082,40816,0,0,93737,40816,0.435431046438439,0.145143682146147,0.0483812273820488
MOZ,Funhalouro,2018,24385,8867,6650,4434,0,44336,11084,0.25,0.116669674004571,0.0611141184490156
MOZ,Funhalouro,2019,15518,11084,15518,4434,0,46554,19952,0.428577565837522,0.174607266113904,0.0793678070388987
MOZ,Funhalouro,2021,15835,22621,4524,2262,0,45242,6786,0.149993368993413,0.0666637195526281,0.033331859776314
MOZ,Funhalouro,2022,15835,24883,4524,0,0,45242,4524,0.0999955793289421,0.033331859776314,0.011110619925438
MOZ,Gaza,2018,810126,318264,216998,101266,0,1446654,318264,0.220000082950035,0.0966667450083664,0.0477778376861364
MOZ,Gaza,2019,723327,433996,231465,57866,0,1446654,289331,0.200000138250058,0.0800000092166706,0.0355555340499909
MOZ,Gaza Prov.,2020,21918,58448,43836,21918,0,146120,65754,0.45,0.2,0.1
MOZ,Gaza Prov.,2021,43836,80366,43836,21918,0,189956,65754,0.346153846153846,0.153846153846154,0.0769230769230769
MOZ,Gile,2017,204078,0,0,0,0,204078,0,0,0,0
MOZ,Gondola,2017,316311,0,0,0,0,316311,0,0,0,0
MOZ,Gondola,2019,90781,90781,30260,0,0,211822,30260,0.14285579401573,0.0476185980052434,0.0158728660017478
MOZ,Gorongosa,2017,142035,108537,54956,5496,0,311024,60452,0.194364422038171,0.070678361369755,0.0274862675834948
MOZ,Govuro,2017,40402,0,0,0,0,40402,0,0,0,0
MOZ,Govuro,2018,23221,12222,4074,1222,0,40739,5296,0.129998281744765,0.0533313696130653,0.024442862558673
MOZ,Govuro,2019,16296,8148,14259,4074,0,42777,18333,0.428571428571429,0.174603174603175,0.0793650793650794
MOZ,Govuro,2021,14790,16639,5546,0,0,36975,5546,0.14999323867478,0.0499977462249268,0.0166659154083089
MOZ,Govuro,2022,14790,18488,3698,0,0,36976,3698,0.10001081782778,0.0333369392759267,0.0111123130919756
MOZ,Guija,2017,94126,71136,18009,900,0,184171,18909,0.102670887381835,0.0358525500757448,0.0130367973242259
MOZ,Guija,2018,23482,23482,46964,0,0,93928,46964,0.5,0.166666666666667,0.0555555555555556
MOZ,Guija,2019,23482,23482,51660,4696,0,103320,56356,0.545451025938831,0.196967350625887,0.0757560115283693
MOZ,Guijá,2020,23056,27668,36890,4611,0,92225,41501,0.449997289238276,0.166664859492184,0.0666654618836782
MOZ,Guijá,2021,37054,41585,36890,4611,0,120140,41501,0.345438654902614,0.127939625991898,0.0511754804579842
MOZ,Guijá,2022,37054,41685,13895,0,0,92634,13895,0.14999892048276,0.04999964016092,0.0166665467203067
MOZ,Guro,2017,98409,2143,4285,0,0,104837,4285,0.0408729742361952,0.0136243247453984,0.00454144158179947
MOZ,Gurue,2017,214260,0,0,0,0,214260,0,0,0,0
MOZ,Homoine,2017,120281,2455,0,0,0,122736,0,0,0,0
MOZ,Homoine,2018,82888,17268,11512,3454,0,115122,14966,0.13000121610118,0.0533347231632529,0.0244455640296574
MOZ,Ibo,2017,4683,96,0,0,0,4779,0,0,0,0
MOZ,Ibo,2019,4000,8000,8000,1954,0,21954,9954,0.453402569007926,0.180802283562601,0.0800461571163949
MOZ,Ibo,2020,6000,8000,6000,3000,0,23000,9000,0.391304347826087,0.173913043478261,0.0869565217391304
MOZ,Ibo,2021,4613,4613,36904,0,0,46130,36904,0.8,0.266666666666667,0.0888888888888889
MOZ,Ibo,2022,4613,4613,36904,0,0,46130,36904,0.8,0.266666666666667,0.0888888888888889
MOZ,Ile,2017,315357,23737,10545,0,0,349639,10545,0.0301596789831798,0.0100532263277266,0.00335107544257553
MOZ,Inhambane,2018,1002872,449047,44905,0,0,1496824,44905,0.0300001870627408,0.0100000623542469,0.00333335411808232
MOZ,Inhambane,2019,823253,598730,74841,0,0,1496824,74841,0.0499998663837565,0.0166666221279188,0.00555554070930628
MOZ,Inhambane Prov.,2020,288682,371162,123721,41240,0,824805,164961,0.2,0.0833332322993516,0.0388887878549071
MOZ,Inhambane Prov.,2021,329922,453643,164961,0,0,948526,164961,0.17391299764055,0.0579709992135166,0.0193236664045055
MOZ,Inharrime,2017,117165,0,0,0,0,117165,0,0,0,0
MOZ,Inhassoro,2017,40291,0,0,0,0,40291,0,0,0,0
MOZ,Inhassunge,2017,96057,7936,0,0,0,103993,0,0,0,0
MOZ,Inhassunge,2021,41959,47204,15735,0,0,104898,15735,0.150002859921066,0.0500009533070221,0.016666984435674
MOZ,Inhassunge,2022,47204,47204,10490,0,0,104898,10490,0.100001906614044,0.033333968871348,0.011111322957116
MOZ,Jangamo,2017,113366,0,0,0,0,113366,0,0,0,0
MOZ,Kamavota,2021,152233,169148,16915,0,0,338296,16915,0.0500005911982406,0.0166668637327469,0.00555562124424896
MOZ,Kamavota,2022,162382,169148,6766,0,0,338296,6766,0.0200002364792962,0.00666674549309875,0.00222224849769958
MOZ,Kamaxaquene,2021,80985,101232,20246,0,0,202463,20246,0.0999985182477786,0.0333328394159262,0.0111109464719754
MOZ,Kamaxaquene,2022,80985,101232,20246,0,0,202463,20246,0.0999985182477786,0.0333328394159262,0.0111109464719754
MOZ,Kamubukuana,2021,149060,165623,16562,0,0,331245,16562,0.0499992452716267,0.0166664150905422,0.00555547169684742
MOZ,Kamubukuana,2022,149060,165623,16562,0,0,331245,16562,0.0499992452716267,0.0166664150905422,0.00555547169684742
MOZ,Katembe,2021,12050,13556,4519,0,0,30125,4519,0.150008298755187,0.0500027662517289,0.0166675887505763
MOZ,Katembe,2022,12050,15063,3013,0,0,30126,3013,0.10001327756755,0.0333377591891832,0.0111125863963944
MOZ,Lago,2017,90284,7202,4501,0,0,101987,4501,0.0441330757841686,0.0147110252613895,0.00490367508712984
MOZ,Lalaua,2017,90028,0,0,0,0,90028,0,0,0,0
MOZ,Limpopo,2017,174374,9178,0,0,0,183552,0,0,0,0
MOZ,Luabo,2021,27228,30631,10210,0,0,68069,10210,0.149994858158633,0.0499982860528777,0.0166660953509592
MOZ,Luabo,2022,30631,30631,6807,0,0,68069,6807,0.100001469097533,0.0333338230325111,0.0111112743441704
MOZ,Lugela,2017,146142,11000,3647,0,0,160789,3647,0.0226818998812108,0.00756063329373693,0.00252021109791231
MOZ,Mabalane,2017,29986,8510,11211,0,0,49707,11211,0.225541674210876,0.0751805580702919,0.0250601860234306
MOZ,Mabalane,2019,13165,10971,21942,2194,0,48272,24136,0.5,0.181816926306485,0.0707058151953744
MOZ,Mabalane,2021,9866,17758,9866,1973,0,39463,11839,0.300002534019208,0.116666244330132,0.0499990145480858
MOZ,Mabalane,2022,11839,21704,5919,0,0,39462,5919,0.149992397749734,0.049997465916578,0.0166658219721927
MOZ,Mabote,2017,52317,38483,46341,1054,0,138195,47395,0.342957415246572,0.116861439753006,0.0406486808093234
MOZ,Mabote,2018,27478,12962,8814,2592,0,51846,11406,0.219997685453073,0.0899972996952513,0.0411089251501241
MOZ,Mabote,2019,20738,12962,18146,5185,0,57031,23331,0.409093300135014,0.166669589053906,0.075759966801681
MOZ,Mabote,2021,15696,28775,7848,0,0,52319,7848,0.150002867027275,0.0500009556757583,0.0166669852252528
MOZ,Mabote,2022,15696,31391,5232,0,0,52319,5232,0.100001911351517,0.0333339704505056,0.0111113234835019
MOZ,Macanga,2017,231706,0,0,0,0,231706,0,0,0,0
MOZ,Machanga,2017,51205,43668,12201,3853,0,110927,16054,0.144725810668277,0.059820121942058,0.0276588306824408
MOZ,Machanga,2018,26255,25137,2793,1676,0,55861,4469,0.0800021481892555,0.0366683971524558,0.0188901419992879
MOZ,Machaze,2017,141041,95550,23541,6924,0,267056,30465,0.114077197291954,0.046668114552753,0.0213176262656522
MOZ,Macomia,2017,62702,2048,2048,0,0,66798,2048,0.0306596005868439,0.0102198668622813,0.0034066222874271
MOZ,Macomia,2018,84976,19789,11641,0,0,116406,11641,0.100003436248991,0.0333344787496635,0.0111114929165545
MOZ,Macomia,2019,34922,40742,40742,11641,0,128047,52383,0.409091974040782,0.166667968272067,0.0757586407074486
MOZ,Macomia,2021,10510,13513,6006,0,0,30029,6006,0.200006660228446,0.0666688867428153,0.0222229622476051
MOZ,Macomia,2022,10510,13513,6006,0,0,30029,6006,0.200006660228446,0.0666688867428153,0.0222229622476051
MOZ,Macossa,2017,51199,4832,12081,483,0,68595,12564,0.183162038049421,0.0634011225307967,0.0226984474087033
MOZ,Macossa,2018,29189,11676,5838,1946,0,48649,7784,0.160003288865136,0.06666803702714,0.0311117506126653
MOZ,Macossa,2019,19459,24324,7297,0,0,51080,7297,0.142854346123728,0.0476181153745758,0.0158727051248586
MOZ,Macossa,2021,21308,23972,7991,0,0,53271,7991,0.150006570178897,0.0500021900596322,0.0166673966865441
MOZ,Macossa,2022,21308,26636,5327,0,0,53271,5327,0.0999981228060295,0.0333327076020098,0.0111109025340033
MOZ,Maganja da costa,2017,298964,0,0,0,0,298964,0,0,0,0
MOZ,Maganja da costa,2019,45876,64226,73402,27526,0,211030,100928,0.47826375396863,0.202900061602616,0.0966192273873646
MOZ,Maganja da costa,2021,84792,59354,25438,0,0,169584,25438,0.150002358713086,0.0500007862376954,0.0166669287458985
MOZ,Maganja da costa,2022,84792,67834,16958,0,0,169584,16958,0.0999976412869139,0.033332547095638,0.0111108490318793
MOZ,Magoe,2017,99875,7517,0,0,0,107392,0,0,0,0
MOZ,Magoe,2018,49309,21002,18263,2739,0,91313,21002,0.230000109513432,0.0866652794965303,0.035554144049101
MOZ,Magoe,2019,45646,44445,26427,3604,0,120122,30031,0.250004162434858,0.0933356642968537,0.0377791837557742
MOZ,Magoe,2020,48048,49250,36036,6006,0,139340,42042,0.301722405626525,0.114941868810105,0.0478924453375437
MOZ,Magude,2017,42013,6839,8045,0,0,56897,8045,0.141395855669016,0.047131951889672,0.0157106506298907
MOZ,Magude,2019,35030,28024,13375,0,0,76429,13375,0.174999018697091,0.0583330062323638,0.0194443354107879
MOZ,Magude,2020,18689,18689,24919,0,0,62297,24919,0.400003210427468,0.133334403475823,0.0444448011586076
MOZ,Magude,2021,23411,42921,24919,0,0,91251,24919,0.273081938828068,0.0910273129426892,0.0303424376475631
MOZ,Magude,2022,23411,42921,11706,0,0,78038,11706,0.150003844280991,0.0500012814269971,0.016667093808999
MOZ,Majune,2017,38216,10861,4073,0,0,53150,4073,0.0766321730950141,0.025544057698338,0.00851468589944601
MOZ,Malema,2017,135765,0,0,0,0,135765,0,0,0,0
MOZ,Mandimba,2017,167183,0,0,0,0,167183,0,0,0,0
MOZ,Mandlakaze,2017,159672,8404,0,0,0,168076,0,0,0,0
MOZ,Mandlakaze,2020,27414,61681,41120,6853,0,137068,47973,0.3499941634809,0.133330415073783,0.05555393430025
MOZ,Mandlakaze,2021,54827,68534,41120,6853,0,171334,47973,0.279996964992354,0.106664954611072,0.0444434068349929
MOZ,Mandlakazi,2018,57641,35147,30929,16871,0,140588,47800,0.340000569038609,0.15333456625032,0.0777788842417403
MOZ,Manhica,2019,145926,62540,20847,0,0,229313,20847,0.0909106766733678,0.0303035588911226,0.0101011862970409
MOZ,Manhiça,2017,98071,2001,8690,0,0,108762,8690,0.0798992295103069,0.0266330765034356,0.00887769216781188
MOZ,Manhiça,2021,128433,102746,25687,0,0,256866,25687,0.100001557232176,0.0333338524107252,0.0111112841369084
MOZ,Manhiça,2022,128433,115589,12843,0,0,256865,12843,0.0499990267261013,0.0166663422420338,0.00555544741401125
MOZ,Manica,2017,217254,0,0,0,0,217254,0,0,0,0
MOZ,Manica,2018,1318754,477809,57337,57337,0,1911237,114674,0.0599998848913034,0.0299999424456517,0.0166666346920287
MOZ,Manica,2019,1318754,477809,57337,57337,0,1911237,114674,0.0599998848913034,0.0299999424456517,0.0166666346920287
MOZ,Manica Prov.,2020,521008,818727,148860,0,0,1488595,148860,0.100000335887196,0.0333334452957319,0.0111111484319106
MOZ,Manica Prov.,2021,744298,818727,148860,0,0,1711885,148860,0.0869567757179951,0.0289855919059984,0.00966186396866612
MOZ,Mapai,2017,20479,5777,23108,0,0,49364,23108,0.468114415363423,0.156038138454474,0.0520127128181581
MOZ,Maputo Prov,2020,325434,406792,81358,0,0,813584,81358,0.0999995083482468,0.0333331694494156,0.0111110564831385
MOZ,Maputo Prov,2021,406792,406792,113902,0,0,927486,113902,0.122807244529837,0.0409357481766122,0.0136452493922041
MOZ,Maputo provincia,2018,1880324,576633,50142,0,0,2507099,50142,0.0200000079773475,0.00666666932578251,0.00222222310859417
MOZ,Maputo provincia,2019,1880324,576633,50142,0,0,2507099,50142,0.0200000079773475,0.00666666932578251,0.00222222310859417
MOZ,Maputo-cidade,2018,969030,110117,22023,0,0,1101170,22023,0.0199996367500023,0.00666654558333409,0.00222218186111136
MOZ,Maputo-cidade,2019,891948,165176,44047,0,0,1101171,44047,0.0400001452998671,0.0133333817666224,0.00444446058887413
MOZ,Marara,2018,37330,20905,14932,1493,0,74660,16425,0.219997321189392,0.0799982141262613,0.0311099205286186
MOZ,Maravia,2017,115541,0,0,0,0,115541,0,0,0,0
MOZ,Maravia,2019,43734,49981,24991,6248,0,124954,31239,0.250004001472542,0.100002134118689,0.044445689347013
MOZ,Maravia,2020,56229,56229,22492,0,0,134950,22492,0.166669136717303,0.0555563789057676,0.0185187929685892
MOZ,Maringue,2017,95338,2848,973,0,0,99159,973,0.00981252332113071,0.00327084110704357,0.00109028036901452
MOZ,Maringue,2018,57320,24707,13836,2965,0,98828,16801,0.17000242846157,0.0666680158119831,0.0288896983760788
MOZ,Marracuene,2017,142412,0,0,0,0,142412,0,0,0,0
MOZ,Marromeu,2017,84486,25461,5787,0,0,115734,5787,0.0500025921509669,0.016667530716989,0.00555584357232965
MOZ,Marromeu,2018,128100,15622,7811,4687,0,156220,12498,0.0800025604916144,0.0366683736610763,0.018890026885162
MOZ,Marrupa,2017,60518,0,0,0,0,60518,0,0,0,0
MOZ,Marrupa,2021,48367,38693,9673,0,0,96733,9673,0.0999968986798714,0.0333322995599571,0.0111107665199857
MOZ,Marrupa,2022,48367,43530,4837,0,0,96734,4837,0.0500031012880683,0.0166677004293561,0.0055559001431187
MOZ,Massangena,2017,14153,9043,3774,0,0,26970,3774,0.139933259176863,0.0466444197256211,0.0155481399085404
MOZ,Massangena,2018,13723,7458,5967,2685,0,29833,8652,0.290014413568867,0.126671806388898,0.06222415892915
MOZ,Massinga,2017,180855,0,0,0,0,180855,0,0,0,0
MOZ,Massinga,2020,82929,106623,23694,23694,0,236940,47388,0.2,0.1,0.0555555555555556
MOZ,Massinga,2021,106623,118470,23694,23694,0,272481,47388,0.173913043478261,0.0869565217391304,0.0483091787439614
MOZ,Massingir,2017,27768,23114,7632,361,0,58875,7993,0.135762208067941,0.0472979476291578,0.0171285680585044
MOZ,Massingir,2019,7460,7460,20515,3730,0,39165,24245,0.619047619047619,0.238095238095238,0.100529100529101
MOZ,Matutuine,2017,32818,9154,0,0,0,41972,0,0,0,0
MOZ,Matutuine,2019,25107,18830,6725,0,0,50662,6725,0.132742489439817,0.0442474964799389,0.014749165493313
MOZ,Maua,2017,65387,0,0,0,0,65387,0,0,0,0
MOZ,Mavago,2017,28344,22766,0,0,0,51110,0,0,0,0
MOZ,Mavago,2021,31161,3666,1833,0,0,36660,1833,0.05,0.0166666666666667,0.00555555555555555
MOZ,Mavago,2022,32994,1833,1833,0,0,36660,1833,0.05,0.0166666666666667,0.00555555555555555
MOZ,Mecanhelas,2017,270344,14229,0,0,0,284573,0,0,0,0
MOZ,Mecanhelas,2021,264991,49686,16562,0,0,331239,16562,0.0500001509484089,0.016666716982803,0.00555557232760098
MOZ,Mecanhelas,2022,264991,49686,16562,0,0,331239,16562,0.0500001509484089,0.016666716982803,0.00555557232760098
MOZ,Meconta,2017,149992,0,0,0,0,149992,0,0,0,0
MOZ,Meconta,2021,118775,118775,26395,0,0,263945,26395,0.100001894334047,0.0333339647780156,0.0111113215926719
MOZ,Meconta,2022,118775,131973,13197,0,0,263945,13197,0.0499990528329766,0.0166663509443255,0.00555545031477517
MOZ,Mecuburi,2017,189880,0,0,0,0,189880,0,0,0,0
MOZ,Mecufi,2017,48092,981,0,0,0,49073,0,0,0,0
MOZ,Mecufi,2019,28327,25180,12590,0,0,66097,12590,0.190477631359971,0.063492543786657,0.021164181262219
MOZ,Mecula,2017,17283,2104,0,0,0,19387,0,0,0,0
MOZ,Mecúfi,2021,38356,30684,7671,0,0,76711,7671,0.0999986964059913,0.0333328988019971,0.0111109662673324
MOZ,Mecúfi,2022,38356,30684,7671,0,0,76711,7671,0.0999986964059913,0.0333328988019971,0.0111109662673324
MOZ,Meluco,2017,25776,10744,0,0,0,36520,0,0,0,0
MOZ,Meluco,2019,16709,16709,5570,0,0,38988,5570,0.142864471119319,0.0476214903731063,0.0158738301243688
MOZ,Meluco,2021,16684,16684,8342,0,0,41710,8342,0.2,0.0666666666666667,0.0222222222222222
MOZ,Meluco,2022,16684,16684,8342,0,0,41710,8342,0.2,0.0666666666666667,0.0222222222222222
MOZ,Memba,2017,268602,39902,66504,13301,0,388309,79805,0.205519315802621,0.0799243214381674,0.0342533623709182
MOZ,Metarica,2017,70275,49598,0,0,0,119873,0,0,0,0
MOZ,Metuge,2017,84532,3450,3450,0,0,91432,3450,0.0377329600139995,0.0125776533379998,0.00419255111266661
MOZ,Metuge,2021,34636,34636,161636,0,0,230908,161636,0.700001732291649,0.233333910763883,0.0777779702546276
MOZ,Metuge,2022,34636,34636,161636,0,0,230908,161636,0.700001732291649,0.233333910763883,0.0777779702546276
MOZ,Milange,2017,619975,0,0,0,0,619975,0,0,0,0
MOZ,Milange,2018,402529,142433,68120,6193,0,619275,74313,0.12,0.0433334678992908,0.0166668012326242
MOZ,Milange,2021,348028,313225,34803,0,0,696056,34803,0.0500002873332031,0.016666762444401,0.00555558748146701
MOZ,Milange,2022,591648,104408,0,0,0,696056,0,0,0,0
MOZ,Moamba,2017,40007,6607,0,0,0,46614,0,0,0,0
MOZ,Moatize,2017,307210,23123,0,0,0,330333,0,0,0,0
MOZ,Moatize,2018,171773,85887,68709,17177,0,343546,85886,0.249998544590826,0.099999223781774,0.0444439916504793
MOZ,Moatize,2019,154596,103064,103064,34355,0,395079,137419,0.347826637204205,0.14492797643003,0.0676331681624294
MOZ,Mocimboa da praia,2017,53813,6975,0,0,0,60788,0,0,0,0
MOZ,Mocimboa da praia,2019,49590,49590,24795,6199,0,130174,30994,0.238096701338209,0.0952391926703233,0.0423288145951658
MOZ,Mocuba,2017,174370,0,0,0,0,174370,0,0,0,0
MOZ,Mocímboa da praia,2021,759,759,6075,0,0,7593,6075,0.800079020150138,0.266693006716713,0.0888976689055709
MOZ,Mocímboa da praia,2022,759,759,6075,0,0,7593,6075,0.800079020150138,0.266693006716713,0.0888976689055709
MOZ,Mogincual,2017,161655,11105,0,0,0,172760,0,0,0,0
MOZ,Mogincual,2021,62018,39466,11276,0,0,112760,11276,0.1,0.0333333333333333,0.0111111111111111
MOZ,Mogincual,2022,62018,45104,5638,0,0,112760,5638,0.05,0.0166666666666667,0.00555555555555556
MOZ,Mogovolas,2017,262607,132537,101352,15593,0,512089,116945,0.228368506255749,0.0862727637838995,0.0355242068381777
MOZ,Moma,2017,340407,0,0,0,0,340407,0,0,0,0
MOZ,Monapo,2017,293455,15445,0,0,0,308900,0,0,0,0
MOZ,Monapo,2021,162046,254644,46299,0,0,462989,46299,0.100000215987853,0.0333334053292843,0.0111111351097614
MOZ,Monapo,2022,162046,277793,23149,0,0,462988,23149,0.0499991360467226,0.0166663786822409,0.00555545956074696
MOZ,Montepuez,2017,138819,0,0,0,0,138819,0,0,0,0
MOZ,Montepuez,2021,125680,125680,62840,0,0,314200,62840,0.2,0.0666666666666667,0.0222222222222222
MOZ,Montepuez,2022,125680,125680,62840,0,0,314200,62840,0.2,0.0666666666666667,0.0222222222222222
MOZ,Mopeia,2017,167506,100558,40548,1622,0,310234,42170,0.135929653100563,0.047052654877716,0.0168460652998131
MOZ,Morrumbala,2017,412247,108418,47704,0,0,568369,47704,0.083931389642996,0.0279771298809987,0.00932570996033289
MOZ,Morrumbala,2018,262330,64632,49425,3802,0,380189,53227,0.140001420346196,0.0500005698919923,0.0188891431483932
MOZ,Morrumbene,2017,139897,0,0,0,0,139897,0,0,0,0
MOZ,Mossuril,2017,118753,0,0,0,0,118753,0,0,0,0
MOZ,Mossurize,2017,300187,0,0,0,0,300187,0,0,0,0
MOZ,Muanza,2017,31339,8839,1607,0,0,41785,1607,0.0384587770731124,0.0128195923577041,0.00427319745256804
MOZ,Muecate,2017,117877,0,0,0,0,117877,0,0,0,0
MOZ,Mueda,2017,94900,3873,3873,0,0,102646,3873,0.0377316213003916,0.0125772071001305,0.00419240236671018
MOZ,Mueda,2021,43752,58335,175006,14584,0,291677,189590,0.649999828577502,0.233333447614999,0.0888890412644428
MOZ,Mueda,2022,43752,58335,175006,14584,0,291677,189590,0.649999828577502,0.233333447614999,0.0888890412644428
MOZ,Muembe,2017,39859,0,0,0,0,39859,0,0,0,0
MOZ,Muidumbe,2017,79020,0,0,0,0,79020,0,0,0,0
MOZ,Muidumbe,2021,7998,7998,3999,0,0,19995,3999,0.2,0.0666666666666667,0.0222222222222222
MOZ,Muidumbe,2022,7998,7998,3999,0,0,19995,3999,0.2,0.0666666666666667,0.0222222222222222
MOZ,Mulevala,2021,36983,67802,18492,0,0,123277,18492,0.150003650315955,0.050001216771985,0.0166670722573283
MOZ,Mulevala,2022,49311,67802,6164,0,0,123277,6164,0.050001216771985,0.0166670722573283,0.00555569075244278
MOZ,Murrupula,2017,153035,12887,0,0,0,165922,0,0,0,0
MOZ,Mutarara,2017,261103,62702,20446,6815,0,351066,27261,0.0776520654235956,0.0323547898875615,0.0150987753489847
MOZ,Mutarara,2018,122413,41496,22823,20748,0,207480,43571,0.210000963948332,0.103333654649444,0.0566667737720369
MOZ,Mutarara,2019,79659,127454,95590,15932,0,318635,111522,0.349999215403204,0.133333333333333,0.0555557299103991
MOZ,Mutarara,2020,143385,127454,79659,15932,0,366430,95591,0.26087110771498,0.101450026835503,0.0434786695655074
MOZ,Mutarara,2021,99310,79448,19862,0,0,198620,19862,0.1,0.0333333333333333,0.0111111111111111
MOZ,Mutarara,2022,99310,89379,9931,0,0,198620,9931,0.05,0.0166666666666667,0.00555555555555555
MOZ,Nacala Porto,2017,207209,60944,60944,12189,0,341286,73133,0.214286551455378,0.0833338216823036,0.035714588025553
MOZ,Nacala-a-velha,2017,79925,6731,0,0,0,86656,0,0,0,0
MOZ,Nacaroa,2017,128500,0,0,0,0,128500,0,0,0,0
MOZ,Namaacha,2017,30478,4962,0,0,0,35440,0,0,0,0
MOZ,Namaacha,2019,27816,25034,8345,0,0,61195,8345,0.136367350273715,0.0454557834245717,0.0151519278081906
MOZ,Namacurra,2017,189122,0,0,0,0,189122,0,0,0,0
MOZ,Namacurra,2019,133169,84744,36319,24213,0,278445,60532,0.217393021961249,0.101450316340151,0.0531407559043178
MOZ,Namarroi,2017,153014,0,0,0,0,153014,0,0,0,0
MOZ,Nampula,2018,3905835,1830860,183086,183086,0,6102867,366172,0.0599999967228517,0.0299999983614259,0.0166666657563477
MOZ,Nampula,2019,3051434,2380118,427201,244115,0,6102868,671316,0.110000085205841,0.0500000436953031,0.0255555803162273
MOZ,Nampula Prov.,2020,484405,538228,53823,0,0,1076456,53823,0.0500001857948676,0.0166667285982892,0.00555557619942973
MOZ,Nampula Prov.,2021,904654,538228,56541,0,0,1499423,56541,0.0377085052050022,0.0125695017350007,0.00418983391166691
MOZ,Namuno,2017,217025,160893,85810,12871,0,476599,98681,0.207052469686256,0.0780194670991756,0.0320078071688965
MOZ,Namuno,2018,177921,44480,24711,0,0,247112,24711,0.0999991906503933,0.0333330635501311,0.011111021183377
MOZ,Namuno,2019,123557,86490,37067,0,0,247114,37067,0.149999595328472,0.0499998651094906,0.0166666217031635
MOZ,Namuno,2020,197690,86490,37067,0,0,321247,37067,0.115384735110367,0.0384615783701223,0.0128205261233741
MOZ,Namuno,2021,144622,130159,14462,0,0,289243,14462,0.0499994814049087,0.0166664938016362,0.00555549793387874
MOZ,Namuno,2022,144622,130159,14462,0,0,289243,14462,0.0499994814049087,0.0166664938016362,0.00555549793387874
MOZ,Nangade,2017,72765,0,0,0,0,72765,0,0,0,0
MOZ,Nangade,2019,35598,31148,35598,4450,0,106794,40048,0.375002340955484,0.138890449525878,0.0555565959802153
MOZ,Nangade,2021,25859,25859,71112,6465,0,129295,77577,0.6,0.216667311187594,0.0833339778542609
MOZ,Nangade,2022,25859,25859,71112,6465,0,129295,77577,0.6,0.216667311187594,0.0833339778542609
MOZ,Ngauma,2017,109274,0,0,0,0,109274,0,0,0,0
MOZ,Ngauma,2021,58679,46943,11736,0,0,117358,11736,0.100001704187188,0.0333339013957293,0.0111113004652431
MOZ,Ngauma,2022,99753,11736,5868,0,0,117357,5868,0.050001278151282,0.016667092717094,0.00555569757236467
MOZ,Nhamatanda,2017,263574,791,791,0,0,265156,791,0.00298314954215632,0.000994383180718772,0.000331461060239591
MOZ,Nhamatanda,2019,95261,95261,158769,15877,0,365168,174646,0.478262060202427,0.173913559421052,0.0676331015982902
MOZ,Nhamatanda,2020,111632,139541,27908,0,0,279081,27908,0.099999641681089,0.0333332138936963,0.0111110712978988
MOZ,Nhamatanda,2021,196111,139541,41862,0,0,377514,41862,0.110888602806783,0.0369628676022611,0.0123209558674204
MOZ,Nhamatanda,2022,196111,130740,0,0,0,326851,0,0,0,0
MOZ,Niassa,2018,1449187,214694,89456,35782,0,1789119,125238,0.0699998155516765,0.0299998677188791,0.0144443531518399
MOZ,Niassa,2019,1449187,214694,89456,35782,0,1789119,125238,0.0699998155516765,0.0299998677188791,0.0144443531518399
MOZ,Niassa Prov.,2020,346933,390299,86733,43367,0,867332,130100,0.150000230592207,0.0666668972588736,0.0333335126828276
MOZ,Niassa Prov.,2021,607132,390299,86733,43367,0,1127531,130100,0.115384854163655,0.0512822559497995,0.025641177246765
MOZ,Nicoadala,2017,245903,18509,0,0,0,264412,0,0,0,0
MOZ,Nicoadala,2019,72274,63240,54206,18069,0,207789,72275,0.34782880710721,0.144929070675862,0.0676337802075931
MOZ,Nicoadala,2021,87186,108983,21797,0,0,217966,21797,0.100001835148601,0.0333339450495337,0.0111113150165112
MOZ,Nicoadala,2022,98084,108983,10898,0,0,217965,10898,0.0499988530268621,0.0166662843422874,0.00555542811409579
MOZ,Nipepe,2017,39376,0,0,0,0,39376,0,0,0,0
MOZ,Palma,2017,52474,0,0,0,0,52474,0,0,0,0
MOZ,Palma,2019,28200,25067,9400,0,0,62667,9400,0.149999202131904,0.0499997340439679,0.0166665780146559
MOZ,Palma,2021,984,1969,14765,1969,0,19687,16734,0.850002539747041,0.316672592743096,0.127783139465976
MOZ,Palma,2022,984,1969,14765,1969,0,19687,16734,0.850002539747041,0.316672592743096,0.127783139465976
MOZ,Panda,2017,52040,29031,10620,1056,0,92747,11676,0.125890864394536,0.0457588924709155,0.0177831448276854
MOZ,Panda,2018,21444,9747,3899,3899,0,38989,7798,0.200005129651953,0.100002564825977,0.0555569804588759
MOZ,Panda,2019,13646,13646,13646,3899,0,44837,17545,0.391306287218146,0.159421906015121,0.072464953299978
MOZ,Panda,2020,10992,13190,13190,6595,0,43967,19785,0.449996588350354,0.199998483711268,0.0999992418556342
MOZ,Panda,2021,10992,19786,13190,6595,0,50563,19785,0.39129402923086,0.173908457435938,0.086954228717969
MOZ,Pebane,2017,208209,0,0,0,0,208209,0,0,0,0
MOZ,Pebane,2021,96197,120247,24049,0,0,240493,24049,0.0999987525624447,0.0333329175208149,0.0111109725069383
MOZ,Pebane,2022,108222,120247,12025,0,0,240494,12025,0.0500012474323684,0.0166670824774561,0.00555569415915204
MOZ,Quissanga,2017,39798,1624,0,0,0,41422,0,0,0,0
MOZ,Quissanga,2019,15052,20070,17561,0,0,52683,17561,0.333333333333333,0.111111111111111,0.037037037037037
MOZ,Quissanga,2021,1071,1071,8030,535,0,10707,8565,0.799943961894088,0.283303757666324,0.105538432800971
MOZ,Quissanga,2022,1071,1071,8030,535,0,10707,8565,0.799943961894088,0.283303757666324,0.105538432800971
MOZ,Rapale,2017,301125,0,0,0,0,301125,0,0,0,0
MOZ,Ribaue,2017,169689,0,0,0,0,169689,0,0,0,0
MOZ,Sanga,2017,69490,0,0,0,0,69490,0,0,0,0
MOZ,Sofala,2018,1377518,822067,22218,0,0,2221803,22218,0.00999998649745274,0.00333332883248425,0.00111110961082808
MOZ,Sofala,2019,1333082,866503,22218,0,0,2221803,22218,0.00999998649745274,0.00333332883248425,0.00111110961082808
MOZ,Sofala Prov.,2020,381951,477439,95488,0,0,954878,95488,0.100000209450841,0.0333334031502803,0.0111111343834268
MOZ,Sofala Prov.,2021,381951,525182,95488,0,0,1002621,95488,0.0952383802054814,0.0317461267351605,0.0105820422450535
MOZ,Sussundenga,2017,174011,0,0,0,0,174011,0,0,0,0
MOZ,Sussundenga,2019,67280,58870,42050,8410,0,176610,50460,0.285714285714286,0.111111111111111,0.0476190476190476
MOZ,Sussundenga,2021,100082,80066,20016,0,0,200164,20016,0.0999980016386563,0.0333326672128854,0.0111108890709618
MOZ,Sussundenga,2022,100082,90074,10008,0,0,200164,10008,0.0499990008193282,0.0166663336064427,0.00555544453548091
MOZ,Tambara,2017,57048,576,1729,0,0,59353,1729,0.0291307937256752,0.00971026457522507,0.00323675485840836
MOZ,Tambara,2019,16484,19232,19232,2747,0,57695,21979,0.380951555594072,0.142854666782217,0.0581987655390897
MOZ,Tambara,2021,30887,18532,12355,0,0,61774,12355,0.200003237608055,0.0666677458693517,0.0222225819564506
MOZ,Tambara,2022,30887,21621,9266,0,0,61774,9266,0.149998381195972,0.0499994603986575,0.0166664867995525
MOZ,Tete,2018,1437368,967459,331700,27642,0,2764169,359342,0.130000010853171,0.0466667076675365,0.0177778163668317
MOZ,Tete,2019,1575576,884534,276417,27642,0,2764169,304059,0.110000148326676,0.0400000868253714,0.0155556094194434
MOZ,Tete Prov.,2020,412584,412584,206292,0,0,1031460,206292,0.2,0.0666666666666667,0.0222222222222222
MOZ,Tete Prov.,2021,618876,515730,206292,0,0,1340898,206292,0.153846153846154,0.0512820512820513,0.0170940170940171
MOZ,Tsangano,2017,239830,0,0,0,0,239830,0,0,0,0
MOZ,Vilankulo,2017,111172,0,0,0,0,111172,0,0,0,0
MOZ,Zambezia,2018,3526443,1277697,255539,51108,0,5110787,306647,0.059999956953792,0.0233333274633959,0.0100000036958865
MOZ,Zambezia,2019,3066472,1737668,255539,51108,0,5110787,306647,0.059999956953792,0.0233333274633959,0.0100000036958865
MOZ,Zambezia Prov.,2020,869932,966592,96659,0,0,1933183,96659,0.0499999224077596,0.0166666408025865,0.00555554693419552
MOZ,Zambezia Prov.,2021,966592,927928,193318,0,0,2087838,193318,0.0925924329378046,0.0308641443126015,0.0102880481042005
MOZ,Zavala,2017,145949,0,0,0,0,145949,0,0,0,0
MOZ,Zavala,2018,104633,39042,7808,4685,0,156168,12493,0.0799971825213872,0.0366656421289893,0.0188884904575699
MOZ,Zumbu,2017,84942,0,0,0,0,84942,0,0,0,0
MOZ,cidade de Maputo,2020,248464,648166,183647,0,0,1080277,183647,0.169999916688035,0.0566666388960116,0.0188888796320039
MOZ,cidade de Maputo,2021,432111,648166,183647,0,0,1263924,183647,0.145299084438621,0.0484330281462071,0.0161443427154024
MRT,Aioun,2020,65058,8041,0,0,0,73099,0,0,0,0
MRT,Aioun,2021,47514,24930,13598,2266,0,88308,15864,0.179643973365946,0.0684347209010886,0.0285138379308783
MRT,Aioun,2022,36261,28707,18886,3777,0,87631,22663,0.258618525407675,0.100573237020385,0.0431024535964569
MRT,Akjoujt,2020,20716,3284,1263,0,0,25263,1263,0.0499940624628904,0.0166646874876301,0.00555489582921004
MRT,Akjoujt,2021,16421,6216,4594,1011,0,28242,5605,0.198463281637278,0.0780870098907065,0.0339840584157559
MRT,Akjoujt,2022,15134,6756,5135,353,0,27378,5488,0.200452918401636,0.0711154941924173,0.0265704012142759
MRT,Aleg,2020,85333,13901,7485,214,0,106933,7699,0.0719983541095826,0.0246665357435653,0.00866690149699137
MRT,Aleg,2021,80201,23940,10693,0,0,114834,10693,0.0931170210913144,0.0310390070304381,0.0103463356768127
MRT,Aleg,2022,58761,42439,22852,3265,0,127317,26117,0.205133642797113,0.0769260978502478,0.0313408438953339
MRT,Amourj,2020,93878,16966,2262,0,0,113106,2262,0.0199989390483264,0.00666631301610878,0.00222210433870293
MRT,Amourj,2021,74852,30539,18097,3393,0,126881,21490,0.169371300667555,0.0653709643944589,0.0277328975794467
MRT,Amourj,2022,64159,43961,29703,3564,0,141387,33267,0.235290373230919,0.086832594227192,0.0345458446203211
MRT,Aoujeft,2020,10879,1518,253,0,0,12650,253,0.02,0.00666666666666667,0.00222222222222222
MRT,Aoujeft,2021,9867,2650,759,127,0,13403,886,0.0661046034469895,0.0251933646696013,0.0105034527924926
MRT,Aoujeft,2022,6941,4417,2145,126,0,13629,2271,0.166629980189302,0.0586249908283807,0.0215961063418691
MRT,Atar,2020,31406,4919,1514,0,0,37839,1514,0.0400116282142763,0.0133372094047588,0.00444573646825292
MRT,Atar,2021,29135,7928,6040,378,0,43481,6418,0.147604700903843,0.0520993844054491,0.0192983397601507
MRT,Atar,2022,19630,13590,8683,378,0,42281,9061,0.214304297438566,0.0744148277792231,0.026791650570653
MRT,Bababe,2020,32099,4709,2354,78,0,39240,2432,0.0619775739041794,0.0213217804960924,0.00754898629516367
MRT,Bababe,2021,28751,8785,5494,0,0,43030,5494,0.12767836393214,0.0425594546440468,0.0141864848813489
MRT,Bababe,2022,17969,19966,11980,1597,0,51512,13577,0.263569653672931,0.0981907128436093,0.0396196786940691
MRT,Barkeol,2020,77742,13273,3792,0,0,94807,3792,0.0399970466315778,0.0133323488771926,0.00444411629239754
MRT,Barkeol,2021,65598,22860,12325,948,0,101731,13273,0.130471537682712,0.0465967436998883,0.0176030686592855
MRT,Barkeol,2022,51683,40750,24848,4970,0,122251,29818,0.243908025292227,0.0948540298238869,0.0406522464256143
MRT,Bassikounou,2020,88853,12693,4231,0,0,105777,4231,0.0399992436919179,0.0133330812306393,0.0044443604102131
MRT,Bassikounou,2021,84350,28006,9225,1058,0,122639,10283,0.0838477156532588,0.0308248871348701,0.0121920614341459
MRT,Bassikounou,2022,78238,53007,30562,4890,0,166697,35452,0.21267329346059,0.0806693181840905,0.0334085863039594
MRT,Bir mogrein,2020,3421,459,292,0,0,4172,292,0.0699904122722915,0.0233301374240972,0.00777671247469905
MRT,Bir mogrein,2021,3171,1194,682,42,0,5089,724,0.142267636077815,0.0501735769961355,0.018558546756621
MRT,Bir mogrein,2022,2089,1535,895,213,0,4732,1108,0.234150464919696,0.09305438151592,0.0410209448670987
MRT,Boghe,2020,62251,7610,6088,152,0,76101,6240,0.0819962943982339,0.0279978800103371,0.00977648125517405
MRT,Boghe,2021,54032,27104,9132,0,0,90268,9132,0.101165418531484,0.0337218061771613,0.0112406020590538
MRT,Boghe,2022,40269,38720,17037,5421,0,101447,22458,0.221376679448382,0.0916044831291216,0.0424096654739256
MRT,Boumdeid,2020,7609,1409,376,0,0,9394,376,0.0400255482222695,0.0133418494074232,0.00444728313580773
MRT,Boumdeid,2021,6388,2659,985,94,0,10126,1079,0.10655737704918,0.0386134702745408,0.0149340531525007
MRT,Boumdeid,2022,5318,3447,2265,394,0,11424,2659,0.232755602240896,0.0890814659197012,0.0373579987550576
MRT,Boutilimit,2020,58864,10638,1418,0,0,70920,1418,0.0199943598420756,0.00666478661402519,0.0022215955380084
MRT,Boutilimit,2021,55318,21996,9532,0,0,86846,9532,0.109757501784768,0.0365858339282562,0.0121952779760854
MRT,Boutilimit,2022,54990,25662,10998,0,0,91650,10998,0.12,0.04,0.0133333333333333
MRT,Chinguity,2020,5436,862,331,0,0,6629,331,0.0499321164579876,0.0166440388193292,0.0055480129397764
MRT,Chinguity,2021,5104,1984,992,66,0,8146,1058,0.129879695556101,0.0459939438579262,0.0171317892899037
MRT,Chinguity,2022,3241,2381,1323,132,0,7077,1455,0.205595591352268,0.0747491875088314,0.0290612783194386
MRT,Djigueni,2020,46349,24244,713,0,0,71306,713,0.00999915855608224,0.00333305285202741,0.00111101761734247
MRT,Djigueni,2021,39700,32088,11236,1498,0,84522,12734,0.150659000023662,0.0561273987837486,0.0226476210007125
MRT,Djigueni,2022,39700,33707,18726,2996,0,95129,21722,0.228342566409822,0.0866122142914709,0.0358694217559548
MRT,F'derik,2020,4240,656,151,0,0,5047,151,0.0299187636219536,0.00997292120731788,0.00332430706910596
MRT,F'derik,2021,4089,1547,722,0,0,6358,722,0.113557722554262,0.0378525741847541,0.0126175247282514
MRT,F'derik,2022,2785,2270,1186,52,0,6293,1238,0.196726521531861,0.068329890354362,0.024612885569504
MRT,Guerrou,2020,44189,6921,2130,0,0,53240,2130,0.040007513148009,0.013335837716003,0.00444527923866767
MRT,Guerrou,2021,37800,16186,5581,532,0,60099,6113,0.10171550275379,0.0368558545067306,0.0142524094503329
MRT,Guerrou,2022,32931,22326,12837,1116,0,69210,13953,0.201603814477677,0.0725762173096373,0.0277753696479314
MRT,Kaedi,2020,111723,14987,9537,0,0,136247,9537,0.0699978715127673,0.0233326238375891,0.00777754127919636
MRT,Kaedi,2021,94313,38149,16350,1408,0,150220,17758,0.118213287178804,0.0425287356321839,0.0162591162591163
MRT,Kaedi,2022,84460,57714,43638,7038,0,192850,50676,0.262774176821364,0.0997562872698989,0.0413620257540403
MRT,Kankossa,2020,83201,13704,979,0,0,97884,979,0.0100016345878795,0.00333387819595984,0.00111129273198661
MRT,Kankossa,2021,76963,22513,5131,0,0,104607,5131,0.0490502547630656,0.0163500849210219,0.00545002830700729
MRT,Kankossa,2022,53361,41047,24628,3079,0,122115,27707,0.226892683126561,0.0840355402694182,0.0336149440190713
MRT,Keur-macene,2020,25227,4505,300,0,0,30032,300,0.00998934469898775,0.00332978156632925,0.00110992718877642
MRT,Keur-macene,2021,23125,8073,2856,0,0,34054,2856,0.0838667997885711,0.0279555999295237,0.00931853330984123
MRT,Keur-macene,2022,24528,8694,3105,0,0,36327,3105,0.0854736146667768,0.0284912048889256,0.00949706829630853
MRT,Kiffa,2020,112976,15764,2627,0,0,131367,2627,0.0199974118309773,0.00666580394365911,0.00222193464788637
MRT,Kiffa,2021,94585,44070,15149,0,0,153804,15149,0.0984954877636472,0.0328318292545491,0.0109439430848497
MRT,Kiffa,2022,71614,59219,31675,4132,0,166640,35807,0.214876380220835,0.079890782525204,0.0321404758094628
MRT,Kobeni,2020,92436,10386,1039,0,0,103861,1039,0.010003755018727,0.00333458500624232,0.00111152833541411
MRT,Kobeni,2021,72988,46737,17656,1039,0,138420,18695,0.135059962433174,0.0475220343880942,0.0175087094029443
MRT,Kobeni,2022,55814,34347,24687,0,0,114848,24687,0.214953677904709,0.0716512259682363,0.0238837419894121
MRT,M'bagne,2020,37111,6889,1837,92,0,45929,1929,0.0419996080907488,0.0146675666064288,0.00533432036404015
MRT,M'bagne,2021,32716,15616,4593,0,0,52925,4593,0.0867831837505905,0.0289277279168635,0.00964257597228783
MRT,M'bagne,2022,22434,32716,13087,1870,0,70107,14957,0.213345315018472,0.0800062761207868,0.032596206116682
MRT,M'bout,2020,68838,24093,19504,2295,0,114730,21799,0.19000261483483,0.070002033760423,0.0277792304637942
MRT,M'bout,2021,69936,27535,24892,1147,0,123510,26039,0.210825034410169,0.0733705772811918,0.0265205696344875
MRT,M'bout,2022,62824,55712,32005,2371,0,152912,34376,0.224809040493879,0.0801048969341844,0.0301473323799891
MRT,Maghama,2020,62073,9962,4598,0,0,76633,4598,0.0600002609841713,0.0200000869947238,0.00666669566490792
MRT,Maghama,2021,45129,22990,15043,2299,0,85461,17342,0.202922970711787,0.0766080434350172,0.031514049943509
MRT,Maghama,2022,38004,32461,23752,2375,0,96592,26127,0.270488239191652,0.0983587322621611,0.0382502346640163
MRT,Maghta lahjar,2020,40096,18226,2430,0,0,60752,2430,0.0399986831709244,0.0133328943903081,0.00444429813010271
MRT,Maghta lahjar,2021,45130,18226,11543,1215,0,76114,12758,0.167616995559293,0.0611932977726393,0.0239450765372409
MRT,Maghta lahjar,2022,32766,34002,12364,3709,0,82841,16073,0.194022283651815,0.0795982665588296,0.0364822035250929
MRT,Mederdra,2020,30814,3006,342,0,0,34162,342,0.0100111234705228,0.00333704115684093,0.00111234705228031
MRT,Mederdra,2021,31433,6149,1366,0,0,38948,1366,0.0350724042312827,0.0116908014104276,0.00389693380347586
MRT,Mederdra,2022,29314,7770,3179,0,0,40263,3179,0.0789558651863994,0.0263186217287998,0.00877287390959994
MRT,Monguel,2020,23223,16933,7257,968,0,48381,8225,0.170004753932329,0.0633375360851023,0.0255587018779181
MRT,Monguel,2021,28991,23223,9497,1451,0,63162,10948,0.173332066748995,0.0654349133972958,0.0269166763419637
MRT,Monguel,2022,26992,17995,13496,1999,0,60482,15495,0.256191924870209,0.0964143601953198,0.0394828213352733
MRT,Moudjeria,2020,22689,14399,6545,0,0,43633,6545,0.150001145921665,0.0500003819738883,0.0166667939912961
MRT,Moudjeria,2021,28362,15708,8726,0,0,52796,8726,0.165277672550951,0.0550925575169836,0.0183641858389945
MRT,Moudjeria,2022,28362,15510,9749,886,0,54507,10635,0.195112554350817,0.0704557824377297,0.027097437026437
MRT,Nema,2020,76581,27302,10836,0,0,114719,10836,0.0944568903145948,0.0314856301048649,0.010495210034955
MRT,Nema,2021,70000,33885,15319,1147,0,120351,16466,0.13681647846715,0.0487823117381659,0.0183786498565769
MRT,Nema,2022,70000,32813,26250,2188,0,131251,28438,0.216668825380378,0.07777972485289,0.0296310969905838
MRT,Nouadhibou,2020,125832,17976,5992,0,0,149800,5992,0.04,0.0133333333333333,0.00444444444444444
MRT,Nouadhibou,2021,138882,25466,10486,0,0,174834,10486,0.0599768923664733,0.0199922974554911,0.00666409915183037
MRT,Nouadhibou,2022,119944,37064,12355,0,0,169363,12355,0.0729498178468733,0.0243166059489578,0.00810553531631926
MRT,Nouakchott Nord,2020,388396,66312,18946,0,0,473654,18946,0.0399996622006781,0.0133332207335594,0.00444440691118646
MRT,Nouakchott Nord,2021,441205,104204,37892,0,0,583301,37892,0.0649613149986028,0.0216537716662009,0.00721792388873364
MRT,Nouakchott Nord,2022,415848,136926,65927,0,0,618701,65927,0.106557125331945,0.0355190417773152,0.0118396805924384
MRT,Nouakchott Ouest,2020,175523,34248,4281,0,0,214052,4281,0.0199998131295199,0.00666660437650664,0.00222220145883555
MRT,Nouakchott Ouest,2021,208556,42811,8562,0,0,259929,8562,0.0329397643202567,0.0109799214400856,0.00365997381336185
MRT,Nouakchott Ouest,2022,203972,112299,29794,0,0,346065,29794,0.0860936529264733,0.0286978843088245,0.00956596143627482
MRT,Nouakchott Sud,2020,456093,82426,10990,0,0,549509,10990,0.0199996724348464,0.00666655747828213,0.00222218582609404
MRT,Nouakchott Sud,2021,476563,120892,38466,0,0,635921,38466,0.0604886456022053,0.0201628818674018,0.00672096062246726
MRT,Nouakchott Sud,2022,411844,147087,64718,0,0,623649,64718,0.103773115967475,0.0345910386558251,0.0115303462186084
MRT,Ouad naga,2020,23936,2660,0,0,0,26596,0,0,0,0
MRT,Ouad naga,2021,20745,7699,3300,0,0,31744,3300,0.103956653225806,0.0346522177419355,0.0115507392473118
MRT,Ouad naga,2022,14848,10998,6049,275,0,32170,6324,0.19658066521604,0.0683763340586468,0.0246917417884157
MRT,Ouadane,2020,3171,580,116,0,0,3867,116,0.0299974140160331,0.00999913800534437,0.00333304600178146
MRT,Ouadane,2021,3009,733,232,39,0,4013,271,0.0675305257911787,0.0257496469806462,0.0107428634714954
MRT,Ouadane,2022,2430,1157,656,39,0,4282,695,0.162307333021952,0.0571384088432197,0.0210701126161192
MRT,Oualata,2020,13305,1878,470,0,0,15653,470,0.0300261930620328,0.0100087310206776,0.0033362436735592
MRT,Oualata,2021,10957,4111,2138,164,0,17370,2302,0.132527345998849,0.0473229706390328,0.0178724493059554
MRT,Oualata,2022,9701,6084,3782,493,0,20060,4275,0.213110667996012,0.0792289797274842,0.0318710535061482
MRT,Ould yenge,2020,65445,10503,4848,0,0,80796,4848,0.0600029704440814,0.0200009901480271,0.00666699671600904
MRT,Ould yenge,2021,52468,22849,12927,808,0,89052,13735,0.154235727440147,0.0544363592807199,0.0201617531829094
MRT,Ould yenge,2022,38928,38928,27080,5078,0,110014,32158,0.292308251677059,0.112822004472158,0.0478646152105894
MRT,R'kiz,2020,71828,7008,796,0,0,79632,796,0.00999598151496886,0.00333199383832295,0.00111066461277432
MRT,R'kiz,2021,67509,15926,3293,0,0,86728,3293,0.0379692832764505,0.0126564277588168,0.00421880925293895
MRT,R'kiz,2022,57629,24698,7409,0,0,89736,7409,0.0825644111616297,0.0275214703872099,0.00917382346240329
MRT,Rosso,2020,58306,6478,0,0,0,64784,0,0,0,0
MRT,Rosso,2021,53771,13395,3349,0,0,70515,3349,0.0474934411118202,0.0158311470372734,0.00527704901242446
MRT,Rosso,2022,48894,20093,5358,0,0,74345,5358,0.0720694061470173,0.0240231353823391,0.00800771179411303
MRT,Selibaby,2020,192616,30537,11745,0,0,234898,11745,0.0500004257166941,0.0166668085722314,0.00555560285741045
MRT,Selibaby,2021,167302,70469,37584,2349,0,277704,39933,0.143796992481203,0.0507518796992481,0.018796992481203
MRT,Selibaby,2022,108254,110715,61508,14762,0,295239,76270,0.258333079301854,0.102777749552058,0.0453703985960903
MRT,Tamchekett,2020,36283,6557,874,0,0,43714,874,0.0199935947293773,0.00666453157645911,0.00222151052548637
MRT,Tamchekett,2021,32979,14426,2623,0,0,50028,2623,0.0524306388422483,0.0174768796140828,0.00582562653802759
MRT,Tamchekett,2022,22589,14457,11294,452,0,48792,11746,0.240736186260043,0.0833333333333333,0.0298364030533239
MRT,Tichitt,2020,284,180,82,0,0,546,82,0.15018315018315,0.0500610500610501,0.0166870166870167
MRT,Tichitt,2021,3232,1016,369,0,0,4617,369,0.0799220272904483,0.0266406757634828,0.00888022525449426
MRT,Tichitt,2022,2955,1385,1154,92,0,5586,1246,0.223057644110276,0.0798424633011099,0.0302740979432709
MRT,Tidjikja,2020,18958,12031,5469,0,0,36458,5469,0.150008228646662,0.0500027428822206,0.0166675809607402
MRT,Tidjikja,2021,22958,13125,8021,365,0,44469,8386,0.188580809102971,0.0655962580674178,0.023689411600091
MRT,Tidjikja,2022,24439,11849,8517,741,0,45546,9258,0.203267026742195,0.0731787643261757,0.0280083139390214
MRT,Timbedra,2020,89399,12621,3155,0,0,105175,3155,0.0299976230092703,0.00999920766975676,0.00333306922325225
MRT,Timbedra,2021,74674,25242,9935,0,0,109851,9935,0.0904406878408025,0.0301468959469342,0.0100489653156447
MRT,Timbedra,2022,59610,39740,21857,1987,0,123194,23844,0.193548387096774,0.0698924731182796,0.0268817204301075
MRT,Tintane,2020,94726,11977,2178,0,0,108881,2178,0.0200034900487688,0.00666783001625628,0.00222261000541876
MRT,Tintane,2021,72950,31506,23630,0,0,128086,23630,0.184485423855847,0.0614951412852823,0.0204983804284274
MRT,Tintane,2022,52885,40508,32631,1125,0,127149,33756,0.265483802467971,0.0914438965308418,0.0324474959824038
MRT,Zoueratt,2020,38722,7171,1912,0,0,47805,1912,0.0399958163372032,0.0133319387790677,0.00444397959302258
MRT,Zoueratt,2021,33464,14654,6838,478,0,55434,7316,0.131976765162175,0.0468665439982682,0.0175383739622294
MRT,Zoueratt,2022,24423,19538,10746,488,0,55195,11234,0.20353292870731,0.0707914364223813,0.0255618967096456
MWI,Balaka,2017,260933,113449,83196,0,0,457578,83196,0.181818181818182,0.0606060606060606,0.0202020202020202
MWI,Balaka,2018,183514,174775,152928,13108,0,524325,166036,0.316666189863157,0.113888650487134,0.0435183860730993
MWI,Balaka,2019,198402,159500,97256,0,0,455158,97256,0.213675251231441,0.0712250837438135,0.0237416945812712
MWI,Balaka,2020,175061,155610,77805,0,0,408476,77805,0.190476307053536,0.0634921023511785,0.0211640341170595
MWI,Balaka,2021,334166,155610,71607,19451,0,580834,91058,0.156771125657245,0.0634197263475164,0.0285816984236843
MWI,Balaka,2022,310297,220862,98161,0,0,629320,98161,0.155979469904023,0.0519931566346745,0.0173310522115582
MWI,Blantyre,2017,255879,134032,69047,0,0,458958,69047,0.150442959922259,0.0501476533074196,0.0167158844358065
MWI,Blantyre,2018,87409,229448,120187,8741,0,445785,128928,0.289215653285777,0.102941253444299,0.0386711082696816
MWI,Blantyre,2019,365488,180488,67683,0,0,613659,67683,0.110294153593445,0.0367647178644817,0.0122549059548272
MWI,Blantyre,2020,225610,180488,67683,0,0,473781,67683,0.142857142857143,0.0476190476190476,0.0158730158730159
MWI,Blantyre,2021,291547,180488,67683,0,0,539718,67683,0.125404377841762,0.0418014592805873,0.0139338197601958
MWI,Blantyre,2022,242956,199036,124397,0,0,566389,124397,0.219631737198286,0.0732105790660953,0.0244035263553651
MWI,Blantyre City,2020,536342,321805,214537,0,0,1072684,214537,0.200000186448199,0.0666667288160664,0.0222222429386888
MWI,Blantyre City,2021,536342,321805,214537,0,0,1072684,214537,0.200000186448199,0.0666667288160664,0.0222222429386888
MWI,Blantyre city,2020,643610,268171,214537,0,0,1126318,214537,0.190476401868744,0.063492133956248,0.0211640446520827
MWI,Blantyre city,2021,506497,379872,42208,0,0,928577,42208,0.0454544965037902,0.0151514988345967,0.00505049961153225
MWI,Blantyre city,2022,429038,379872,214519,0,0,1023429,214519,0.209608092012245,0.0698693640040817,0.0232897880013606
MWI,Chikhwawa,2017,418157,139363,117065,0,0,674585,117065,0.173536322331508,0.0578454407771692,0.0192818135923897
MWI,Chikhwawa,2018,180376,255532,180376,30063,0,646347,210439,0.325582078976154,0.124031415529636,0.0516798424238236
MWI,Chikhwawa,2019,303346,215100,66185,0,0,584631,66185,0.11320816036098,0.03773605345366,0.0125786844845533
MWI,Chikhwawa,2020,303346,193038,82731,0,0,579115,82731,0.142857636220785,0.0476192120735951,0.0158730706911984
MWI,Chikhwawa,2021,391974,193038,120607,0,0,705619,120607,0.170923685444978,0.0569745618149927,0.0189915206049976
MWI,Chikhwawa,2022,301519,246274,215490,0,0,763283,215490,0.282319925899044,0.094106641966348,0.0313688806554493
MWI,Chiradzulu,2017,258449,81788,39258,0,0,379495,39258,0.1034480032675,0.0344826677558334,0.0114942225852778
MWI,Chiradzulu,2018,188953,82874,82874,8288,0,362989,91162,0.251142596607611,0.0913250814762982,0.0355156155634958
MWI,Chiradzulu,2019,297288,159261,53087,0,0,509636,53087,0.104166503151269,0.0347221677170896,0.0115740559056965
MWI,Chiradzulu,2020,194653,141566,53087,0,0,389306,53087,0.136363169332094,0.0454543897773645,0.0151514632591215
MWI,Chiradzulu,2021,263972,141566,53087,0,0,458625,53087,0.115752521122922,0.0385841737076406,0.0128613912358802
MWI,Chiradzulu,2022,245117,115068,76712,0,0,436897,76712,0.175583718817021,0.0585279062723403,0.0195093020907801
MWI,Chitipa,2017,182978,37427,0,0,0,220405,0,0,0,0
MWI,Chitipa,2018,190186,35220,5870,1174,0,232450,7044,0.0303032910303291,0.0117846131784613,0.00505054850505485
MWI,Chitipa,2019,193294,65155,15203,0,0,273652,15203,0.0555559615862482,0.0185186538620827,0.00617288462069425
MWI,Chitipa,2020,184606,32578,21718,0,0,238902,21718,0.0909075687938988,0.0303025229312996,0.0101008409770999
MWI,Chitipa,2021,222763,32578,21718,0,0,277059,21718,0.0783876358465165,0.0261292119488388,0.00870973731627961
MWI,Chitipa,2022,210387,75549,25183,0,0,311119,25183,0.0809433046519177,0.0269811015506393,0.00899370051687975
MWI,Dedza,2017,663253,223568,0,0,0,886821,0,0,0,0
MWI,Dedza,2018,567501,197049,157639,19705,0,941894,177344,0.188284456637371,0.0697350232616409,0.0278940328977807
MWI,Dedza,2019,647663,119938,119938,0,0,887539,119938,0.135135470103286,0.0450451567010952,0.0150150522336984
MWI,Dedza,2020,519730,239875,119938,0,0,879543,119938,0.136363998121752,0.045454666040584,0.0151515553468613
MWI,Dedza,2021,711214,266705,119938,0,0,1097857,119938,0.109247379212411,0.0364157930708037,0.0121385976902679
MWI,Dedza,2022,622312,317970,136273,0,0,1076555,136273,0.1265824783685,0.0421941594561665,0.0140647198187222
MWI,Dowa,2017,716466,241505,0,0,0,957971,0,0,0,0
MWI,Dowa,2018,519731,303176,86622,43311,0,952840,129933,0.136363922589312,0.060606187817472,0.030303093908736
MWI,Dowa,2019,651984,111134,37045,0,0,800163,37045,0.0462968170235315,0.0154322723411772,0.00514409078039238
MWI,Dowa,2020,444535,259312,111134,0,0,814981,111134,0.13636391523238,0.0454546384107932,0.0151515461369311
MWI,Dowa,2021,710531,259312,111134,0,0,1080977,111134,0.102808847921834,0.0342696159739446,0.0114232053246482
MWI,Dowa,2022,585143,257253,128627,0,0,971023,128627,0.132465451384777,0.0441551504615922,0.0147183834871974
MWI,Karonga,2017,255467,26735,14853,0,0,297055,14853,0.0500008415949908,0.0166669471983303,0.00555564906611009
MWI,Karonga,2018,268519,92593,33334,9260,0,403706,42594,0.105507473260244,0.0428149858230164,0.0193688806540733
MWI,Karonga,2019,239701,91026,60684,3034,0,394445,63718,0.161538364030473,0.0564100613942797,0.0205126471652857
MWI,Karonga,2020,212393,60684,45513,0,0,318590,45513,0.142857591261496,0.0476191970871653,0.0158730656957218
MWI,Karonga,2021,349902,60684,45513,0,0,456099,45513,0.0997875461248545,0.0332625153749515,0.0110875051249838
MWI,Karonga,2022,311024,119129,59565,0,0,489718,59565,0.121631224500631,0.0405437415002103,0.0135145805000701
MWI,Kasungu,2017,781301,207793,41559,0,0,1030653,41559,0.0403229797031591,0.0134409932343864,0.00448033107812879
MWI,Kasungu,2018,510149,389568,139132,23189,0,1062038,162321,0.152839163947053,0.0582245330832481,0.0242602744283475
MWI,Kasungu,2019,602775,181559,72624,0,0,856958,72624,0.0847462769470616,0.0282487589823539,0.00941625299411795
MWI,Kasungu,2020,508365,217871,108935,0,0,835171,108935,0.130434366135797,0.0434781220452658,0.0144927073484219
MWI,Kasungu,2021,770887,226732,108935,0,0,1106554,108935,0.0984452634033224,0.0328150878011075,0.0109383626003692
MWI,Kasungu,2022,696353,185694,92847,0,0,974894,92847,0.095238046392736,0.0317460154642453,0.0105820051547484
MWI,Likoma,2020,12327,2175,725,0,0,15227,725,0.0476127930649504,0.0158709310216501,0.00529031034055005
MWI,Likoma,2021,13852,2175,770,0,0,16797,770,0.045841519318926,0.015280506439642,0.00509350214654733
MWI,Likoma,2022,14122,4707,770,0,0,19599,770,0.0392877187611613,0.0130959062537204,0.00436530208457348
MWI,Lilongwe,2017,1344415,453174,0,0,0,1797589,0,0,0,0
MWI,Lilongwe,2018,970007,547585,195566,39113,0,1752271,234679,0.133928484806289,0.0520832679420021,0.0223213824294936
MWI,Lilongwe,2019,1342818,409396,163758,0,0,1915972,163758,0.085469933798615,0.0284899779328717,0.00949665931095722
MWI,Lilongwe,2020,982550,655033,163758,0,0,1801341,163758,0.0909089395067341,0.0303029798355781,0.010100993278526
MWI,Lilongwe,2021,1490304,655033,175330,0,0,2320667,175330,0.0755515547900668,0.0251838515966889,0.00839461719889631
MWI,Lilongwe,2022,1051979,806319,358364,0,0,2216662,358364,0.161668310279149,0.0538894367597165,0.0179631455865722
MWI,Lilongwe City,2020,819434,341431,204859,0,0,1365724,204859,0.150000292884946,0.0500000976283153,0.0166666992094384
MWI,Lilongwe City,2021,682862,409717,204859,68286,0,1365724,273145,0.200000146442473,0.0833333333333333,0.0388888563461171
MWI,Lilongwe city,2020,887721,409717,273145,0,0,1570583,273145,0.173913126526901,0.0579710421756337,0.0193236807252112
MWI,Lilongwe city,2021,715189,255425,102170,0,0,1072784,102170,0.0952381840146758,0.0317460613382253,0.0105820204460751
MWI,Lilongwe city,2022,664104,506764,337843,0,0,1508711,337843,0.223928240730001,0.0746427469100002,0.0248809156366667
MWI,Machinga,2017,416676,122552,91914,0,0,631142,91914,0.145631252554893,0.0485437508516309,0.016181250283877
MWI,Machinga,2018,374211,200470,167059,16706,0,758446,183765,0.24229147493691,0.0881060308402532,0.0342634808542731
MWI,Machinga,2019,490059,284092,106535,0,0,880686,106535,0.120968199789709,0.0403227332632365,0.0134409110877455
MWI,Machinga,2020,355116,284092,106535,0,0,745743,106535,0.142857525984153,0.0476191753280509,0.0158730584426836
MWI,Machinga,2021,571459,284092,106535,0,0,962086,106535,0.11073334400459,0.0369111146681967,0.0123037048893989
MWI,Machinga,2022,530641,338030,169015,0,0,1037686,169015,0.162876824010346,0.0542922746701154,0.0180974248900385
MWI,Mangochi,2017,844766,183202,50890,0,0,1078858,50890,0.0471702485405864,0.0157234161801955,0.00524113872673183
MWI,Mangochi,2018,577003,305472,311129,33942,0,1227546,345071,0.281106369944589,0.102918885863883,0.0404508036539749
MWI,Mangochi,2019,627072,421652,108016,0,0,1156740,108016,0.0933796704531701,0.0311265568177234,0.0103755189392411
MWI,Mangochi,2020,432463,594087,162024,0,0,1188574,162024,0.136317974312075,0.0454393247706916,0.0151464415902305
MWI,Mangochi,2021,822079,594087,162024,0,0,1578190,162024,0.10266444471198,0.0342214815706601,0.0114071605235534
MWI,Mangochi,2022,848531,442658,261086,0,0,1552275,261086,0.168195712744198,0.0560652375813994,0.0186884125271331
MWI,Mchinji,2017,542861,182987,0,0,0,725848,0,0,0,0
MWI,Mchinji,2018,481741,229401,65544,16386,0,793072,81930,0.103307139830936,0.0413228559323744,0.0183657137477219
MWI,Mchinji,2019,488150,114859,57429,0,0,660438,57429,0.0869559292469543,0.0289853097489848,0.00966176991632826
MWI,Mchinji,2020,373291,201003,57429,0,0,631723,57429,0.0909085152828059,0.030302838427602,0.010100946142534
MWI,Mchinji,2021,547788,201003,57429,0,0,806220,57429,0.0712324179504354,0.0237441393168118,0.00791471310560393
MWI,Mchinji,2022,483343,230465,98771,0,0,812579,98771,0.121552489050295,0.0405174963500985,0.0135058321166995
MWI,Mulanje,2017,370041,165095,102473,0,0,637609,102473,0.160714481759197,0.0535714939197324,0.0178571646399108
MWI,Mulanje,2018,271675,181116,150930,30186,0,633907,181116,0.285713834994723,0.111110935831281,0.0476189724991205
MWI,Mulanje,2019,475221,200798,100399,0,0,776418,100399,0.129310500271761,0.043103500090587,0.014367833363529
MWI,Mulanje,2020,435061,200798,66933,0,0,702792,66933,0.095238705050712,0.031746235016904,0.010582078338968
MWI,Mulanje,2021,513148,219920,73307,0,0,806375,73307,0.0909093163850566,0.0303031054616855,0.0101010351538952
MWI,Mulanje,2022,439841,262276,219920,0,0,922037,219920,0.238515374111885,0.0795051247039616,0.0265017082346539
MWI,Mwanza,2017,52182,22111,22111,0,0,96404,22111,0.229357702999876,0.0764525676666252,0.0254841892222084
MWI,Mwanza,2018,27635,68535,24319,8291,0,128780,32610,0.253222550085417,0.105867888388466,0.0495962105917068
MWI,Mwanza,2019,73392,39519,16937,0,0,129848,16937,0.130437126486353,0.0434790421621178,0.0144930140540393
MWI,Mwanza,2020,67746,45164,16937,0,0,129847,16937,0.130438131031137,0.0434793770103789,0.0144931256701263
MWI,Mwanza,2021,100505,45164,16937,0,0,162606,16937,0.104159748102776,0.0347199160342587,0.0115733053447529
MWI,Mwanza,2022,93326,51792,36994,0,0,182112,36994,0.20313872781585,0.0677129092719499,0.0225709697573166
MWI,Mzimba,2017,783378,119811,36865,0,0,940054,36865,0.0392158322819753,0.0130719440939918,0.00435731469799725
MWI,Mzimba,2018,686262,245094,122547,24510,0,1078413,147057,0.136364268605812,0.0530307034503479,0.0227275326490562
MWI,Mzimba,2019,776975,228522,91409,0,0,1096906,91409,0.0833334852758577,0.0277778284252859,0.00925927614176197
MWI,Mzimba,2020,594157,274226,137113,0,0,1005496,137113,0.136363545951451,0.0454545153171503,0.0151515051057168
MWI,Mzimba,2021,838350,274226,137113,0,0,1249689,137113,0.109717697763203,0.0365725659210678,0.0121908553070226
MWI,Mzimba,2022,739721,400772,100193,0,0,1240686,100193,0.0807561300764255,0.0269187100254752,0.00897290334182505
MWI,Mzuzu City,2020,153133,91880,61253,0,0,306266,61253,0.199999346972893,0.0666664489909643,0.0222221496636548
MWI,Mzuzu City,2021,122506,107193,61253,15313,0,306265,76566,0.249999183713451,0.0999994558089672,0.0444440816504226
MWI,Mzuzu city,2020,229699,122506,61253,0,0,413458,61253,0.148148058569431,0.0493826861898105,0.0164608953966035
MWI,Mzuzu city,2021,175404,75173,25058,0,0,275635,25058,0.0909100803598962,0.0303033601199654,0.0101011200399885
MWI,Mzuzu city,2022,162875,91552,52316,0,0,306743,52316,0.170553199258011,0.0568510664193369,0.0189503554731123
MWI,Neno,2017,130540,31003,17949,0,0,179492,17949,0.0999988857442114,0.0333329619147372,0.0111109873049124
MWI,Neno,2018,54445,103446,49908,4537,0,212336,54445,0.256409652626027,0.0925922437394821,0.0356123209336984
MWI,Neno,2019,72084,54403,34002,0,0,160489,34002,0.211864987631551,0.0706216625438504,0.0235405541812835
MWI,Neno,2020,74804,40802,27202,0,0,142808,27202,0.190479524956585,0.0634931749855284,0.0211643916618428
MWI,Neno,2021,88363,66272,27202,0,0,181837,27202,0.149595516864005,0.0498651722880015,0.0166217240960005
MWI,Neno,2022,73636,58909,36818,0,0,169363,36818,0.217391047631419,0.0724636825438063,0.0241545608479354
MWI,Nkhata bay,2017,227073,35142,13516,0,0,275731,13516,0.0490187900526238,0.0163395966842079,0.00544653222806931
MWI,Nkhata bay,2018,259307,44453,7409,0,0,311169,7409,0.0238102124568964,0.00793673748563214,0.00264557916187738
MWI,Nkhata bay,2019,221734,67602,27041,0,0,316377,27041,0.0854708148822449,0.028490271627415,0.00949675720913832
MWI,Nkhata bay,2020,216326,54081,27041,0,0,297448,27041,0.0909100077996826,0.0303033359332275,0.0101011119777425
MWI,Nkhata bay,2021,254569,54081,27041,0,0,335691,27041,0.0805532468847839,0.026851082294928,0.00895036076497599
MWI,Nkhata bay,2022,254569,106595,45683,0,0,406847,45683,0.112285453745511,0.0374284845818371,0.012476161527279
MWI,Nkhotakota,2017,313859,51694,11077,0,0,376630,11077,0.029410827602687,0.00980360920089566,0.00326786973363189
MWI,Nkhotakota,2018,237732,145976,62561,10427,0,456696,72988,0.159817471578468,0.0608829505841961,0.0253679569000921
MWI,Nkhotakota,2019,306371,91182,36473,0,0,434026,36473,0.0840341362038219,0.0280113787346073,0.0093371262448691
MWI,Nkhotakota,2020,200600,145891,36473,0,0,382964,36473,0.0952387169551185,0.0317462389850395,0.0105820796616798
MWI,Nkhotakota,2021,356655,145891,41959,0,0,544505,41959,0.077058980174654,0.0256863267248847,0.0085621089082949
MWI,Nkhotakota,2022,293716,149924,85671,0,0,529311,85671,0.161853806174442,0.053951268724814,0.0179837562416047
MWI,Nsanje,2017,172038,64514,67202,0,0,303754,67202,0.221238238838007,0.073746079612669,0.0245820265375563
MWI,Nsanje,2018,155714,77857,93428,15572,0,342571,109000,0.318182216241305,0.121212828873431,0.0505056697086962
MWI,Nsanje,2019,138885,98037,62635,13616,0,313173,76251,0.243478843961644,0.0956521368913242,0.0415457271220699
MWI,Nsanje,2020,163394,68081,54465,0,0,285940,54465,0.19047702315171,0.0634923410505701,0.0211641136835234
MWI,Nsanje,2021,189674,94837,63225,0,0,347736,63225,0.181818966112223,0.0606063220374077,0.0202021073458026
MWI,Nsanje,2022,158062,112537,112537,0,0,383136,112537,0.293725987638854,0.0979086625462847,0.0326362208487616
MWI,Ntcheu,2017,494635,116385,29096,0,0,640116,29096,0.0454542614151185,0.0151514204717062,0.00505047349056872
MWI,Ntcheu,2018,310036,248029,124015,0,0,682080,124015,0.181818848228947,0.0606062827429823,0.0202020942476608
MWI,Ntcheu,2019,542612,127673,63837,0,0,734122,63837,0.0869569363130379,0.0289856454376793,0.00966188181255976
MWI,Ntcheu,2020,414939,223428,63837,0,0,702204,63837,0.0909094792966147,0.0303031597655382,0.0101010532551794
MWI,Ntcheu,2021,501502,223428,71643,0,0,796573,71643,0.0899390263039295,0.0299796754346432,0.00999322514488105
MWI,Ntcheu,2022,465681,294376,147188,0,0,907245,147188,0.162236220646022,0.0540787402153406,0.0180262467384469
MWI,Ntchisi,2017,267896,71249,0,0,0,339145,0,0,0,0
MWI,Ntchisi,2018,180059,110563,47384,7898,0,345904,55282,0.159818909292752,0.0608839446782922,0.0253686315021252
MWI,Ntchisi,2019,261555,76928,46157,0,0,384640,46157,0.120000519966722,0.0400001733222407,0.0133333911074136
MWI,Ntchisi,2020,184627,107699,46157,0,0,338483,46157,0.136364307808664,0.0454547692695547,0.0151515897565182
MWI,Ntchisi,2021,294231,107699,46157,0,0,448087,46157,0.103009013874538,0.0343363379581793,0.0114454459860598
MWI,Ntchisi,2022,259616,142493,51923,0,0,454032,51923,0.114359780808401,0.0381199269361337,0.0127066423120446
MWI,Phalombe,2017,285857,57944,57944,0,0,401745,57944,0.144230793164818,0.0480769310549395,0.0160256436849798
MWI,Phalombe,2018,210056,121186,100989,12119,0,444350,113108,0.254547091256892,0.0939402122951127,0.0373741920158034
MWI,Phalombe,2019,292014,190444,63481,0,0,545939,63481,0.116278558593543,0.0387595195311808,0.0129198398437269
MWI,Phalombe,2020,190444,211604,63481,0,0,465529,63481,0.13636314816048,0.0454543827201599,0.01515146090672
MWI,Phalombe,2021,325914,211604,46559,21160,0,605237,67719,0.111888400742189,0.0489499705624959,0.0240858815086762
MWI,Phalombe,2022,279355,167275,95586,0,0,542216,95586,0.176287678711067,0.0587625595703557,0.0195875198567852
MWI,Rumphi,2017,171471,17537,7794,0,0,196802,7794,0.0396032560644709,0.0132010853548236,0.00440036178494121
MWI,Rumphi,2018,186386,36148,5648,0,0,228182,5648,0.0247521715122139,0.00825072383740465,0.00275024127913488
MWI,Rumphi,2019,173715,41361,20680,0,0,235756,20680,0.0877178099390896,0.0292392699796965,0.00974642332656551
MWI,Rumphi,2020,144762,72381,31020,0,0,248163,31020,0.124998488896411,0.0416661629654703,0.0138887209884901
MWI,Rumphi,2021,219430,72381,31020,0,0,322831,31020,0.0960874265482559,0.032029142182752,0.010676380727584
MWI,Rumphi,2022,207239,73143,36572,0,0,316954,36572,0.115385828858446,0.0384619429528154,0.0128206476509385
MWI,Salima,2017,342156,122199,0,0,0,464355,0,0,0,0
MWI,Salima,2018,229179,160425,114589,34377,0,538570,148966,0.276595428635089,0.113475190473538,0.0520095396657403
MWI,Salima,2019,352481,108791,65274,0,0,526546,65274,0.123966377106654,0.0413221257022178,0.0137740419007393
MWI,Salima,2020,282855,108791,65274,0,0,456920,65274,0.142856517552307,0.0476188391841023,0.0158729463947008
MWI,Salima,2021,416949,108791,65274,0,0,591014,65274,0.110444084234891,0.0368146947449637,0.0122715649149879
MWI,Salima,2022,364830,133995,107196,0,0,606021,107196,0.176884959432099,0.058961653144033,0.0196538843813443
MWI,Thyolo,2017,449245,186116,89849,0,0,725210,89849,0.12389376870148,0.0412979229004932,0.0137659743001644
MWI,Thyolo,2018,300983,408230,103788,17298,0,830299,121086,0.145834211531027,0.0555558901070578,0.0231482875446074
MWI,Thyolo,2019,504729,280405,105152,0,0,890286,105152,0.118110360041605,0.0393701200138682,0.0131233733379561
MWI,Thyolo,2020,420608,210304,105152,0,0,736064,105152,0.142857142857143,0.0476190476190476,0.0158730158730159
MWI,Thyolo,2021,607250,210304,105152,0,0,922706,105152,0.113960459778088,0.0379868199260292,0.0126622733086764
MWI,Thyolo,2022,569297,308344,154172,0,0,1031813,154172,0.149418547740724,0.0498061825802414,0.0166020608600805
MWI,Zomba,2017,530983,117996,78664,0,0,727643,78664,0.108107959535102,0.0360359865117006,0.0120119955039002
MWI,Zomba,2018,401716,209591,174659,20959,0,806925,195618,0.242424017101961,0.0894659768049488,0.035593973004513
MWI,Zomba,2019,515240,298690,112009,0,0,925939,112009,0.120968011931672,0.0403226706438905,0.0134408902146302
MWI,Zomba,2020,298690,373362,112009,0,0,784061,112009,0.142857507260277,0.047619169086759,0.015873056362253
MWI,Zomba,2021,517106,373362,112009,0,0,1002477,112009,0.111732239243394,0.037244079747798,0.012414693249266
MWI,Zomba,2022,437551,325726,162863,0,0,926140,162863,0.175851383160213,0.0586171277200711,0.019539042573357
MWI,Zomba City,2020,73890,73890,36945,0,0,184725,36945,0.2,0.0666666666666667,0.0222222222222222
MWI,Zomba City,2021,64653,73890,36945,9236,0,184724,46181,0.25,0.0999996391012177,0.0444440835456621
MWI,Zomba city,2020,83126,73890,36945,0,0,193961,36945,0.190476435984554,0.0634921453281845,0.0211640484427282
MWI,Zomba city,2021,61667,33636,16818,0,0,112121,16818,0.149998662159631,0.0499995540532104,0.0166665180177368
MWI,Zomba city,2022,57232,45786,22893,0,0,125911,22893,0.181818903828895,0.0606063012762983,0.0202021004254328
NAM,Erongo,2019,68478,97826,29348,0,0,195652,29348,0.150001022223131,0.0500003407410436,0.0166667802470145
NAM,Erongo,2020,70805,97826,40460,0,0,209091,40460,0.193504263693798,0.0645014212312661,0.0215004737437554
NAM,Erongo,2021,86280,75495,43140,10785,0,215700,53925,0.25,0.1,0.0444444444444444
NAM,Erongo,2022,86280,75495,43140,10785,0,215700,53925,0.25,0.1,0.0444444444444444
NAM,Hardap,2019,45163,27098,18065,0,0,90326,18065,0.199997785798109,0.0666659285993697,0.0222219761997899
NAM,Hardap,2020,49679,32165,18065,0,0,99909,18065,0.180814541232522,0.0602715137441739,0.0200905045813913
NAM,Hardap,2021,47525,33267,14257,0,0,95049,14257,0.149996317688771,0.0499987725629237,0.0166662575209746
NAM,Hardap,2022,42772,33267,19010,0,0,95049,19010,0.200002104177845,0.0666673680592817,0.0222224560197606
NAM,Karas,2019,44579,31205,13374,0,0,89158,13374,0.150003364813029,0.0500011216043429,0.016667040534781
NAM,Karas,2020,49036,36360,13374,0,0,98770,13374,0.135405487496203,0.0451351624987344,0.0150450541662448
NAM,Kavango East,2019,91953,45977,15326,0,0,153256,15326,0.100002610012006,0.0333342033373354,0.0111114011124451
NAM,Kavango East,2020,99616,62280,23355,0,0,185251,23355,0.126072193942273,0.0420240646474243,0.0140080215491414
NAM,Kavango East,2021,40168,56235,56235,8034,0,160672,64269,0.400001244771958,0.150001244771958,0.0611120792670783
NAM,Kavango East,2022,32134,48201,64268,16067,0,160670,80335,0.5,0.2,0.0888888888888889
NAM,Kavango west,2019,45257,27154,18103,0,0,90514,18103,0.200002209602934,0.0666674032009781,0.0222224677336594
NAM,Kavango west,2020,50105,31680,18220,0,0,100005,18220,0.182190890455477,0.0607302968184924,0.0202434322728308
NAM,Kavango west,2021,36896,27672,23060,4612,0,92240,27672,0.3,0.116666666666667,0.05
NAM,Kavango west,2022,36896,27672,23060,4612,0,92240,27672,0.3,0.116666666666667,0.05
NAM,Kharas,2021,37718,33003,14144,9429,0,94294,23573,0.24999469743568,0.116663485128075,0.0611091079201457
NAM,Kharas,2022,37718,28288,18859,9429,0,94294,28288,0.299997878974272,0.133331212307605,0.0666650169799893
NAM,Khomas,2019,223818,134291,89527,0,0,447636,89527,0.19999955320841,0.0666665177361368,0.0222221725787123
NAM,Khomas,2020,223818,162330,139140,0,0,525288,139140,0.264883264038013,0.0882944213460045,0.0294314737820015
NAM,Khomas Region,2021,173791,198618,99309,24827,0,496545,124136,0.24999949652096,0.0999996643473066,0.0444442206759821
NAM,Khomas Region,2022,148964,223446,99309,24827,0,496546,124136,0.249998993043948,0.099999462956772,0.0444441311692281
NAM,Kunene,2019,40994,40994,20497,0,0,102485,20497,0.2,0.0666666666666667,0.0222222222222222
NAM,Kunene,2020,52450,40994,20980,10490,0,124914,31470,0.25193333013113,0.111970368947169,0.0559851844735845
NAM,Kunene,2021,43869,32902,27418,5484,0,109673,32902,0.300000911801446,0.116668034368836,0.0500011650796256
NAM,Kunene,2022,32902,38385,32902,5484,0,109673,38386,0.350004103106508,0.133335764803856,0.0555570752246324
NAM,Ohangwena,2019,91067,117086,52038,0,0,260191,52038,0.199999231333905,0.0666664104446349,0.0222221368148783
NAM,Ohangwena,2020,131350,104076,52540,0,0,287966,52540,0.182452095038998,0.0608173650129992,0.0202724550043331
NAM,Ohangwena,2021,80351,80351,93742,13392,0,267836,107134,0.399998506548784,0.149999751091464,0.0611111940806231
NAM,Ohangwena,2022,80351,53567,120526,13392,0,267836,133918,0.5,0.183333582241869,0.0722224711307583
NAM,Omaheke,2019,34080,22720,18934,0,0,75734,18934,0.250006602054559,0.0833355340181865,0.0277785113393955
NAM,Omaheke,2020,45720,26507,15240,3810,0,91277,19050,0.208705369370159,0.0834821477480636,0.0371031767769172
NAM,Omaheke,2021,38606,19303,15442,3861,0,77212,19303,0.25,0.100001726847295,0.0444461712917393
NAM,Omaheke,2022,38606,15442,15442,7721,0,77211,23163,0.299996114543265,0.133331606463673,0.0666658032318366
NAM,Omusati,2019,126466,75879,50586,0,0,252931,50586,0.199999209270513,0.0666664030901708,0.0222221343633903
NAM,Omusati,2020,203600,101172,12725,0,0,317497,12725,0.040079118857816,0.0133597062859387,0.00445323542864622
NAM,Omusati,2021,128937,77362,51575,0,0,257874,51575,0.200000775572566,0.0666669251908555,0.0222223083969518
NAM,Omusati,2022,116043,77362,64469,0,0,257874,64469,0.250001938931416,0.0833339796438054,0.0277779932146018
NAM,Oshana,2019,87560,77831,29187,0,0,194578,29187,0.150001541798148,0.0500005139327159,0.016666837977572
NAM,Oshana,2020,118380,59190,29187,0,0,206757,29187,0.141165716275628,0.0470552387585426,0.0156850795861809
NAM,Oshana,2021,81062,101328,20266,0,0,202656,20266,0.100001973788094,0.033333991262698,0.0111113304208993
NAM,Oshana,2022,121594,40531,40531,0,0,202656,40531,0.199999013105953,0.0666663377019843,0.0222221125673281
NAM,Oshikoto,2019,110377,60206,30103,0,0,200686,30103,0.150000498290862,0.0500001660969541,0.016666722032318
NAM,Oshikoto,2020,122100,60206,40700,0,0,223006,40700,0.182506300278916,0.0608354334263054,0.0202784778087685
NAM,Oshikoto,2021,83708,62781,52318,10464,0,209271,62782,0.300003344945071,0.116668498422301,0.0500010884345073
NAM,Oshikoto,2022,73245,62781,52318,20927,0,209271,73245,0.350000716773944,0.150000079641549,0.0722221425806729
NAM,Otjozondjupa,2019,79119,55383,23736,0,0,158238,23736,0.15000189587836,0.0500006319594535,0.0166668773198178
NAM,Otjozondjupa,2020,88055,56035,40025,0,0,184115,40025,0.217391304347826,0.072463768115942,0.0241545893719807
NAM,Otjozondjupa,2021,73699,65510,24566,0,0,163775,24566,0.149998473515494,0.0499994911718313,0.0166664970572771
NAM,Otjozondjupa,2022,73699,73699,16378,0,0,163776,16378,0.100002442360297,0.0333341474534323,0.0111113824844774
NAM,Zambezi,2019,46019,35792,20453,0,0,102264,20453,0.200001955722444,0.066667318574148,0.022222439524716
NAM,Zambezi,2020,57200,35792,20800,0,0,113792,20800,0.182789651293588,0.0609298837645294,0.0203099612548432
NAM,Zambezi,2021,42973,32230,21487,10743,0,107433,32230,0.300000930812693,0.133332712791538,0.0666658392776066
NAM,Zambezi,2022,42973,37602,21487,5372,0,107434,26859,0.250004654020143,0.100002482144076,0.0444458923618221
NER,Abala,2021,94267,62845,48181,4190,0,209483,52371,0.250001193414263,0.09000093881922,0.034445118060495
NER,Abala,2022,62845,83793,62845,48181,0,257664,111026,0.430894498261302,0.205962028067561,0.110207695120605
NER,Abala (accès limité),2020,120952,32254,36285,12095,0,201586,48380,0.239996825176352,0.0999986771568131,0.0466660493398461
NER,Abala (accès limité),2021,96761,42333,48381,14111,0,201586,62492,0.310001686625063,0.126667195803941,0.0577779321094829
NER,Abalak,2020,271522,70525,10579,0,0,352626,10579,0.0300006238904675,0.0100002079634892,0.00333340265449639
NER,Abalak,2021,270578,98735,18282,0,0,387595,18282,0.0471677911221765,0.0157225970407255,0.00524086568024183
NER,Abalak,2022,244983,164541,32908,0,0,442432,32908,0.0743797916968031,0.0247932638989344,0.00826442129964479
NER,Aderbissinat,2020,20983,18651,6994,0,0,46628,6994,0.149995710731749,0.0499985702439164,0.0166661900813055
NER,Aderbissinat,2021,35665,18651,7460,0,0,61776,7460,0.120758870758871,0.0402529569196236,0.0134176523065412
NER,Aderbissinat,2022,30363,19278,5783,0,0,55424,5783,0.104341079676674,0.0347803598922248,0.0115934532974083
NER,Aguié,2020,294143,56702,3544,0,0,354389,3544,0.0100003103933813,0.00333343679779376,0.00111114559926459
NER,Aguié,2021,303405,81509,11100,0,0,396014,11100,0.0280293120950269,0.00934310403167565,0.00311436801055855
NER,Aguié,2022,284905,96202,22200,0,0,403307,22200,0.0550449161556829,0.0183483053852276,0.00611610179507588
NER,Arlit,2020,72097,47141,19411,0,0,138649,19411,0.14000100974403,0.04666700324801,0.0155556677493367
NER,Arlit,2021,84553,40208,20797,1433,0,146991,22230,0.151233749005041,0.0536608817319881,0.0200533819530901
NER,Arlit,2022,81687,51592,31528,5732,0,170539,37260,0.218483748585368,0.0840316095829497,0.0354796654528681
NER,Ayerou,2021,14904,45539,20700,1656,0,82799,22356,0.270003260908948,0.0966678341525864,0.0366671095061535
NER,Ayerou,2022,37259,48023,24840,6624,0,116746,31464,0.269508163020575,0.108748907885495,0.048858204992034
NER,Ayerou (accès limité),2020,39839,19920,15139,4781,0,79679,19920,0.250003137589578,0.103335466894246,0.0477792140965625
NER,Ayerou (accès limité),2021,35855,20716,17529,5577,0,79677,23106,0.289995858277797,0.119996987838398,0.055553463776665
NER,Bagaroua,2020,51721,29839,16909,995,0,99464,17904,0.180004825866645,0.0633361484222097,0.0233350760073997
NER,Bagaroua,2021,46411,39785,23721,2063,0,111980,25784,0.230255402750491,0.0828927784723463,0.0317249111944593
NER,Bagaroua,2022,52599,41254,31972,4125,0,129950,36097,0.277776067718353,0.10317301526228,0.0414450002137574
NER,Balleyara,2020,113756,32929,2994,0,0,149679,2994,0.0200028060048504,0.00666760200161679,0.00222253400053893
NER,Balleyara,2021,106272,55995,20220,0,0,182487,20220,0.110802413322593,0.0369341377741976,0.0123113792580659
NER,Balleyara,2022,91770,66883,35775,3111,0,197539,38886,0.196852267147247,0.0708670186646688,0.027122070409725
NER,Banibangou,2021,32076,35964,24300,4860,0,97200,29160,0.3,0.116666666666667,0.05
NER,Banibangou,2022,39852,43740,34992,9720,0,128304,44712,0.348484848484849,0.141414141414141,0.063973063973064
NER,Banibangou (accès limité),2020,52380,14966,21513,4677,0,93536,26190,0.279999144714335,0.110000427642833,0.0477783954840917
NER,Banibangou (accès limité),2021,46768,18707,22449,5612,0,93536,28061,0.300002138214164,0.120000142547611,0.0533330007222412
NER,Bankilaré,2021,57928,35743,25883,3698,0,123252,29581,0.240004218998475,0.0900025963067536,0.0366683254182037
NER,Bankilaré,2022,61626,35743,38208,6163,0,141740,44371,0.313045011993791,0.118842011194205,0.0492764529733628
NER,Bankilaré (accès limité),2020,72350,26093,20163,0,0,118606,20163,0.169999831374467,0.0566666104581556,0.0188888701527185
NER,Bankilaré (accès limité),2021,53373,35582,27279,2372,0,118606,29651,0.249995784361668,0.0899982575361561,0.0344436387891188
NER,Belbedji,2020,107250,27500,2750,0,0,137500,2750,0.02,0.00666666666666667,0.00222222222222222
NER,Belbedji,2021,107250,45872,7168,0,0,160290,7168,0.0447189469087279,0.0149063156362426,0.00496877187874755
NER,Belbedji,2022,91745,57340,21503,0,0,170588,21503,0.12605224283068,0.0420174142768933,0.0140058047589644
NER,Bermo,2020,57986,15814,1506,0,0,75306,1506,0.019998406501474,0.00666613550049133,0.00222204516683044
NER,Bermo,2021,54221,23588,18084,1573,0,97466,19657,0.20168058605052,0.0726065157764417,0.027788607765215
NER,Bermo,2022,35382,28305,23588,2359,0,89634,25947,0.289477207309726,0.10526511517207,0.0409368468810199
NER,Bilma,2020,17284,5209,1184,0,0,23677,1184,0.0500063352620687,0.0166687784206896,0.00555625947356319
NER,Bilma,2021,17758,6118,2937,0,0,26813,2937,0.109536418901279,0.0365121396337597,0.0121707132112532
NER,Bilma,2022,12236,11013,5384,734,0,29367,6118,0.208329076854973,0.0777743725950897,0.0314790221828735
NER,Birni n'konni,2020,387429,30133,12914,0,0,430476,12914,0.0299993495572343,0.00999978318574477,0.00333326106191492
NER,Birni n'konni,2021,321388,102666,30133,0,0,454187,30133,0.0663449196035994,0.0221149732011998,0.00737165773373327
NER,Birni n'konni,2022,366025,111593,35710,0,0,513328,35710,0.0695656578250164,0.0231885526083388,0.00772951753611293
NER,Boboye,2020,313621,31714,7048,0,0,352383,7048,0.0200009648592583,0.00666698828641942,0.00222232942880647
NER,Boboye,2021,296409,59905,14095,0,0,370409,14095,0.0380525311210041,0.0126841770403347,0.0042280590134449
NER,Boboye,2022,267134,120759,54891,3659,0,446443,58550,0.131147761304355,0.0464478854710082,0.017303938514485
NER,Bosso,2021,40864,30386,27243,6287,0,104780,33530,0.320003817522428,0.126668575427881,0.0555566159784522
NER,Bosso,2022,30386,39816,31434,9430,0,111066,40864,0.367925377703348,0.150943282972887,0.0691820879276986
NER,Bosso (accès limité),2020,8662,3248,2784,773,0,15467,3557,0.229973491950605,0.0933169543759833,0.0422117339425156
NER,Bosso (accès limité),2021,8043,3403,3094,928,0,15468,4022,0.260020687871735,0.1066718386346,0.0488894635519926
NER,Bouza,2020,466839,106368,17728,0,0,590935,17728,0.0299999153883253,0.00999997179610843,0.00333332393203614
NER,Bouza,2021,419565,222379,95305,12707,0,749956,108012,0.144024449434367,0.0536560367097092,0.0216506035020721
NER,Bouza,2022,311330,254147,190610,31768,0,787855,222378,0.282257522005953,0.107526554167116,0.0448026603880156
NER,Dakoro,2020,771972,127148,9082,0,0,908202,9082,0.00999997797846735,0.00333332599282245,0.00111110866427415
NER,Dakoro,2021,708398,199127,104305,9482,0,1021312,113787,0.111412575197393,0.0402322372268872,0.0154738871830221
NER,Dakoro,2022,578417,284467,218092,28447,0,1109423,246539,0.222222722983028,0.0826213265814752,0.0332384992519134
NER,Damagaram takaya,2020,278484,58447,6876,0,0,343807,6876,0.0199995927947948,0.00666653093159825,0.00222217697719942
NER,Damagaram takaya,2021,275996,85952,25091,0,0,387039,25091,0.0648280922594364,0.0216093640864788,0.0072031213621596
NER,Damagaram takaya,2022,243736,121868,96778,7169,0,469551,103947,0.22137531386367,0.0788810303176155,0.0296865161256889
NER,Diffa,2021,60644,42310,33848,4231,0,141033,38079,0.270000638148518,0.100000236351303,0.0400000945405212
NER,Diffa,2022,53593,49362,38079,7052,0,148086,45131,0.304762097699985,0.117461024899946,0.0497361142999488
NER,Diffa (accès limité),2020,178075,89037,29679,0,0,296791,29679,0.0999996630625592,0.0333332210208531,0.0111110736736177
NER,Diffa (accès limité),2021,130588,103877,59358,2968,0,296791,62326,0.209999629368815,0.0733333108708373,0.0266667265666562
NER,Dioundiou,2020,68857,8510,0,0,0,77367,0,0,0,0
NER,Dioundiou,2021,136567,19056,3176,0,0,158799,3176,0.0200001259453775,0.00666670864845916,0.00222223621615305
NER,Dioundiou,2022,119099,41288,11116,0,0,171503,11116,0.0648151927371533,0.0216050642457178,0.00720168808190592
NER,Dogondoutchi,2021,275197,167277,97128,0,0,539602,97128,0.179999332841613,0.059999777613871,0.0199999258712903
NER,Dogondoutchi,2022,323761,183465,129504,16188,0,652918,145692,0.223139812350096,0.08264437494448,0.033057749977792
NER,Dogondoutchi (accessibles),2020,313798,52300,7471,0,0,373569,7471,0.0199989827849741,0.00666632759499138,0.00222210919833046
NER,Dogondoutchi (accessibles),2021,283912,74714,14943,0,0,373569,14943,0.0400006424515953,0.0133335474838651,0.00444451582795503
NER,Dogondoutchi (accès limité),2020,99312,36512,10223,0,0,146047,10223,0.0699980143378502,0.02333267144595,0.00777755714865002
NER,Dogondoutchi (accès limité),2021,54037,61340,30670,0,0,146047,30670,0.210000890124412,0.0700002967081374,0.0233334322360458
NER,Dosso,2020,648289,99150,15254,0,0,762693,15254,0.0200001835600956,0.0066667278533652,0.0022222426177884
NER,Dosso,2021,541512,190673,30508,0,0,762693,30508,0.0400003671201912,0.0133334557067304,0.0044444852355768
NER,Dosso,2022,426645,227934,99356,5844,0,759779,105200,0.138461315724704,0.0487176753591066,0.0179484940869501
NER,Dungass,2020,474199,25223,5045,0,0,504467,5045,0.0100006541557723,0.00333355138525744,0.00111118379508581
NER,Dungass,2021,443931,84149,31556,0,0,559636,31556,0.0563866513233602,0.0187955504411201,0.00626518348037335
NER,Dungass,2022,368153,168298,63112,10519,0,610082,73631,0.120690333430588,0.0459774259853594,0.0191573518896731
NER,Falmey,2020,121016,20169,2881,0,0,144066,2881,0.0199977787958297,0.00666592626527656,0.00222197542175885
NER,Falmey,2021,122679,27373,7203,0,0,157255,7203,0.0458045849098598,0.0152681949699533,0.00508939832331775
NER,Falmey,2022,124175,49371,23937,0,0,197483,23937,0.12121043330312,0.0404034777677066,0.0134678259225689
NER,Filingué,2020,321400,98563,8571,0,0,428534,8571,0.0200007467318813,0.00666691557729375,0.00222230519243125
NER,Filingué,2021,236019,133595,81421,8571,0,459606,89992,0.195802491699412,0.0714836911035394,0.0279720262814478
NER,Filingué,2022,236019,133595,111329,13360,0,494303,124689,0.252252161123845,0.0930933725535417,0.0370373367482428
NER,Gaya,2020,321196,40150,3650,0,0,364996,3650,0.0100001095902421,0.00333336986341403,0.00111112328780468
NER,Gaya,2021,310809,60646,7581,0,0,379036,7581,0.0200007387161114,0.00666691290537047,0.00222230430179016
NER,Gaya,2022,322180,125082,26532,0,0,473794,26532,0.0559990206714311,0.0186663402238104,0.00622211340793678
NER,Gazaoua,2020,194269,34691,2313,0,0,231273,2313,0.0100011674514535,0.00333372248381783,0.00111124082793928
NER,Gazaoua,2021,195586,39316,7244,0,0,242146,7244,0.029915835900655,0.00997194530021832,0.00332398176673944
NER,Gazaoua,2022,173854,79683,28976,0,0,282513,28976,0.102565191690294,0.034188397230098,0.0113961324100327
NER,Gothèye,2020,245839,57250,30309,3368,0,336766,33677,0.100001187768361,0.0366673991238229,0.0144449129530759
NER,Gothèye,2021,242472,104987,76990,0,0,424449,76990,0.181388105520333,0.0604627018401111,0.0201542339467037
NER,Gothèye,2022,157480,146982,80490,13998,0,398950,94488,0.236841709487404,0.0906429377114927,0.0380114467142917
NER,Goudoumaria,2020,92957,33199,6640,0,0,132796,6640,0.0500015060694599,0.01666716868982,0.00555572289660666
NER,Goudoumaria,2021,85133,46478,20597,0,0,152208,20597,0.135321402291601,0.0451071340972003,0.0150357113657334
NER,Goudoumaria,2022,81013,45313,32955,2746,0,162027,35701,0.220339819906559,0.0790958708528003,0.0301314664291205
NER,Gouré,2020,331806,88793,42060,4673,0,467332,46733,0.0999995720387219,0.0366662957668923,0.0144441686471764
NER,Gouré,2021,370285,98140,37387,4673,0,510485,42060,0.0823922348354996,0.0305154248737312,0.0122060393547313
NER,Gouré,2022,341052,151037,92571,9744,0,594404,102315,0.172130402890963,0.0628410979737687,0.0245898973313325
NER,Guidan roumdji (accessibles),2021,513965,94018,18804,0,0,626787,18804,0.0300006222209459,0.010000207406982,0.00333340246899399
NER,Guidan roumdji (accessibles),2022,438750,188036,43875,0,0,670661,43875,0.0654205328772659,0.021806844292422,0.00726894809747398
NER,Guidan roumdji (accès limité),2021,106223,37017,17704,0,0,160944,17704,0.110000994134606,0.0366669980448686,0.0122223326816229
NER,Guidan roumdji (accès limité),2022,90128,57940,37017,3219,0,188304,40236,0.213675758348203,0.0769234854278189,0.0294399835726626
NER,Guidan-Roumdji (accessibles),2020,387522,80340,4726,0,0,472588,4726,0.0100002539209629,0.00333341797365429,0.00111113932455143
NER,Guidan-Roumdji (accessibles),2021,368619,94518,9452,0,0,472589,9452,0.0200004655207802,0.00666682184026007,0.00222227394675336
NER,Guidan-Roumdji (accès limité),2020,193028,69704,5362,0,0,268094,5362,0.0200004476041985,0.00666681586806618,0.00222227195602206
NER,Guidan-Roumdji (accès limité),2021,144771,67024,50938,5362,0,268095,56300,0.210000186501054,0.0766668531677204,0.0300001450563751
NER,Iferouane,2020,21173,13827,7778,432,0,43210,8210,0.190002314279102,0.0666666666666667,0.0244439301601995
NER,Iferouane,2021,28137,10272,7346,447,0,46202,7793,0.16867235184624,0.0594490858981574,0.0219663410434373
NER,Iferouane,2022,20991,19205,10272,1340,0,51808,11612,0.224135268684373,0.0833333333333333,0.0335254958479171
NER,Illéla,2020,324192,115783,23157,0,0,463132,23157,0.0500008636846515,0.0166669545615505,0.00555565152051683
NER,Illéla,2021,321756,162096,46313,0,0,530165,46313,0.087355823187121,0.0291186077290403,0.00970620257634678
NER,Illéla,2022,369779,168082,76837,0,0,614698,76837,0.12499959329622,0.0416665310987401,0.01388884369958
NER,Ingall,2020,45908,17130,5482,0,0,68520,5482,0.080005837711617,0.026668612570539,0.008889537523513
NER,Ingall,2021,51701,13704,6852,0,0,72257,6852,0.0948281827366207,0.0316093942455402,0.0105364647485134
NER,Ingall,2022,50285,21247,9207,0,0,80739,9207,0.114034109909709,0.038011369969903,0.0126704566566343
NER,Kantché,2020,466634,96741,5691,0,0,569066,5691,0.0100005974702407,0.00333353249008024,0.00111117749669341
NER,Kantché,2021,466634,148320,17798,0,0,632752,17798,0.0281279237363138,0.00937597457877125,0.00312532485959042
NER,Kantché,2022,421229,177984,41530,0,0,640743,41530,0.0648153783966427,0.0216051261322142,0.00720170871073807
NER,Keita,2020,215290,92797,59390,3712,0,371189,63102,0.169999649774104,0.0599999820396977,0.0222222820898967
NER,Keita,2021,254884,148476,96183,9618,0,509161,105801,0.207794783968136,0.0755615610779302,0.0293849424183444
NER,Keita,2022,226029,264502,110610,14427,0,615568,125037,0.203124593871026,0.075520494892522,0.0303816962545162
NER,Kollo,2020,445059,122977,17568,0,0,585604,17568,0.0299997950833669,0.00999993169445564,0.00333331056481855
NER,Kollo,2021,439203,250004,87839,0,0,777046,87839,0.113042213717077,0.0376807379056924,0.0125602459685641
NER,Kollo,2022,452710,256761,94596,0,0,804067,94596,0.117646912508535,0.0392156375028449,0.013071879167615
NER,Loga,2020,191014,36734,17142,0,0,244890,17142,0.0699987749601862,0.0233329249867287,0.00777764166224291
NER,Loga,2021,186116,76293,45776,0,0,308185,45776,0.148534159676818,0.0495113865589392,0.0165037955196464
NER,Loga,2022,162758,104267,53405,10172,0,330602,63577,0.192306761604588,0.0743582918433645,0.0316234559312339
NER,Madaoua,2020,517890,180136,52540,0,0,750566,52540,0.0700005062845906,0.0233335020948635,0.00777783403162117
NER,Madaoua,2021,607958,194570,70045,0,0,872573,70045,0.0802740859504019,0.026758028650134,0.00891934288337798
NER,Madaoua,2022,568144,249050,93394,0,0,910588,93394,0.102564496786692,0.0341881655955639,0.0113960551985213
NER,Madarounfa (accessibles),2020,256787,53236,3132,0,0,313155,3132,0.010001436988073,0.00333381232935767,0.00111127077645256
NER,Madarounfa (accessibles),2021,392303,71763,14353,0,0,478419,14353,0.0300008987937352,0.0100002995979117,0.00333343319930391
NER,Madarounfa (accessibles),2022,392303,110036,38273,0,0,540612,38273,0.070795690809675,0.023598563603225,0.00786618786774166
NER,Madarounfa (accès limité),2020,203429,60028,66698,3335,0,333490,70033,0.210000299859066,0.0733335332393775,0.0266667999373628
NER,Madarounfa (accès limité),2021,176750,83373,66698,6670,0,333491,73368,0.219999940028367,0.0800001599243558,0.0311112843624965
NER,Madarounfa (accès limité),2022,98361,68853,45246,3934,0,216394,49180,0.227270626727174,0.0818168094617534,0.0313122257446037
NER,Magaria,2020,691842,123543,8236,0,0,823621,8236,0.00999974502835649,0.0033332483427855,0.0011110827809285
NER,Magaria,2021,667133,188907,42933,0,0,898973,42933,0.0477578303241588,0.0159192767747196,0.0053064255915732
NER,Magaria,2022,566720,300533,111627,17173,0,996053,128800,0.129310388101838,0.0488504795092898,0.0201148377088814
NER,Malbaza,2020,249407,41568,28778,0,0,319753,28778,0.0900007193052137,0.0300002397684046,0.0100000799228015
NER,Malbaza,2021,265394,82890,19893,3316,0,371493,23209,0.0624749322329088,0.0238003587326455,0.00991704045866574
NER,Malbaza,2022,218828,99467,39787,6631,0,364713,46418,0.127272677420328,0.04848469892765,0.0202018817231327
NER,Mayahi,2020,602024,184621,16054,0,0,802699,16054,0.0200000249159398,0.00666667497197995,0.00222222499065998
NER,Mayahi,2021,687218,240809,24081,0,0,952108,24081,0.0252922987728283,0.00843076625760943,0.00281025541920314
NER,Mayahi,2022,653695,209518,33523,0,0,896736,33523,0.0373833547443172,0.0124611182481057,0.00415370608270191
NER,Maïné soroa,2020,126927,38252,8694,0,0,173873,8694,0.0500020129634848,0.016667337654495,0.00555577921816498
NER,Maïné soroa,2021,109668,52162,19776,0,0,181606,19776,0.108895080559012,0.0362983601863375,0.0120994533954458
NER,Maïné soroa,2022,102477,70116,39552,3596,0,215741,43148,0.199999072962487,0.0722224024795163,0.027778164043408
NER,Mirriah,2020,665473,105502,40578,0,0,811553,40578,0.0500004312718948,0.0166668104239649,0.00555560347465497
NER,Mirriah,2021,543072,243466,81155,0,0,867693,81155,0.0935296239568603,0.0311765413189534,0.0103921804396511
NER,Mirriah,2022,558158,226280,60341,0,0,844779,60341,0.0714281486637334,0.0238093828879111,0.00793646096263704
NER,N'gourti,2020,32814,20509,13672,1367,0,68362,15039,0.219990638073784,0.0799957091171509,0.03110890065631
NER,N'gourti,2021,40291,23927,15040,1367,0,80625,16407,0.203497674418605,0.0734842377260982,0.0282625322997416
NER,N'gourti,2022,38878,23327,15551,707,0,78463,16258,0.207205944203,0.0720721868906364,0.0260264215121919
NER,N'guigmi,2021,49093,27051,21040,3006,0,100190,24046,0.240003992414413,0.0900023289084074,0.0366681083718712
NER,N'guigmi,2022,42080,35067,27051,5010,0,109208,32061,0.293577393597539,0.11315105120504,0.0479116304055869
NER,N'guigmi (accès limité),2020,64920,11628,16472,3876,0,96896,20348,0.209998348745046,0.0833333333333333,0.0366670336122119
NER,N'guigmi (accès limité),2021,59107,14534,19379,3876,0,96896,23255,0.239999587186262,0.0933337461470718,0.0400005045501248
NER,Ouallam (accessibles),2020,144675,105492,51239,0,0,301406,51239,0.16999993364432,0.0566666445481068,0.0188888815160356
NER,Ouallam (accessibles),2021,87408,150703,105810,11757,0,355678,117567,0.33054335663156,0.121199511918083,0.0477454326666254
NER,Ouallam (accessibles),2022,108749,82296,129323,20574,0,340942,149897,0.439655425262948,0.166666666666667,0.0689654610526782
NER,Ouallam (accès limité),2020,76325,54518,24922,0,0,155765,24922,0.159997432029018,0.053332477343006,0.0177774924476687
NER,Ouallam (accès limité),2021,54518,63407,68842,18116,0,204883,86958,0.42442760014252,0.170949598876757,0.0766323544006417
NER,Ouallam (accès limité),2022,45291,72465,81523,39856,0,239135,121379,0.507575219018546,0.224747527547201,0.111953034431969
NER,Say,2020,203656,36805,4907,0,0,245368,4907,0.0199985328160151,0.00666617760533838,0.00222205920177946
NER,Say,2021,176666,66295,38247,0,0,281208,38247,0.136009644106853,0.0453365480356178,0.0151121826785393
NER,Say,2022,117291,86693,63745,7649,0,275378,71394,0.259258183297141,0.0956781829582126,0.0380652533366258
NER,Tahoua,2020,566814,120448,21256,0,0,708518,21256,0.0300006492425034,0.0100002164141678,0.00333340547138926
NER,Tahoua,2021,524303,155874,73926,12321,0,766424,86247,0.112531705687713,0.042869221214367,0.0178621755059862
NER,Tahoua,2022,338828,215618,154013,30803,0,739262,184816,0.250000676350198,0.0972226355473432,0.0416669296917436
NER,Takeita,2020,216307,39568,7914,0,0,263789,7914,0.0300012509998522,0.0100004169999507,0.00333347233331691
NER,Takeita,2021,300802,79137,18342,0,0,398281,18342,0.0460529123910003,0.0153509707970001,0.0051169902656667
NER,Takeita,2022,297134,77035,25678,0,0,399847,25678,0.0642195639832236,0.0214065213277412,0.00713550710924707
NER,Tanout,2020,428252,152947,30589,0,0,611788,30589,0.0499993461787417,0.0166664487262472,0.00555548290874907
NER,Tanout,2021,484744,214126,44647,0,0,743517,44647,0.0600483916305881,0.0200161305435294,0.00667204351450979
NER,Tanout,2022,452853,159455,63782,0,0,676090,63782,0.0943395110118475,0.0314465036706158,0.0104821678902053
NER,Tassara,2021,14305,12212,7676,698,0,34891,8374,0.240004585709782,0.0866699148777622,0.0333355624978106
NER,Tassara,2022,15701,17446,8025,1047,0,42219,9072,0.21487955659774,0.0798929391979914,0.0321419266207158
NER,Tassara (accès limité),2020,24227,6730,2692,0,0,33649,2692,0.080002377485215,0.0266674591617383,0.00888915305391278
NER,Tassara (accès limité),2021,22545,7739,3028,336,0,33648,3364,0.0999762244412744,0.0366539863686797,0.014437047603952
NER,Tchintabaraden,2020,151706,41919,5988,0,0,199613,5988,0.0299980462194346,0.00999934873981153,0.00333311624660385
NER,Tchintabaraden,2021,145717,51746,22768,4140,0,224371,26908,0.119926371946464,0.0461259847900724,0.0194756799130805
NER,Tchintabaraden,2022,120051,60025,45536,6210,0,231822,51746,0.223214362743829,0.0833340522757403,0.0337308605548893
NER,Tchirozerine,2020,235825,80762,6461,0,0,323048,6461,0.0200001238206087,0.0066667079402029,0.00222223598006763
NER,Tchirozerine,2021,242286,71071,20708,0,0,334065,20708,0.0619879364794277,0.0206626454931426,0.00688754849771418
NER,Tchirozerine,2022,84558,79381,37965,6903,0,208807,44868,0.214877853711801,0.0826456967438831,0.0348950625857051
NER,Tesker,2020,42877,8999,1059,0,0,52935,1059,0.0200056673278549,0.00666855577595164,0.00222285192531721
NER,Tesker,2021,45253,13234,2117,0,0,60604,2117,0.034931687677381,0.0116438958924603,0.00388129863082011
NER,Tesker,2022,41390,13245,4967,0,0,59602,4967,0.0833361296600785,0.0277787098866928,0.00925956996223095
NER,Tessaoua,2020,620699,128682,7570,0,0,756951,7570,0.0100006473338433,0.00333354911128109,0.0011111830370937
NER,Tessaoua,2021,651756,166529,23277,0,0,841562,23277,0.0276592811937801,0.00921976039792671,0.00307325346597557
NER,Tessaoua,2022,543130,232770,100867,0,0,876767,100867,0.115044247787611,0.0383480825958702,0.0127826941986234
NER,Tibiri,2020,312648,56503,7534,0,0,376685,7534,0.0200007964214131,0.00666693214047104,0.00222231071349035
NER,Tibiri,2021,297291,86058,18834,0,0,402183,18834,0.0468294283945368,0.0156098094648456,0.0052032698216152
NER,Tibiri,2022,301203,117352,35206,0,0,453761,35206,0.0775870998168639,0.0258623666056213,0.00862078886854044
NER,Tillabéri (accessibles),2020,163851,49586,2156,0,0,215593,2156,0.0100003246858664,0.00333344156195547,0.00111114718731849
NER,Tillabéri (accessibles),2021,159539,78258,57389,7826,0,303012,65215,0.215222499438966,0.0803499531371695,0.0325227310396215
NER,Tillabéri (accessibles),2022,148689,104343,70432,13043,0,336507,83475,0.248063190364539,0.0956077189082743,0.0404825654939323
NER,Tillabéri (accès limité),2020,27994,6024,1417,0,0,35435,1417,0.0399887117256949,0.0133295705752316,0.00444319019174388
NER,Tillabéri (accès limité),2021,24805,8859,6289,2012,0,41965,8301,0.197807696890266,0.0819174709082966,0.037960204932682
NER,Tillabéri (accès limité),2022,11320,9308,7547,3019,0,31194,10566,0.338718984420081,0.14516680558227,0.0698959201555855
NER,Tillia,2021,22808,20027,12239,556,0,55630,12795,0.230001797591228,0.0799988016058482,0.0288872910300198
NER,Tillia,2022,23365,20583,11682,5007,0,60637,16689,0.275227996107987,0.119267114138232,0.0581053372253465
NER,Tillia (accès limité),2020,38091,11266,4292,0,0,53649,4292,0.0800014911741132,0.0266671637247044,0.00888905457490147
NER,Tillia (accès limité),2021,35408,13412,4828,0,0,53648,4828,0.089994035192365,0.0299980117307884,0.00999933724359612
NER,Torodi,2021,79538,92794,79538,13256,0,265126,92794,0.349999622820847,0.133332830427797,0.0555551364676083
NER,Torodi,2022,87491,119306,95445,21210,0,323452,116655,0.360656295215364,0.142076722357568,0.0619308789763757
NER,Torodi (accès limité),2020,137771,58680,56129,2551,0,255131,58680,0.229999490457843,0.0799994251319257,0.028888427252405
NER,Torodi (accès limité),2021,127566,63783,61232,2551,0,255132,63783,0.25,0.0866662485824332,0.0311106930268776
NER,Téra,2022,175723,170842,126911,48812,0,522288,175723,0.336448472873204,0.14330216279141,0.0685358354862537
NER,Téra (accessibles),2020,282845,86739,7543,0,0,377127,7543,0.0200012197482546,0.00666707324941819,0.00222235774980606
NER,Téra (accessibles),2021,271531,111189,55595,0,0,438315,55595,0.126838004631372,0.0422793348771241,0.014093111625708
NER,Téra (accessibles),2022,192728,118602,59301,0,0,370631,59301,0.160000107924054,0.053333369308018,0.0177777897693393
NER,Téra (accès limité),2020,62965,21297,7408,926,0,92596,8334,0.0900038878569269,0.0333347732803433,0.0133339093121373
NER,Téra (accès limité),2021,46995,35246,29372,5874,0,117487,35246,0.299999148842,0.116665389929666,0.0499989124092216
NER,Téra (accès limité),2022,23498,46995,37596,9399,0,117488,46995,0.399998297698488,0.159999319079395,0.0711108084797313
NER,Ville d'agadez,2021,90353,61311,9681,0,0,161345,9681,0.0600018593696737,0.0200006197898912,0.00666687326329708
NER,Ville d'agadez,2022,119395,64538,19361,0,0,203294,19361,0.0952364555766525,0.0317454851922175,0.0105818283974058
NER,Ville de diffa,2021,53944,17724,5394,0,0,77062,5394,0.0699955879681296,0.0233318626560432,0.0077772875520144
NER,Ville de diffa,2022,47008,34678,14642,2312,0,98640,16954,0.171877534468775,0.0651054339010543,0.0269104262413265
NER,Ville de dosso,2021,98136,27116,3874,0,0,129126,3874,0.0300017037622168,0.0100005679207389,0.00333352264024631
NER,Ville de dosso,2022,92971,37447,11621,0,0,142039,11621,0.0818155576989419,0.027271852566314,0.00909061752210465
NER,Ville de maradi,2021,345697,48237,8039,0,0,401973,8039,0.0199988556445333,0.00666628521484445,0.00222209507161482
NER,Ville de maradi,2022,333637,100493,24118,0,0,458248,24118,0.0526308898238508,0.0175436299412836,0.00584787664709454
NER,Ville de niamey,2020,924154,285401,135905,13591,0,1359051,149496,0.110000286964948,0.0400002158368842,0.0155557076224513
NER,Ville de niamey,2021,980478,280136,163086,0,0,1423700,163086,0.11455081829037,0.0381836060967901,0.01272786869893
NER,Ville de niamey,2022,1022498,266130,168082,0,0,1456710,168082,0.115384668190649,0.0384615560635496,0.0128205186878499
NER,Ville de tahoua,2021,127967,63983,21328,0,0,213278,21328,0.100000937743227,0.0333336459144091,0.011111215304803
NER,Ville de tahoua,2022,106639,106639,36257,4266,0,253801,40523,0.159664461526944,0.0588243019793723,0.0233433105289402
NER,Ville de tillabéri,2021,27688,22843,15229,3461,0,69221,18690,0.270004767339391,0.10666801500508,0.0466669555963267
NER,Ville de tillabéri,2022,40148,27688,20766,4845,0,93447,25611,0.274069793572827,0.108639121641144,0.0477347230694048
NER,Ville de zinder,2021,359970,110391,9599,0,0,479960,9599,0.0199995832986082,0.00666652776620274,0.00222217592206758
NER,Ville de zinder,2022,326373,153587,67194,14399,0,561553,81593,0.145298840893023,0.0569800772737984,0.0246914459642377
NGA,Aba north,2021,101326,63798,22517,0,0,187641,22517,0.120000426346054,0.0400001421153515,0.0133333807051172
NGA,Aba north,2022,112585,73180,26270,0,0,212035,26270,0.123894640035843,0.041298213345281,0.0137660711150937
NGA,Aba south,2021,398611,250977,88580,0,0,738168,88580,0.119999783247174,0.039999927749058,0.013333309249686
NGA,Aba south,2022,442901,287886,103344,0,0,834131,103344,0.123894208463659,0.0412980694878862,0.0137660231626287
NGA,Abadam,2020,4235,14824,12706,10589,0,42354,23295,0.550007083156254,0.26667296280556,0.144449166548614
NGA,Abadam,2021,2118,10589,16942,12706,0,42355,29648,0.699988195018298,0.333325463345532,0.177772531119243
NGA,Abadam,2022,6747,17991,15742,9895,0,50375,25637,0.508923076923077,0.235116625310174,0.122022608216157
NGA,Abaji,2020,291992,148471,49490,4949,0,494902,54439,0.109999555467547,0.0399998383518353,0.0155554926923804
NGA,Abaji,2021,448970,173216,54439,4949,0,681574,59388,0.0871336054485647,0.0314649130786484,0.012101889645634
NGA,Abaji,2022,421924,140305,109126,0,0,671355,109126,0.162545895986475,0.054181965328825,0.0180606551096083
NGA,Abi,2021,192936,30965,14292,0,0,238193,14292,0.0600017632759989,0.0200005877586663,0.0066668625862221
NGA,Abi,2022,192936,61930,16674,0,0,271540,16674,0.0614053178168962,0.0204684392722987,0.00682281309076625
NGA,Abuja municipal,2020,820905,396299,183996,14154,0,1415354,198150,0.14000031087629,0.0500002119611066,0.0188890317663755
NGA,Abuja municipal,2021,881780,495034,254764,28307,0,1659885,283071,0.170536513071689,0.06253003471124,0.0246330318064203
NGA,Abuja municipal,2022,1248342,541444,185638,0,0,1975424,185638,0.0939737494330331,0.0313245831443444,0.0104415277147815
NGA,Ado,2020,244151,30870,5613,0,0,280634,5613,0.0200011402752339,0.00666704675841131,0.00222234891947044
NGA,Ado,2021,241369,38738,17879,0,0,297986,17879,0.0599994630620231,0.0199998210206744,0.00666660700689145
NGA,Ado,2022,241369,89396,29799,0,0,360564,29799,0.082645522015509,0.027548507338503,0.009182835779501
NGA,Agaie,2020,97056,78067,35869,0,0,210992,35869,0.170001706225828,0.0566672354086095,0.0188890784695365
NGA,Agaie,2021,183277,84397,37979,0,0,305653,37979,0.124255282951582,0.0414184276505274,0.0138061425501758
NGA,Agaie,2022,185459,32728,8727,0,0,226914,8727,0.0384595044818742,0.0128198348272914,0.0042732782757638
NGA,Agatu,2020,153063,19353,3519,0,0,175935,3519,0.0200017051752068,0.00666723505840225,0.00222241168613408
NGA,Agatu,2021,151319,24286,11209,0,0,186814,11209,0.0600008564668601,0.0200002854889534,0.00666676182965112
NGA,Agatu,2022,112088,56044,18681,0,0,186813,18681,0.0999983941160412,0.0333327980386804,0.0111109326795601
NGA,Agege,2021,1145717,427506,136802,0,0,1710025,136802,0.08,0.0266666666666667,0.00888888888888889
NGA,Agege,2022,1391881,513008,171003,0,0,2075892,171003,0.0823756727228584,0.0274585575742861,0.00915285252476205
NGA,Agwara,2020,48500,32028,10981,0,0,91509,10981,0.11999912576905,0.0399997085896833,0.0133332361965611
NGA,Agwara,2021,77596,39349,11896,0,0,128841,11896,0.092330857413401,0.0307769524711337,0.0102589841570446
NGA,Agwara,2022,70972,38798,13248,946,0,123964,14194,0.114500984156691,0.0407107439794349,0.0152660808335036
NGA,Ajeromi-ifelodun,2021,1591810,593959,190067,0,0,2375836,190067,0.0800000505085368,0.0266666835028456,0.00888889450094853
NGA,Ajeromi-ifelodun,2022,1933819,712751,237584,0,0,2884154,237584,0.082375629040613,0.0274585430135377,0.00915284767117922
NGA,Ajingi,2020,238624,32914,2743,0,0,274281,2743,0.0100006927202395,0.00333356424007982,0.00111118808002661
NGA,Ajingi,2021,237998,41142,5667,0,0,284807,5667,0.019897685099032,0.00663256169967733,0.00221085389989244
NGA,Ajingi,2022,249331,45333,11333,0,0,305997,11333,0.0370363108135047,0.0123454369378349,0.00411514564594497
NGA,Akamkpa,2021,205081,34592,7413,0,0,247086,7413,0.0300016998130206,0.0100005666043402,0.00333352220144673
NGA,Akamkpa,2022,202610,59300,19767,0,0,281677,19767,0.0701761237161714,0.0233920412387238,0.0077973470795746
NGA,Akko,2020,427409,61058,20353,0,0,508820,20353,0.0400003930663103,0.0133334643554368,0.00444448811847892
NGA,Akko,2021,417232,162822,50882,0,0,630936,50882,0.0806452635449554,0.0268817545149851,0.00896058483832838
NGA,Akko,2022,422321,178087,61058,0,0,661466,61058,0.0923070875902919,0.030769029196764,0.010256343065588
NGA,Akoko-edo,2021,314484,62120,11648,0,0,388252,11648,0.0300011332845678,0.0100003777615226,0.00333345925384086
NGA,Akoko-edo,2022,291189,143653,27178,0,0,462020,27178,0.0588242933206355,0.0196080977735452,0.00653603259118172
NGA,Akpabuyo,2021,372971,62911,13481,0,0,449363,13481,0.0300002447909597,0.0100000815969866,0.00333336053232885
NGA,Akpabuyo,2022,368478,107847,35949,0,0,512274,35949,0.0701753358554211,0.0233917786184737,0.00779725953949124
NGA,Albasu,2020,259401,35779,2982,0,0,298162,2982,0.0100012744749499,0.00333375815831662,0.00111125271943887
NGA,Albasu,2021,258721,44724,6160,0,0,309605,6160,0.019896319503884,0.00663210650129466,0.00221070216709822
NGA,Albasu,2022,271041,49280,12320,0,0,332641,12320,0.0370369256946678,0.0123456418982226,0.0041152139660742
NGA,Aleiro,2020,80017,18232,3039,0,0,101288,3039,0.0300035542216255,0.0100011847405418,0.00333372824684727
NGA,Aleiro,2021,87719,16206,6077,0,0,110002,6077,0.0552444501009073,0.0184148167003024,0.00613827223343414
NGA,Aleiro,2022,86674,16708,7310,0,0,110692,7310,0.0660390994832508,0.0220130331610836,0.0073376777203612
NGA,Alimosho,2021,2270247,847107,271074,0,0,3388428,271074,0.0799999291706951,0.0266666430568984,0.00888888101896612
NGA,Alimosho,2022,2758024,1016529,338843,0,0,4113396,338843,0.082375487310242,0.0274584957700807,0.00915283192336022
NGA,Alkaleri,2020,441898,73650,10521,0,0,526069,10521,0.0199992776612954,0.00666642588709846,0.00222214196236615
NGA,Alkaleri,2021,466183,78910,15782,0,0,560875,15782,0.0281381769556497,0.00937939231854988,0.0031264641061833
NGA,Alkaleri,2022,455341,81311,27104,0,0,563756,27104,0.0480775370905143,0.0160258456968381,0.00534194856561271
NGA,Amuwo-odofin,2021,582218,217246,69519,0,0,868983,69519,0.0800004142773794,0.0266668047591265,0.00888893491970882
NGA,Amuwo-odofin,2022,707311,260695,86898,0,0,1054904,86898,0.0823752682708569,0.0274584227569523,0.00915280758565076
NGA,Aninri,2021,178107,32188,4292,0,0,214587,4292,0.0200012116297819,0.00666707054326062,0.00222235684775354
NGA,Aninri,2022,173815,64376,21459,0,0,259650,21459,0.0826458694396303,0.0275486231465434,0.00918287438218114
NGA,Anka,2021,123622,68679,36629,0,0,228930,36629,0.160000873629494,0.0533336245431646,0.0177778748477215
NGA,Anka,2022,130490,80125,50364,4579,0,265558,54943,0.206896421873941,0.07471311979555,0.0287361371568965
NGA,Apa,2020,128147,16202,2946,0,0,147295,2946,0.0200006789096711,0.00666689296989036,0.00222229765663012
NGA,Apa,2021,126687,20333,9384,0,0,156404,9384,0.059998465512391,0.0199994885041303,0.00666649616804344
NGA,Apa,2022,124906,46921,15640,0,0,187467,15640,0.0834280166642662,0.0278093388880887,0.00926977962936292
NGA,Apapa,2021,510172,259410,95117,0,0,864699,95117,0.110000127211897,0.0366667090706323,0.0122222363568774
NGA,Apapa,2022,544626,302645,103764,0,0,951035,103764,0.109106394612186,0.0363687982040619,0.0121229327346873
NGA,Ardo-kola,2020,115629,17684,2721,0,0,136034,2721,0.0200023523530882,0.00666745078436273,0.00222248359478758
NGA,Ardo-kola,2021,114269,19045,6802,0,0,140116,6802,0.048545490878986,0.0161818302929953,0.00539394343099844
NGA,Ardo-kola,2022,112908,40810,17684,0,0,171402,17684,0.103172658428723,0.0343908861429077,0.0114636287143026
NGA,Arewa-dandi,2020,229189,48703,8595,0,0,286487,8595,0.0300013613183146,0.0100004537727715,0.00333348459092385
NGA,Arewa-dandi,2021,229189,67934,14768,0,0,311891,14768,0.0473498754372521,0.0157832918124174,0.00526109727080579
NGA,Arewa-dandi,2022,200850,82703,44305,0,0,327858,44305,0.13513472295933,0.04504490765311,0.0150149692177033
NGA,Argungu,2020,241897,51403,9071,0,0,302371,9071,0.0299995700645895,0.00999985668819651,0.00333328556273217
NGA,Argungu,2021,241897,71701,15587,0,0,329185,15587,0.0473502741619454,0.0157834247206485,0.00526114157354949
NGA,Argungu,2022,211987,87289,46762,0,0,346038,46762,0.135135447552003,0.045045149184001,0.0150150497280003
NGA,Arochukwu,2021,169362,95081,32684,0,0,297127,32684,0.110000100966927,0.0366667003223089,0.0122222334407696
NGA,Arochukwu,2022,181247,118851,38627,0,0,338725,38627,0.114036460255369,0.0380121534184565,0.0126707178061522
NGA,Askira/uba,2020,151772,133984,43968,5236,0,334960,49204,0.1468951516599,0.0541756229599554,0.0215322559244222
NGA,Askira/uba,2021,204547,117236,88560,13506,0,423849,102066,0.240807457372791,0.09089085971655,0.0373780914114854
NGA,Askira/uba,2022,146105,122728,78897,20455,0,368185,99352,0.269842606298464,0.108466305435221,0.0485012818133396
NGA,Augie,2020,140571,29871,5271,0,0,175713,5271,0.0299977804715644,0.00999926015718814,0.00333308671906271
NGA,Augie,2021,140571,41667,9058,0,0,191296,9058,0.0473507025761124,0.0157835675253708,0.0052611891751236
NGA,Augie,2022,123189,50725,27174,0,0,201088,27174,0.13513486632718,0.0450449554423934,0.0150149851474645
NGA,Auyo,2020,157585,28652,18419,0,0,204656,18419,0.0899998045500743,0.0299999348500248,0.00999997828334159
NGA,Auyo,2021,174790,30698,22512,0,0,228000,22512,0.0987368421052632,0.0329122807017544,0.0109707602339181
NGA,Auyo,2022,181108,29483,12635,0,0,223226,12635,0.056601829535986,0.0188672765119953,0.00628909217066511
NGA,Awgu,2021,263897,47692,6359,0,0,317948,6359,0.0200001258067357,0.00666670860224523,0.00222223620074841
NGA,Awgu,2022,257538,95384,31795,0,0,384717,31795,0.0826451651473681,0.027548388382456,0.00918279612748534
NGA,Babura,2020,266896,46130,16475,0,0,329501,16475,0.0499998482553922,0.0166666160851307,0.00555553869504358
NGA,Babura,2021,274636,46130,20343,0,0,341109,20343,0.0596378283774395,0.0198792761258132,0.00662642537527105
NGA,Babura,2022,250902,71202,47468,0,0,369572,47468,0.12844046626909,0.0428134887563632,0.0142711629187877
NGA,Badagry,2021,421904,157427,50377,0,0,629708,50377,0.0800005716935469,0.0266668572311823,0.00888895241039409
NGA,Badagry,2022,512552,188912,62971,0,0,764435,62971,0.0823758723763302,0.0274586241254434,0.00915287470848114
NGA,Bade,2020,182753,136092,69990,0,0,388835,69990,0.179999228464516,0.0599997428215053,0.0199999142738351
NGA,Bade,2021,330005,174975,116651,7777,0,629408,124428,0.197690528242412,0.0700155278187334,0.0260842993204196
NGA,Bade,2022,245491,144880,60367,12073,0,462811,72440,0.156521776707987,0.0608693397520802,0.026086722705861
NGA,Bagudo,2020,287518,61097,10782,0,0,359397,10782,0.0300002504194526,0.0100000834731509,0.00333336115771695
NGA,Bagudo,2021,287518,85224,18527,0,0,391269,18527,0.0473510551564269,0.0157836850521423,0.0052612283507141
NGA,Bagudo,2022,251966,103751,55581,0,0,411298,55581,0.13513559511595,0.0450451983719833,0.0150150661239944
NGA,Bagwai,2020,218177,35935,2567,0,0,256679,2567,0.0100008181425048,0.00333360604750161,0.00111120201583387
NGA,Bagwai,2021,214771,43635,7954,0,0,266360,7954,0.0298618411172849,0.00995394703909496,0.00331798234636499
NGA,Bagwai,2022,214771,108711,13257,0,0,336739,13257,0.0393687692842231,0.013122923094741,0.00437430769824701
NGA,Bakori,2020,113779,91023,22756,0,0,227558,22756,0.100000878896809,0.0333336262989362,0.0111112087663121
NGA,Bakori,2021,133599,102401,31858,0,0,267858,31858,0.118936152737645,0.0396453842458815,0.0132151280819605
NGA,Bakori,2022,98441,93754,82034,11719,0,285948,93753,0.327867304544882,0.122950093490192,0.0500906924802179
NGA,Bakura,2021,162395,90220,48117,0,0,300732,48117,0.159999600973624,0.0533332003245415,0.0177777334415138
NGA,Bakura,2022,171417,105256,66161,6015,0,348849,72176,0.206897540196475,0.0747133191342577,0.0287360879794855
NGA,Balanga,2020,259287,54418,6402,0,0,320107,6402,0.0199995626462402,0.00666652088208006,0.00222217362736002
NGA,Balanga,2021,249683,86429,35212,0,0,371324,35212,0.0948282362572848,0.0316094120857616,0.0105364706952539
NGA,Balanga,2022,259287,96032,41614,0,0,396933,41614,0.10483885189692,0.0349462839656399,0.01164876132188
NGA,Bali,2020,281361,31973,6395,0,0,319729,6395,0.0200013136124656,0.00666710453748852,0.00222236817916284
NGA,Bali,2021,274966,44762,12789,0,0,332517,12789,0.0384611914578804,0.0128203971526268,0.00427346571754226
NGA,Bali,2022,268572,41565,19184,0,0,329321,19184,0.0582531936924763,0.0194177312308254,0.00647257707694182
NGA,Bama,2020,70245,89751,87405,31322,0,278723,118727,0.425967717052414,0.179448173754349,0.0847886810760345
NGA,Bama,2021,56031,91984,115391,41244,0,304650,156635,0.514147382241917,0.216509655889272,0.102254682057735
NGA,Bama,2022,68483,89235,66408,31129,4150,259405,101687,0.392000925194194,0.181332922135914,0.0977767497842284
NGA,Barikin ladi,2020,207853,39972,18653,0,0,266478,18653,0.0699982737786984,0.0233327579262328,0.00777758597541094
NGA,Barikin ladi,2021,189199,86137,34993,0,0,310329,34993,0.112760973031847,0.0375869910106156,0.0125289970035385
NGA,Barikin ladi,2022,178943,107671,56527,2692,0,345833,59219,0.171235827697183,0.0596733105284921,0.0216209043735624
NGA,Bassa,2020,219442,42200,19694,0,0,281336,19694,0.0700017061449655,0.0233339020483218,0.00777796734944061
NGA,Bassa,2021,199749,56267,25320,0,0,281336,25320,0.0899991469275173,0.0299997156425058,0.00999990521416859
NGA,Bassa (1),2021,156220,90892,36925,0,0,284037,36925,0.130000668926936,0.0433335563089785,0.0144445187696595
NGA,Bassa (1),2022,169582,113614,59648,2840,0,345684,62488,0.180766248944122,0.0629939482301755,0.0228236706870372
NGA,Batagarawa,2020,140993,115096,31651,0,0,287740,31651,0.10999860985612,0.0366662032853734,0.0122220677617911
NGA,Batagarawa,2021,192642,129483,40284,2877,0,365286,43161,0.118156731985348,0.0420109174728843,0.0157538659205846
NGA,Batagarawa,2022,237098,103730,44456,2964,0,388248,47420,0.122138426984814,0.0432575741965617,0.0161157015332697
NGA,Batsari,2020,155024,126550,34801,0,0,316375,34801,0.109999209798499,0.0366664032661662,0.0122221344220554
NGA,Batsari,2021,211814,142369,44293,3164,0,401640,47457,0.118158051986854,0.0420119178036716,0.0157545729177041
NGA,Batsari,2022,260694,114054,48880,3259,0,426887,52139,0.122137708573932,0.0432573491345485,0.0161156361181192
NGA,Bauchi,2020,686067,86744,15772,0,0,788583,15772,0.0200004311530936,0.00666681038436453,0.00222227012812151
NGA,Bauchi,2021,692973,105984,23657,0,0,822614,23657,0.0287583240742317,0.00958610802474388,0.0031953693415813
NGA,Bauchi,2022,611447,195663,40763,0,0,847873,40763,0.0480767756491833,0.0160255918830611,0.00534186396102037
NGA,Baure,2020,256360,46330,6177,0,0,308867,6177,0.0199988992025694,0.0066662997341898,0.0022220999113966
NGA,Baure,2021,244006,73171,25451,0,0,342628,25451,0.0742817282884061,0.0247605760961354,0.00825352536537845
NGA,Baure,2022,251326,101803,41357,3181,0,397667,44538,0.111998229674577,0.0399991282488447,0.0151106327656054
NGA,Bayo,2020,103413,51706,17235,0,0,172354,17235,0.0999976791951449,0.033332559731715,0.011110853243905
NGA,Bayo,2021,156829,77559,25853,0,0,260241,25853,0.0993425324987223,0.0331141774995741,0.0110380591665247
NGA,Bayo,2022,146136,53464,17821,0,0,217421,17821,0.0819654035258784,0.0273218011752928,0.00910726705843093
NGA,Bebeji,2020,265313,36595,3050,0,0,304958,3050,0.0100013772388329,0.0033337924129443,0.0011112641376481
NGA,Bebeji,2021,264618,45744,6300,0,0,316662,6300,0.0198950300320215,0.00663167667734051,0.00221055889244684
NGA,Bebeji,2022,277219,50403,12601,0,0,340223,12601,0.0370374724812843,0.0123458241604281,0.0041152747201427
NGA,Bekwara,2021,146262,22636,5224,0,0,174122,5224,0.0300019526538864,0.0100006508846288,0.00333355029487626
NGA,Bekwara,2022,149744,24377,8706,0,0,182827,8706,0.0476187871594458,0.0158729290531486,0.00529097635104954
NGA,Bende,2021,191159,107317,36890,0,0,335366,36890,0.109999224727611,0.036666408242537,0.0122221360808457
NGA,Bende,2022,204573,134146,43598,0,0,382317,43598,0.114036257869778,0.0380120859565927,0.0126706953188643
NGA,Benue IDPs,2022,7149,42897,153713,168012,0,371771,321725,0.865384874021911,0.439102745148671,0.246794995366024
NGA,Biase,2021,230298,38845,8324,0,0,277467,8324,0.0299999639596781,0.00999998798655936,0.00333332932885312
NGA,Biase,2022,227523,66592,22197,0,0,316312,22197,0.070174384784643,0.023391461594881,0.00779715386496034
NGA,Bichi,2020,375902,61913,4422,0,0,442237,4422,0.0099991633445415,0.0033330544481805,0.0011110181493935
NGA,Bichi,2021,370034,75180,13705,0,0,458919,13705,0.0298636578568331,0.00995455261894437,0.00331818420631479
NGA,Bichi,2022,370034,187301,22842,0,0,580177,22842,0.0393707437557849,0.0131235812519283,0.0043745270839761
NGA,Bida,2020,136333,109659,50384,0,0,296376,50384,0.17000026992739,0.0566667566424632,0.0188889188808211
NGA,Bida,2021,257445,118550,53348,0,0,429343,53348,0.124254966308988,0.0414183221029961,0.0138061073676654
NGA,Bida,2022,260510,45972,12259,0,0,318741,12259,0.0384606937921384,0.0128202312640462,0.00427341042134872
NGA,Billiri,2020,246594,51754,6089,0,0,304437,6089,0.0200008540354819,0.00666695134516063,0.00222231711505354
NGA,Billiri,2021,237461,82198,33488,0,0,353147,33488,0.0948273665074317,0.0316091221691439,0.0105363740563813
NGA,Billiri,2022,246594,91331,39577,0,0,377502,39577,0.104839179659975,0.0349463932199918,0.0116487977399973
NGA,Bindawa,2020,190750,34473,4596,0,0,229819,4596,0.0199983465248739,0.00666611550829131,0.00222203850276377
NGA,Bindawa,2021,181557,54444,18937,0,0,254938,18937,0.0742808055291875,0.0247602685097292,0.00825342283657639
NGA,Bindawa,2022,187004,75748,30773,2367,0,295892,33140,0.112000324442702,0.0399999549385136,0.0151109939512465
NGA,Binji,2020,92796,73052,29616,1974,0,197438,31590,0.15999959480951,0.0566658900515605,0.0211104245383361
NGA,Binji,2021,164723,88848,31590,5923,0,291084,37513,0.128873452336783,0.049740510184918,0.0211019652211885
NGA,Binji,2022,138286,54908,30504,2034,0,225732,32538,0.144144383605337,0.0510516896142328,0.0190196043686023
NGA,Biriniwa,2020,169198,30763,19776,0,0,219737,19776,0.0899984982046719,0.0299994994015573,0.00999983313385244
NGA,Biriniwa,2021,187671,32961,24171,0,0,244803,24171,0.0987365350914817,0.0329121783638272,0.0109707261212757
NGA,Biriniwa,2022,194454,31655,13567,0,0,239676,13567,0.0566055842053439,0.018868528068448,0.00628950935614932
NGA,Birni kudu,2020,403391,63182,19441,0,0,486014,19441,0.040000905323715,0.013333635107905,0.00444454503596833
NGA,Birni kudu,2021,405088,70015,25005,0,0,500108,25005,0.0499992001727627,0.0166664000575876,0.00555546668586252
NGA,Birni kudu,2022,405088,105023,45010,0,0,555121,45010,0.081081421888201,0.0270271406294003,0.00900904687646677
NGA,Birnin kebbi,2020,320433,73010,12168,0,0,405611,12168,0.0299991864125973,0.0099997288041991,0.00333324293473303
NGA,Birnin kebbi,2021,351276,64898,24337,0,0,440511,24337,0.0552472015454779,0.0184157338484926,0.00613857794949754
NGA,Birnin kebbi,2022,347094,66910,29273,0,0,443277,29273,0.0660377145667382,0.0220125715222461,0.00733752384074869
NGA,Birnin magaji,2021,166692,86220,34488,0,0,287400,34488,0.12,0.04,0.0133333333333333
NGA,Birnin magaji,2022,143700,123582,68976,2874,0,339132,71850,0.211864406779661,0.0734463276836158,0.0263653483992467
NGA,Birnin-gwari,2020,233071,108766,46614,0,0,388451,46614,0.119999691080728,0.0399998970269094,0.0133332990089698
NGA,Birnin-gwari,2021,220057,140037,58268,0,0,418362,58268,0.139276511729077,0.0464255039096923,0.0154751679698974
NGA,Birnin-gwari,2022,216056,188049,88023,0,0,492128,88023,0.178862003381234,0.0596206677937447,0.0198735559312482
NGA,Biu,2020,234601,83786,16757,0,0,335144,16757,0.0499994032415917,0.0166664677471972,0.00555548924906574
NGA,Biu,2021,301488,117300,33514,0,0,452302,33514,0.0740965107384005,0.0246988369128002,0.00823294563760005
NGA,Biu,2022,284162,121288,86635,6931,0,499016,93566,0.187501001971881,0.0671301120605351,0.0254632227334505
NGA,Bodinga,2020,131900,105520,26380,0,0,263800,26380,0.1,0.0333333333333333,0.0111111111111111
NGA,Bodinga,2021,163028,118710,48909,0,0,330647,48909,0.147919079864629,0.0493063599548763,0.0164354533182921
NGA,Bodinga,2022,149443,86948,62494,5434,0,304319,67928,0.223213141473257,0.0803564680483309,0.0307535477209405
NGA,Bogoro,2020,112968,20173,1345,0,0,134486,1345,0.0100010410005502,0.00333368033351675,0.00111122677783892
NGA,Bogoro,2021,117630,21518,2768,0,0,141916,2768,0.0195044956171256,0.00650149853904187,0.00216716617968063
NGA,Bogoro,2022,116246,20758,6919,0,0,143923,6919,0.0480743175170056,0.0160247725056685,0.00534159083522285
NGA,Boki,2021,249478,40040,18480,0,0,307998,18480,0.0600003896129196,0.0200001298709732,0.00666670995699106
NGA,Boki,2022,249478,80079,21560,0,0,351117,21560,0.0614040334133636,0.0204680111377879,0.00682267037926263
NGA,Bokkos,2020,223520,37253,5322,0,0,266095,5322,0.0200003758056333,0.00666679193521111,0.0022222639784037
NGA,Bokkos,2021,215537,67199,21504,0,0,304240,21504,0.0706810412831975,0.0235603470943992,0.00785344903146639
NGA,Bokkos,2022,225788,80639,29567,0,0,335994,29567,0.0879985952130098,0.0293328650710033,0.00977762169033442
NGA,Borgu,2020,146311,96621,33127,0,0,276059,33127,0.119999710206876,0.039999903402292,0.0133333011340973
NGA,Borgu,2021,234088,118705,35888,0,0,388681,35888,0.0923327870413012,0.0307775956804337,0.0102591985601446
NGA,Borgu,2022,214105,117044,39966,2855,0,373970,42821,0.114503837206193,0.0407127131409828,0.015267415984051
NGA,Bosso,2020,120675,89914,26028,0,0,236617,26028,0.110000549411074,0.0366668498036912,0.0122222832678971
NGA,Bosso,2021,113576,94647,44043,0,0,252266,44043,0.174589520585414,0.0581965068618046,0.0193988356206015
NGA,Bosso,2022,129683,100321,46490,0,0,276494,46490,0.168141080819114,0.0560470269397045,0.0186823423132348
NGA,Buji,2020,124936,19568,6021,0,0,150525,6021,0.04,0.0133333333333333,0.00444444444444444
NGA,Buji,2021,125462,21685,7745,0,0,154892,7745,0.050002582444542,0.016667527481514,0.005555842493838
NGA,Buji,2022,125462,32527,13940,0,0,171929,13940,0.0810799806897033,0.0270266602299011,0.00900888674330037
NGA,Bukkuyum,2021,183880,102156,54483,0,0,340519,54483,0.159999882532252,0.0533332941774174,0.0177777647258058
NGA,Bukkuyum,2022,194096,119182,74914,6810,0,395002,81724,0.206895154961241,0.0747118579990312,0.0287351568965333
NGA,Bungudu,2021,199196,145247,70549,0,0,414992,70549,0.170000867486602,0.0566669558288674,0.0188889852762891
NGA,Bungudu,2022,228245,165997,95448,12450,0,502140,107898,0.214876329310551,0.0798900704982674,0.0321397750959228
NGA,Bunkure,2020,241191,33268,2772,0,0,277231,2772,0.00999888179893302,0.00333296059964434,0.00111098686654811
NGA,Bunkure,2021,240559,41585,5728,0,0,287872,5728,0.019897732325478,0.006632577441826,0.00221085914727533
NGA,Bunkure,2022,252014,45821,11455,0,0,309290,11455,0.0370364382941576,0.0123454794313859,0.00411515981046195
NGA,Bunza,2020,147378,33580,5597,0,0,186555,5597,0.0300018761223232,0.0100006253741077,0.00333354179136924
NGA,Bunza,2021,161563,29849,11193,0,0,202605,11193,0.0552454282964389,0.0184151427654796,0.00613838092182654
NGA,Bunza,2022,159640,30774,13464,0,0,203878,13464,0.0660394942073201,0.0220131647357734,0.00733772157859112
NGA,Bursari,2020,94647,52582,28044,0,0,175273,28044,0.1600018257233,0.0533339419077667,0.0177779806359222
NGA,Bursari,2021,97960,59593,43818,10516,0,211887,54334,0.256429134397108,0.102019787276552,0.0450355351883053
NGA,Bursari,2022,94332,63493,45352,7256,0,210433,52608,0.249998811973407,0.0948266986008215,0.0392714070511754
NGA,Buruku,2020,263635,40801,9416,0,0,313852,9416,0.0300014019346698,0.0100004673115566,0.00333348910385221
NGA,Buruku,2021,276605,43939,19996,0,0,340540,19996,0.0587185059023903,0.0195728353007968,0.00652427843359893
NGA,Buruku,2022,269940,39991,23328,0,0,333259,23328,0.0699996099130106,0.0233332033043369,0.00777773443477896
NGA,Bwari,2020,357723,232765,82080,1225,0,673793,83305,0.123635894109912,0.0418179866318983,0.0143433434963623
NGA,Bwari,2021,419780,255429,81010,1225,0,757444,82235,0.1085690823348,0.0367287878707865,0.0126023251297199
NGA,Bwari,2022,594287,257760,88375,0,0,940422,88375,0.0939737692227532,0.0313245897409177,0.0104415299136392
NGA,Calabar south,2021,262356,44253,9483,0,0,316092,9483,0.0300007592726168,0.0100002530908723,0.00333341769695743
NGA,Calabar south,2022,259195,75862,25287,0,0,360344,25287,0.0701746109273361,0.0233915369757787,0.00779717899192623
NGA,Calabar-municipal,2021,251624,42443,9095,0,0,303162,9095,0.030000461799302,0.0100001539331007,0.00333338464436689
NGA,Calabar-municipal,2022,248593,72759,24253,0,0,345605,24253,0.0701754893592396,0.0233918297864132,0.00779727659547107
NGA,Chanchaga,2020,167084,124494,36038,0,0,327616,36038,0.110000732564954,0.0366669108549847,0.0122223036183282
NGA,Chanchaga,2021,157256,131047,60982,0,0,349285,60982,0.174590950083743,0.0581969833612475,0.0193989944537492
NGA,Chanchaga,2022,179558,138903,64370,0,0,382831,64370,0.168142078358336,0.0560473594527786,0.0186824531509262
NGA,Charanchi,2020,102161,83397,22934,0,0,208492,22934,0.109999424438348,0.0366664748127826,0.0122221582709275
NGA,Charanchi,2021,139585,93821,29189,2085,0,264680,31274,0.118157775426931,0.0420117374439575,0.0157544540157507
NGA,Charanchi,2022,171798,75161,32212,2147,0,281318,34359,0.122135803610149,0.0432559120520787,0.0161146223609344
NGA,Chibok,2020,81174,40587,13529,0,0,135290,13529,0.1,0.0333333333333333,0.0111111111111111
NGA,Chibok,2021,90929,54116,20294,0,0,165339,20294,0.122741760867067,0.0409139202890224,0.0136379734296741
NGA,Chibok,2022,90929,55956,34973,4197,0,186055,39170,0.210529144607777,0.0776956634686876,0.0309114091114037
NGA,Chikun,2020,335546,156588,67109,0,0,559243,67109,0.119999713898967,0.039999904632989,0.0133333015443297
NGA,Chikun,2021,316811,201607,83886,0,0,602304,83886,0.139275183296143,0.0464250610987143,0.0154750203662381
NGA,Chikun,2022,311051,270730,126724,0,0,708505,126724,0.178861123068997,0.0596203743563325,0.0198734581187775
NGA,Dala,2020,485754,146392,33271,0,0,665417,33271,0.0500002254225546,0.0166667418075182,0.00555558060250607
NGA,Dala,2021,556774,232896,59888,0,0,849558,59888,0.0704931270142827,0.0234977090047609,0.00783256966825364
NGA,Dala,2022,433047,274950,61864,0,0,769861,61864,0.0803573632123202,0.0267857877374401,0.00892859591248002
NGA,Damaturu,2020,72097,48065,21205,0,0,141367,21205,0.149999646310667,0.0499998821035555,0.0166666273678518
NGA,Damaturu,2021,87789,49478,53719,5655,0,196641,59374,0.30194110078773,0.110233030412444,0.0431350080151703
NGA,Damaturu,2022,87789,43894,35115,4389,0,171187,39504,0.230765186608796,0.0854679385701017,0.0341867859903692
NGA,Damban,2020,197630,33742,9641,0,0,241013,9641,0.0400019915938144,0.0133339971979381,0.00444466573264605
NGA,Damban,2021,203389,53023,19281,0,0,275693,19281,0.0699364873246691,0.0233121624415564,0.00777072081385212
NGA,Damban,2022,181065,69450,22323,0,0,272838,22323,0.0818177819805159,0.0272725939935053,0.00909086466450177
NGA,Dambatta,2020,284280,46823,3344,0,0,334447,3344,0.00999859469512359,0.00333286489837453,0.00111095496612484
NGA,Dambatta,2021,279842,56856,10365,0,0,347063,10365,0.0298648948461807,0.00995496494872689,0.00331832164957563
NGA,Dambatta,2022,279842,141648,17274,0,0,438764,17274,0.0393696839303133,0.0131232279767711,0.00437440932559037
NGA,Damboa,2020,42624,68199,51149,8525,0,170497,59674,0.350000293260292,0.133333724347056,0.0555558814003244
NGA,Damboa,2021,65229,59674,76723,17050,0,218676,93773,0.428821635661893,0.168930289560811,0.0736365927470575
NGA,Damboa,2022,45836,61703,65229,28207,0,200975,93436,0.464913546461003,0.201754778786748,0.0984406573509696
NGA,Dan musa,2020,84413,68908,18950,0,0,172271,18950,0.110001102913433,0.0366670343044776,0.0122223447681592
NGA,Dan musa,2021,115335,77522,24118,1723,0,218698,25841,0.118158373647679,0.0420122726316656,0.0157548562655148
NGA,Dan musa,2022,141951,62104,26616,1774,0,232445,28390,0.122136419368023,0.0432561107645536,0.0161146842383264
NGA,Dandi,2020,176621,37532,6623,0,0,220776,6623,0.0299987317462043,0.00999957724873476,0.00333319241624492
NGA,Dandi,2021,176621,52353,11381,0,0,240355,11381,0.0473507936177737,0.0157835978725912,0.00526119929086375
NGA,Dandi,2022,154782,63734,34143,0,0,252659,34143,0.13513470725365,0.0450449024178834,0.0150149674726278
NGA,Dandume,2020,110588,88470,22118,0,0,221176,22118,0.100001808514486,0.0333339361714954,0.0111113120571651
NGA,Dandume,2021,129852,99529,30965,0,0,260346,30965,0.118937874981755,0.0396459583272517,0.0132153194424172
NGA,Dandume,2022,95681,91125,79734,11391,0,277931,91125,0.327869147378306,0.122951380018782,0.0500915694902692
NGA,Dange-shnsi,2020,141945,113556,28389,0,0,283890,28389,0.1,0.0333333333333333,0.0111111111111111
NGA,Dange-shnsi,2021,113556,127750,42583,0,0,283889,42583,0.14999876712377,0.0499995890412567,0.0166665296804189
NGA,Dange-shuni,2021,175443,64329,52633,0,0,292405,52633,0.180000341991416,0.0600001139971387,0.0200000379990462
NGA,Dange-shuni,2022,160823,93570,67253,5848,0,327494,73101,0.223213249708392,0.0803566884685928,0.0307537440889502
NGA,Danja,2020,95489,76391,19098,0,0,190978,19098,0.100001047241043,0.0333336824136812,0.0111112274712271
NGA,Danja,2021,112123,85940,26737,0,0,224800,26737,0.118936832740214,0.0396456109134045,0.0132152036378015
NGA,Danja,2022,82617,78683,68847,9835,0,239982,78682,0.327866256635914,0.122949498990202,0.0500903308488877
NGA,Danko Wasagu,2021,272562,111503,28908,0,0,412973,28908,0.0699997336387609,0.0233332445462536,0.00777774818208454
NGA,Danko Wasagu,2022,251914,123892,74335,0,0,450141,74335,0.165137145916502,0.0550457153055006,0.0183485717685002
NGA,Darazo,2020,337499,60268,4018,0,0,401785,4018,0.010000373333997,0.00333345777799901,0.00111115259266634
NGA,Darazo,2021,350811,84375,12382,0,0,447568,12382,0.0276650698888214,0.00922168996294045,0.00307389665431348
NGA,Darazo,2022,301285,115561,28890,0,0,445736,28890,0.0648141500798679,0.0216047166932893,0.00720157223109643
NGA,Dass,2020,123525,18672,1436,0,0,143633,1436,0.00999770247784284,0.00333256749261428,0.00111085583087143
NGA,Dass,2021,126479,24418,2976,0,0,153873,2976,0.0193406250609269,0.00644687502030896,0.00214895834010299
NGA,Dass,2022,129455,23808,5952,0,0,159215,5952,0.0373834123669252,0.0124611374556417,0.00415371248521392
NGA,Daura,2020,284080,51340,6845,0,0,342265,6845,0.0199991234861876,0.00666637449539587,0.00222212483179862
NGA,Daura,2021,270389,81083,28203,0,0,379675,28203,0.0742819516691908,0.0247606505563969,0.00825355018546564
NGA,Daura,2022,278501,112810,45829,3525,0,440665,49354,0.111998910737181,0.0399993948539896,0.0151107480235049
NGA,Dawakin kudu,2020,261552,78824,17915,0,0,358291,17915,0.0500012559623323,0.0166670853207774,0.00555569510692581
NGA,Dawakin kudu,2021,299793,125402,32246,0,0,457441,32246,0.0704921509003347,0.0234973836334449,0.0078324612111483
NGA,Dawakin kudu,2022,233172,148046,33310,0,0,414528,33310,0.0803564536050641,0.0267854845350214,0.00892849484500712
NGA,Dawakin tofa,2020,332530,54770,3912,0,0,391212,3912,0.00999969326094292,0.00333323108698097,0.00111107702899366
NGA,Dawakin tofa,2021,327339,66506,12124,0,0,405969,12124,0.0298643492483416,0.00995478308278054,0.00331826102759351
NGA,Dawakin tofa,2022,327339,165690,20206,0,0,513235,20206,0.0393698792950598,0.0131232930983533,0.00437443103278442
NGA,Demsa,2020,111696,125658,41886,0,0,279240,41886,0.15,0.05,0.0166666666666667
NGA,Demsa,2021,137922,139620,69810,0,0,347352,69810,0.200977682581358,0.0669925608604528,0.0223308536201509
NGA,Demsa,2022,123555,143669,48847,0,0,316071,48847,0.154544390342676,0.0515147967808921,0.017171598926964
NGA,Dikwa,2020,44509,52779,34382,11432,0,143102,45814,0.320149264161228,0.133345445905718,0.0622011649810004
NGA,Dikwa,2021,51209,57703,44046,16078,0,169036,60124,0.355687545848222,0.150267793053945,0.0712261161987848
NGA,Dikwa,2022,32474,53707,44964,8743,0,139888,53707,0.383928571428571,0.148809523809524,0.0634920634920635
NGA,Doguwa,2020,208259,28725,2394,0,0,239378,2394,0.0100009190485341,0.00333363968284471,0.0011112132276149
NGA,Doguwa,2021,207713,35907,4946,0,0,248566,4946,0.019898135706412,0.00663271190213733,0.00221090396737911
NGA,Doguwa,2022,217604,39564,9891,0,0,267059,9891,0.0370367596673394,0.0123455865557798,0.00411519551859327
NGA,Donga,2020,175453,22184,4033,0,0,201670,4033,0.0199980165617097,0.00666600552056991,0.00222200184018997
NGA,Donga,2021,171420,26217,10084,0,0,207721,10084,0.0485458860683321,0.0161819620227773,0.00539398734092578
NGA,Donga,2022,169403,24200,12100,0,0,205703,12100,0.0588226715215626,0.0196075571738542,0.00653585239128474
NGA,Dukku,2020,255870,49926,6241,0,0,312037,6241,0.0200008332345203,0.00666694441150676,0.00222231480383558
NGA,Dukku,2021,255870,59287,12481,0,0,327638,12481,0.0380938718952014,0.0126979572984005,0.00423265243280016
NGA,Dukku,2022,258990,78009,28083,0,0,365082,28083,0.0769224448206156,0.0256408149402052,0.00854693831340174
NGA,Dutse,2020,322519,50515,15543,0,0,388577,15543,0.039999794120599,0.0133332647068663,0.00444442156895544
NGA,Dutse,2021,323875,55978,19992,0,0,399845,19992,0.0499993747577186,0.0166664582525729,0.00555548608419096
NGA,Dutse,2022,323875,83968,35986,0,0,443829,35986,0.0810807766054043,0.0270269255351348,0.00900897517837826
NGA,Dutsi,2020,152727,27601,3680,0,0,184008,3680,0.0199991304725882,0.00666637682419605,0.00222212560806535
NGA,Dutsi,2021,145366,43592,15162,0,0,204120,15162,0.0742798353909465,0.0247599451303155,0.0082533150434385
NGA,Dutsi,2022,149727,60649,24639,1895,0,236910,26534,0.112000337680976,0.0399997185991868,0.015110754670081
NGA,Dutsin-ma,2020,126652,103389,28432,0,0,258473,28432,0.109999883933718,0.0366666279779061,0.0122222093259687
NGA,Dutsin-ma,2021,173048,116313,36186,2585,0,328132,38771,0.1181567174186,0.0420115481980829,0.0157544998828385
NGA,Dutsin-ma,2022,212982,93180,39934,2662,0,348758,42596,0.122136266408226,0.0432563554097684,0.0161149628746071
NGA,Edati,2020,117423,94449,43395,0,0,255267,43395,0.169998472187944,0.0566661573959815,0.0188887191319938
NGA,Edati,2021,221736,102107,45948,0,0,369791,45948,0.124253970486031,0.0414179901620104,0.0138059967206701
NGA,Edati,2022,224375,39596,10559,0,0,274530,10559,0.0384620988598696,0.0128206996199565,0.00427356653998551
NGA,Egor,2021,409215,85885,10104,0,0,505204,10104,0.0199998416481263,0.00666661388270877,0.00222220462756959
NGA,Egor,2022,424371,126301,25260,0,0,575932,25260,0.0438593445059486,0.0146197815019829,0.00487326050066096
NGA,Enugu east,2021,376198,62700,8957,0,0,447855,8957,0.0199997767134452,0.00666659223781507,0.00222219741260502
NGA,Enugu east,2022,367241,147792,17914,0,0,532947,17914,0.0336130984882174,0.0112043661627391,0.00373478872091305
NGA,Enugu north,2021,330049,55008,7858,0,0,392915,7858,0.0199992364760826,0.00666641215869421,0.0022221373862314
NGA,Enugu north,2022,322191,129662,15717,0,0,467570,15717,0.0336142181919285,0.0112047393973095,0.0037349131324365
NGA,Enugu south,2021,267869,44645,6378,0,0,318892,6378,0.0200005017372653,0.00666683391242176,0.00222227797080725
NGA,Enugu south,2022,261491,105234,12756,0,0,379481,12756,0.0336143311522843,0.0112047770507614,0.00373492568358714
NGA,Epe,2022,425661,155730,67483,0,0,648874,67483,0.10400016027765,0.0346667200925501,0.0115555733641834
NGA,Esan central,2021,131271,21879,3126,0,0,156276,3126,0.0200030714889042,0.00666769049630142,0.00222256349876714
NGA,Esan central,2022,114081,46883,17190,0,0,178154,17190,0.0964895539813869,0.0321631846604623,0.0107210615534874
NGA,Esan north east,2021,152119,25353,3622,0,0,181094,3622,0.0200006626392923,0.00666688754643077,0.00222229584881026
NGA,Esan north east,2022,132199,54328,19920,0,0,206447,19920,0.0964896559407499,0.0321632186469166,0.0107210728823055
NGA,Esan south east,2021,207425,34571,4939,0,0,246935,4939,0.0200012148946079,0.00666707163153596,0.00222235721051199
NGA,Esan south east,2022,180263,74081,27163,0,0,281507,27163,0.0964913838732252,0.0321637946244084,0.0107212648748028
NGA,Esan west,2021,159258,26543,3792,0,0,189593,3792,0.020000738423887,0.00666691280796232,0.00222230426932077
NGA,Esan west,2022,138403,56878,20855,0,0,216136,20855,0.0964901728541289,0.0321633909513763,0.0107211303171254
NGA,Eti-osa,2021,960524,488402,179081,0,0,1628007,179081,0.110000141277034,0.0366667137590113,0.0122222379196704
NGA,Eti-osa,2022,1025392,569802,195361,0,0,1790555,195361,0.109106394386098,0.0363687981286994,0.0121229327095665
NGA,Etsako central,2021,113273,22375,4195,0,0,139843,4195,0.0299979262458614,0.00999930874862048,0.00333310291620683
NGA,Etsako central,2022,104882,51742,9789,0,0,166413,9789,0.0588235294117647,0.0196078431372549,0.0065359477124183
NGA,Etsako east,2021,177162,34995,6562,0,0,218719,6562,0.030001965992895,0.010000655330965,0.00333355177698833
NGA,Etsako east,2022,164039,80926,15310,0,0,260275,15310,0.0588223993852656,0.0196074664617552,0.0065358221539184
NGA,Etsako west,2021,239122,47234,8856,0,0,295212,8856,0.0299987805373765,0.00999959351245884,0.00333319783748628
NGA,Etsako west,2022,221409,109228,20665,0,0,351302,20665,0.0588240317447666,0.0196080105815889,0.00653600352719629
NGA,Etung,2021,107000,17173,7926,0,0,132099,7926,0.0600004542048009,0.0200001514016003,0.00666671713386677
NGA,Etung,2022,107000,34346,9247,0,0,150593,9247,0.061403916516704,0.0204679721722347,0.00682265739074489
NGA,Ezeagu,2021,226048,40852,5447,0,0,272347,5447,0.0200002203071816,0.00666674010239388,0.00222224670079796
NGA,Ezeagu,2022,220601,81704,27235,0,0,329540,27235,0.0826455058566487,0.0275485019522162,0.00918283398407207
NGA,Fagge,2020,232107,69950,15898,0,0,317955,15898,0.0500007862747873,0.0166669287582624,0.00555564291942081
NGA,Fagge,2021,266043,111284,28616,0,0,405943,28616,0.0704926553727986,0.0234975517909329,0.00783251726364429
NGA,Fagge,2022,206922,131379,29560,0,0,367861,29560,0.0803564389810282,0.0267854796603427,0.00892849322011424
NGA,Fakai,2020,141066,28937,10851,0,0,180854,10851,0.0599986729627213,0.0199995576542404,0.00666651921808015
NGA,Fakai,2021,137449,50344,13052,0,0,200845,13052,0.064985436530658,0.021661812176886,0.007220604058962
NGA,Fakai,2022,113741,55938,33563,0,0,203242,33563,0.16513811121717,0.0550460370723899,0.01834867902413
NGA,Faskari,2020,147935,118348,29587,0,0,295870,29587,0.1,0.0333333333333333,0.0111111111111111
NGA,Faskari,2021,173705,133141,41422,0,0,348268,41422,0.118937140363169,0.0396457134543895,0.0132152378181298
NGA,Faskari,2022,127993,121898,106661,15237,0,371789,121898,0.327868764272208,0.122950562460607,0.0500908370667831
NGA,Fika,2020,99707,120857,75535,6043,2,302144,81580,0.270003706841771,0.0966724475746664,0.0366730948010073
NGA,Fika,2021,146977,120857,105749,30214,2,403799,135965,0.336714553527869,0.137182938376106,0.0623585826941952
NGA,Fika,2022,181375,106324,100069,25017,0,412785,125086,0.303029422096249,0.121211607333923,0.0538717357569787
NGA,Fufore,2020,131137,140972,55733,0,0,327842,55733,0.169999572965026,0.0566665243216753,0.0188888414405584
NGA,Fufore,2021,114745,161928,81961,0,0,358634,81961,0.228536613929521,0.0761788713098405,0.0253929571032802
NGA,Fufore,2022,158554,205783,64096,0,0,428433,64096,0.149605655960208,0.0498685519867362,0.0166228506622454
NGA,Funakaye,2020,291556,56889,7111,0,0,355556,7111,0.0199996625004219,0.00666655416680729,0.0022221847222691
NGA,Funakaye,2021,291556,67556,14222,0,0,373334,14222,0.0380945748311164,0.0126981916103721,0.00423273053679071
NGA,Funakaye,2022,295111,88889,32000,0,0,416000,32000,0.0769230769230769,0.0256410256410256,0.00854700854700855
NGA,Fune,2020,231876,193230,57969,0,0,483075,57969,0.12,0.04,0.0133333333333333
NGA,Fune,2021,234992,241538,89997,0,0,566527,89997,0.158857388968222,0.0529524629894074,0.0176508209964691
NGA,Fune,2022,304989,159994,119996,10000,0,594979,129996,0.218488383623624,0.0784318998373612,0.0298789256987782
NGA,Funtua,2020,171339,137072,34268,0,0,342679,34268,0.100000291818291,0.0333334306060969,0.0111111435353656
NGA,Funtua,2021,201187,154205,47975,0,0,403367,47975,0.118936353246547,0.0396454510821824,0.0132151503607275
NGA,Funtua,2022,148243,141184,123536,17648,0,430611,141184,0.327869004739777,0.122950876777416,0.0500910979463548
NGA,Gabasawa,2020,285266,46985,3356,0,0,335607,3356,0.00999979142270572,0.00333326380756858,0.00111108793585619
NGA,Gabasawa,2021,280812,57053,10400,0,0,348265,10400,0.0298623174881197,0.00995410582937323,0.00331803527645774
NGA,Gabasawa,2022,280812,142140,17334,0,0,440286,17334,0.0393698641337676,0.0131232880445892,0.0043744293481964
NGA,Gada,2020,232163,111936,62187,8292,0,414578,70479,0.170001784947585,0.063334282089257,0.0255561076564603
NGA,Gada,2021,230588,145102,82915,20729,0,479334,103644,0.216225012204434,0.0864901439636384,0.0384401412515421
NGA,Gada,2022,204967,149455,98213,17081,0,469716,115294,0.245454700286982,0.093939742312376,0.0393942533597133
NGA,Gagarawa,2020,102962,17796,6356,0,0,127114,6356,0.0500023600862218,0.0166674533620739,0.00555581778735798
NGA,Gagarawa,2021,105948,17796,7848,0,0,131592,7848,0.0596388838227248,0.0198796279409083,0.00662654264696942
NGA,Gagarawa,2022,96792,27468,18312,0,0,142572,18312,0.128440366972477,0.0428134556574924,0.0142711518858308
NGA,Gamawa,2020,384168,68602,4573,0,0,457343,4573,0.00999905978663716,0.00333301992887905,0.00111100664295968
NGA,Gamawa,2021,403881,137203,22867,0,0,563951,22867,0.0405478490152513,0.0135159496717504,0.00450531655725015
NGA,Gamawa,2022,352221,126800,37570,0,0,516591,37570,0.0727267799864883,0.0242422599954961,0.00808075333183204
NGA,Ganjuwa,2020,380706,58226,8958,0,0,447890,8958,0.0200004465382125,0.0066668155127375,0.00222227183757917
NGA,Ganjuwa,2021,395445,98536,17916,0,0,511897,17916,0.0349992283603928,0.0116664094534643,0.00388880315115476
NGA,Ganjuwa,2022,386249,64375,22991,0,0,473615,22991,0.0485436483219493,0.0161812161073164,0.00539373870243881
NGA,Ganye,2020,109060,111720,45220,0,0,266000,45220,0.17,0.0566666666666667,0.0188888888888889
NGA,Ganye,2021,197073,133000,66500,0,0,396573,66500,0.167686655420314,0.0558955518067712,0.0186318506022571
NGA,Ganye,2022,164228,125908,41057,0,0,331193,41057,0.123966992055992,0.0413223306853305,0.0137741102284435
NGA,Garki,2020,188322,32549,11625,0,0,232496,11625,0.0500008602298534,0.0166669534099511,0.00555565113665038
NGA,Garki,2021,193783,32549,14354,0,0,240686,14354,0.0596378684260821,0.0198792894753607,0.00662642982512024
NGA,Garki,2022,177037,50240,33493,0,0,260770,33493,0.128438854162672,0.0428129513875574,0.0142709837958525
NGA,Garko,2020,223909,30884,2574,0,0,257367,2574,0.0100012822156687,0.00333376073855623,0.00111125357951874
NGA,Garko,2021,223322,38605,5317,0,0,267244,5317,0.0198956758617593,0.00663189195391976,0.00221063065130659
NGA,Garko,2022,233957,42538,10634,0,0,287129,10634,0.0370356181367957,0.0123452060455986,0.00411506868186619
NGA,Garum mallam,2020,137600,41468,9425,0,0,188493,9425,0.0500018568328797,0.0166672856109599,0.00555576187031997
NGA,Garum mallam,2021,157718,65973,16964,0,0,240655,16964,0.0704909517774407,0.0234969839258136,0.00783232797527119
NGA,Garum mallam,2022,122669,77885,17524,0,0,218078,17524,0.0803565696677336,0.0267855232225779,0.00892850774085929
NGA,Gashaka,2020,116219,13207,2641,0,0,132067,2641,0.0199974255491531,0.00666580851638436,0.00222193617212812
NGA,Gashaka,2021,113578,18489,5283,0,0,137350,5283,0.0384637786676374,0.0128212595558791,0.00427375318529305
NGA,Gashaka,2022,167386,26217,12100,0,0,205703,12100,0.0588226715215626,0.0196075571738542,0.00653585239128474
NGA,Gassol,2020,354034,40231,8046,0,0,402311,8046,0.0199994531593717,0.00666648438645724,0.00222216146215241
NGA,Gassol,2021,345987,56324,16092,0,0,418403,16092,0.0384605272906743,0.0128201757635581,0.00427339192118603
NGA,Gassol,2022,337941,52300,24139,0,0,414380,24139,0.0582532940778995,0.0194177646926332,0.00647258823087773
NGA,Gawabawa,2020,207568,100077,55599,7413,0,370657,63012,0.170000836352747,0.0633334862150182,0.0255555225810745
NGA,Gawabawa,2021,148263,129730,74131,18533,0,370657,92664,0.249999325521979,0.0999999100695971,0.0444445043980464
NGA,Gaya,2020,286746,39551,3296,0,0,329593,3296,0.0100002123831513,0.00333340412771711,0.00111113470923904
NGA,Gaya,2021,285994,49439,6809,0,0,342242,6809,0.0198952787793433,0.00663175959311442,0.00221058653103814
NGA,Gaya,2022,299614,54475,13619,0,0,367708,13619,0.0370375406572607,0.0123458468857536,0.00411528229525118
NGA,Gbako,2020,93198,74963,34443,0,0,202604,34443,0.170001579435747,0.0566671931452489,0.0188890643817496
NGA,Gbako,2021,175990,81041,36469,0,0,293500,36469,0.124255536626917,0.0414185122089722,0.0138061707363241
NGA,Gbako,2022,178085,31427,8380,0,0,217892,8380,0.0384594202632497,0.0128198067544166,0.00427326891813885
NGA,Gboko,2020,461935,71490,16498,0,0,549923,16498,0.0300005637152838,0.0100001879050946,0.00333339596836486
NGA,Gboko,2021,484660,76989,35036,0,0,596685,35036,0.0587177488959836,0.0195725829653279,0.00652419432177596
NGA,Gboko,2022,490500,70071,40875,0,0,601446,40875,0.067961213475524,0.0226537378251747,0.00755124594172489
NGA,Geidam,2020,91487,95093,49081,16983,7,252651,66071,0.261510938013307,0.109595185981189,0.0514878011345471
NGA,Geidam,2021,94135,106234,73216,27545,7,301137,100768,0.334625104188459,0.142047196680138,0.0676912280235684
NGA,Geidam,2022,104595,83676,81061,26149,0,295481,107210,0.362832127954082,0.150442837272109,0.0698134755045352
NGA,Gezawa,2020,327496,98698,22431,0,0,448625,22431,0.0499994427417108,0.0166664809139036,0.00555549363796787
NGA,Gezawa,2021,375378,157019,40376,0,0,572773,40376,0.0704921495950403,0.0234973831983468,0.00783246106611559
NGA,Gezawa,2022,291961,185372,41709,0,0,519042,41709,0.0803576589177754,0.0267858863059251,0.00892862876864172
NGA,Giade,2020,205549,40107,5013,0,0,250669,5013,0.0199984840566644,0.00666616135222146,0.00222205378407382
NGA,Giade,2021,213832,57654,12533,0,0,284019,12533,0.0441273295096455,0.0147091098365485,0.00490303661218283
NGA,Giade,2022,216408,61831,20610,0,0,298849,20610,0.0689645941595923,0.0229881980531974,0.00766273268439915
NGA,Girei,2021,173571,32143,8571,0,0,214285,8571,0.0399981333271111,0.013332711109037,0.00444423703634568
NGA,Girei,2022,107143,111428,51428,0,0,269999,51428,0.190474779536221,0.0634915931787402,0.0211638643929134
NGA,Gireri,2020,83298,93711,31237,0,0,208246,31237,0.1500004802013,0.0500001600671001,0.0166667200223667
NGA,Gireri,2021,52062,104123,52062,0,0,208247,52062,0.250001200497486,0.083333733499162,0.0277779111663874
NGA,Giwa,2020,388259,181187,77652,0,0,647098,77652,0.120000370886635,0.0400001236288785,0.0133333745429595
NGA,Giwa,2021,366581,233279,97065,0,0,696925,97065,0.13927610575026,0.04642536858342,0.01547512286114
NGA,Giwa,2022,359916,313260,146632,0,0,819808,146632,0.178861391935673,0.0596204639785576,0.0198734879928525
NGA,Gombe,2020,330967,64579,8072,0,0,403618,8072,0.0199991080675292,0.00666636935584307,0.00222212311861436
NGA,Gombe,2021,330967,76687,16145,0,0,423799,16145,0.0380958897968141,0.0126986299322714,0.00423287664409045
NGA,Gombe,2022,335003,100905,36326,0,0,472234,36326,0.0769237284905365,0.0256412428301788,0.00854708094339294
NGA,Gombi,2020,92525,104091,34697,0,0,231313,34697,0.150000216157328,0.0500000720524426,0.0166666906841476
NGA,Gombi,2021,197557,115657,41636,0,0,354850,41636,0.117334084824574,0.0391113616081913,0.0130371205360638
NGA,Gombi,2022,188037,83307,40464,0,0,311808,40464,0.129772167487685,0.0432573891625616,0.0144191297208539
NGA,Goronyo,2020,171921,82891,46050,6140,0,307002,52190,0.169998892515358,0.0633329207410158,0.0255553890709362
NGA,Goronyo,2021,168838,107451,61400,15350,0,353039,76750,0.217398077832761,0.0869592311331043,0.0386485471702686
NGA,Goronyo,2022,150078,109432,71913,12507,0,343930,84420,0.245456924374146,0.0939406274532609,0.0393946442590062
NGA,Gubio,2020,37089,96550,120162,75041,0,328842,195203,0.593607264278894,0.273935000192595,0.142022274797285
NGA,Gubio,2021,32597,82211,136605,91483,0,342896,228088,0.665181279454995,0.310658819778203,0.162840757677093
NGA,Gubio,2022,28762,61360,78617,47937,5752,222428,132306,0.594826190947183,0.28735440981651,0.160917490403886
NGA,Gudu,2020,99589,78400,31784,2119,0,211892,33903,0.160001321427897,0.0566672329929083,0.021111383786709
NGA,Gudu,2021,174225,95351,33903,6357,0,309836,40260,0.12993971004015,0.0501523386565796,0.0212768475365462
NGA,Gudu,2022,146263,58075,32264,2151,0,238753,34415,0.144144785615259,0.0510513654976761,0.0190191909165074
NGA,Gujba,2020,48057,73131,62684,25073,12,208957,87769,0.420033786855669,0.180046612460937,0.0867185327337416
NGA,Gujba,2021,60552,83578,73131,31342,12,248615,104485,0.420268286306136,0.182143743002903,0.0887615165796289
NGA,Gujba,2022,82178,82178,67040,30276,0,261672,97316,0.371900700113119,0.162534266817492,0.0798896667923541
NGA,Gulani,2020,64840,49877,41564,9975,6,166262,51545,0.310022735201068,0.123363526642688,0.0544776049581718
NGA,Gulani,2021,111849,66502,49877,13300,6,241534,63183,0.261590500716255,0.105568298183003,0.0474425960734307
NGA,Gulani,2022,94641,61947,43019,17207,0,216814,60226,0.277777265305746,0.119046740524136,0.0573184593450812
NGA,Guma,2020,248228,38416,8865,0,0,295509,8865,0.029999086322244,0.009999695440748,0.00333323181358267
NGA,Guma,2021,260440,41371,18827,0,0,320638,18827,0.0587173073684342,0.0195724357894781,0.00652414526315935
NGA,Guma,2022,254164,37654,21965,0,0,313783,21965,0.0700006055140017,0.0233335351713339,0.0077778450571113
NGA,Gumel,2020,133315,23042,8229,0,0,164586,8229,0.0499981772447231,0.0166660590815744,0.00555535302719146
NGA,Gumel,2021,137181,23042,10162,0,0,170385,10162,0.0596414003580127,0.0198804667860042,0.00662682226200142
NGA,Gumel,2022,125326,35565,23710,0,0,184601,23710,0.128439174218991,0.0428130580729971,0.0142710193576657
NGA,Gummi,2021,177717,98732,52657,0,0,329106,52657,0.160000121541388,0.0533333738471293,0.0177777912823764
NGA,Gummi,2022,187590,115187,72403,6582,0,381762,78985,0.206895919447195,0.0747123425939023,0.0287354716056368
NGA,Gurara,2020,74817,55746,16137,0,0,146700,16137,0.11,0.0366666666666667,0.0122222222222222
NGA,Gurara,2021,70416,58680,27306,0,0,156402,27306,0.17458856024859,0.0581961867495301,0.01939872891651
NGA,Gurara,2022,80402,62198,28823,0,0,171423,28823,0.168139631204681,0.0560465437348936,0.0186821812449645
NGA,Guri,2020,135062,24557,15786,0,0,175405,15786,0.0899974345087084,0.0299991448362361,0.00999971494541205
NGA,Guri,2021,149808,26311,19295,0,0,195414,19295,0.0987390872711269,0.0329130290903756,0.0109710096967919
NGA,Guri,2022,155223,25269,10829,0,0,191321,10829,0.0566012094856289,0.018867069828543,0.00628902327618099
NGA,Gusau,2021,295925,215779,104807,0,0,616511,104807,0.17000021086404,0.0566667369546799,0.0188889123182266
NGA,Gusau,2022,339081,246605,141798,18495,0,745979,160293,0.214876021979171,0.0798896483681176,0.0321394212616352
NGA,Guyuk,2020,171282,69066,35914,0,0,276262,35914,0.129999782814864,0.043333260938288,0.0144444203127627
NGA,Guyuk,2021,147822,96653,58015,0,0,302490,58015,0.191791464180634,0.0639304880602114,0.0213101626867371
NGA,Guyuk,2022,156351,119395,54012,0,0,329758,54012,0.163792842023545,0.0545976140078482,0.0181992046692827
NGA,Guzamala,2020,12434,24868,33157,12434,0,82893,45591,0.549998190438276,0.233332931208506,0.111111111111111
NGA,Guzamala,2021,6631,12434,41446,22381,0,82892,63827,0.770001930222458,0.346667953481639,0.175556413432204
NGA,Guzamala,2022,17605,30809,33449,13204,0,95067,46653,0.490738111016441,0.209876543209877,0.100823629650667
NGA,Gwadabawa,2021,206159,106897,68720,0,0,381776,68720,0.180000838187838,0.060000279395946,0.020000093131982
NGA,Gwadabawa,2022,183253,133622,87809,15271,0,419955,103080,0.245454870164661,0.0939394300182956,0.0393939033150377
NGA,Gwagwalada,2020,330491,202341,128149,13489,0,674470,141638,0.209998962148057,0.0766661230299346,0.0299996869970331
NGA,Gwagwalada,2021,611874,229320,134894,13489,0,989577,148383,0.14994588596946,0.054525654227345,0.0212043462341317
NGA,Gwagwalada,2022,575014,191213,148721,0,0,914948,148721,0.162545849600196,0.054181949866732,0.0180606499555773
NGA,Gwale,2020,415074,125091,28430,0,0,568595,28430,0.0500004396802645,0.0166668132267548,0.00555560440891828
NGA,Gwale,2021,475760,199008,51174,0,0,725942,51174,0.0704932349967353,0.0234977449989118,0.00783258166630392
NGA,Gwale,2022,370036,234943,52862,0,0,657841,52862,0.0803568035437135,0.0267856011812378,0.00892853372707927
NGA,Gwandu,2020,180217,41062,6844,0,0,228123,6844,0.0300013589160234,0.0100004529720078,0.0033334843240026
NGA,Gwandu,2021,197564,36500,13687,0,0,247751,13687,0.055244983874939,0.0184149946249796,0.00613833154165988
NGA,Gwandu,2022,195212,37631,16464,0,0,249307,16464,0.0660390602750825,0.0220130200916942,0.00733767336389806
NGA,Gwaram,2020,348503,54585,16795,0,0,419883,16795,0.0399992378829341,0.0133330792943114,0.00444435976477045
NGA,Gwaram,2021,349968,60488,21603,0,0,432059,21603,0.0500001157249357,0.0166667052416452,0.00555556841388175
NGA,Gwaram,2022,349968,90732,38885,0,0,479585,38885,0.0810805175307818,0.0270268391769273,0.00900894639230909
NGA,Gwarzo,2020,248015,40849,2918,0,0,291782,2918,0.0100006168989177,0.00333353896630589,0.0011111796554353
NGA,Gwarzo,2021,244143,49603,9042,0,0,302788,9042,0.0298624780374387,0.00995415934581291,0.00331805311527097
NGA,Gwarzo,2022,244143,123578,15071,0,0,382792,15071,0.0393712512278209,0.0131237504092736,0.00437458346975787
NGA,Gwer east,2020,215623,33370,7701,0,0,256694,7701,0.0300007012240255,0.0100002337413418,0.00333341124711394
NGA,Gwer east,2021,226231,35937,16354,0,0,278522,16354,0.0587170851853714,0.0195723617284571,0.00652412057615237
NGA,Gwer east,2022,228956,32708,19080,0,0,280744,19080,0.0679622716781125,0.0226540905593708,0.00755136351979027
NGA,Gwer west,2020,156371,24200,5585,0,0,186156,5585,0.0300017189883753,0.0100005729961251,0.0033335243320417
NGA,Gwer west,2021,164064,26062,11860,0,0,201986,11860,0.0587169407780737,0.0195723135926912,0.00652410453089708
NGA,Gwer west,2022,160110,23720,13837,0,0,197667,13837,0.0700015682941513,0.0233338560980504,0.00777795203268348
NGA,Gwiwa,2020,161337,27885,9959,0,0,199181,9959,0.0499997489720405,0.0166665829906802,0.00555552766356006
NGA,Gwiwa,2021,166016,27885,12297,0,0,206198,12297,0.05963685389771,0.0198789512992367,0.00662631709974555
NGA,Gwiwa,2022,151669,43041,28694,0,0,223404,28694,0.128439956312331,0.042813318770777,0.0142711062569257
NGA,Gwoza,2020,90101,110057,104919,34775,0,339852,139694,0.411043630756918,0.171122527845454,0.0797794987883615
NGA,Gwoza,2021,121850,121122,118948,57695,0,419615,176643,0.420964455512792,0.186153180097629,0.0926055233170088
NGA,Gwoza,2022,95739,110245,89937,37715,0,333636,127652,0.38260859139901,0.165216982979455,0.0801928515574525
NGA,Hadejia,2020,124247,22590,14522,0,0,161359,14522,0.0899980788180393,0.0299993596060131,0.0099997865353377
NGA,Hadejia,2021,137813,24204,17750,0,0,179767,17750,0.0987389231616481,0.0329129743872161,0.0109709914624053
NGA,Hadejia,2022,142794,23246,9962,0,0,176002,9962,0.0566016295269372,0.0188672098423124,0.00628906994743747
NGA,Hawul,2020,220466,25937,12969,0,0,259372,12969,0.050001542186512,0.0166671807288373,0.00555572690961245
NGA,Hawul,2021,233326,51874,25937,0,0,311137,25937,0.0833619916628366,0.0277873305542789,0.00926244351809296
NGA,Hawul,2022,219917,80457,16091,0,0,316465,16091,0.0508460651256853,0.0169486883752284,0.00564956279174281
NGA,Hong,2020,193305,55608,15888,0,0,264801,15888,0.059999773414753,0.0199999244715843,0.00666664149052811
NGA,Hong,2021,223434,58256,18536,0,0,300226,18536,0.0617401557493355,0.0205800519164452,0.00686001730548172
NGA,Hong,2022,136241,122616,49047,0,0,307904,49047,0.15929315630846,0.0530977187694866,0.0176992395898289
NGA,Ibeju/lekki,2021,115338,37897,11534,0,0,164769,11534,0.0700010317474768,0.0233336772491589,0.00777789241638631
NGA,Ibeju/lekki,2022,130920,47898,20756,0,0,199574,20756,0.104001523244511,0.0346671744148369,0.0115557248049456
NGA,Ibi,2020,111131,14051,2555,0,0,127737,2555,0.0200020354321771,0.00666734514405902,0.00222244838135301
NGA,Ibi,2021,108576,16606,6387,0,0,131569,6387,0.0485448699921714,0.0161816233307238,0.0053938744435746
NGA,Ibi,2022,107299,15328,7664,0,0,130291,7664,0.0588221749775503,0.0196073916591834,0.00653579721972781
NGA,Ifako-ijaye,2021,825490,308019,98566,0,0,1232075,98566,0.08,0.0266666666666667,0.00888888888888889
NGA,Ifako-ijaye,2022,1002851,369622,123207,0,0,1495680,123207,0.0823752406931964,0.0274584135643988,0.00915280452146627
NGA,Igabi,2020,388258,181187,77652,0,0,647097,77652,0.120000556330813,0.0400001854436043,0.0133333951478681
NGA,Igabi,2021,366580,233278,97064,0,0,696922,97064,0.139275270403288,0.0464250901344292,0.0154750300448097
NGA,Igabi,2022,359915,313259,146632,0,0,819806,146632,0.178861828286204,0.0596206094287348,0.0198735364762449
NGA,Igbo-etiti,2021,285415,26863,23505,0,0,335783,23505,0.0700005658416299,0.02333352194721,0.00777784064906998
NGA,Igbo-etiti,2022,275341,107450,26863,0,0,409654,26863,0.0655748509717957,0.0218582836572652,0.00728609455242175
NGA,Igbo-eze north,2021,353864,33305,29142,0,0,416311,29142,0.0700005524715898,0.0233335174905299,0.00777783916350997
NGA,Igbo-eze north,2022,341375,133220,33305,0,0,507900,33305,0.0655739318763536,0.0218579772921179,0.00728599243070596
NGA,Igbo-eze south,2021,200955,18913,16549,0,0,236417,16549,0.0699991963352889,0.0233330654450963,0.00777768848169877
NGA,Igbo-eze south,2022,193863,75654,18913,0,0,288430,18913,0.0655722358977915,0.0218574119659305,0.0072858039886435
NGA,Igueben,2021,87672,14612,2087,0,0,104371,2087,0.0199959758936869,0.00666532529789565,0.00222177509929855
NGA,Igueben,2022,76192,31312,11481,0,0,118985,11481,0.0964911543471866,0.0321637181157289,0.0107212393719096
NGA,Ikara,2020,204764,67280,20476,0,0,292520,20476,0.0699986325721318,0.0233328775240439,0.00777762584134798
NGA,Ikara,2021,192829,90389,29252,0,0,312470,29252,0.0936153870771594,0.0312051290257198,0.0104017096752399
NGA,Ikara,2022,247062,90389,27117,0,0,364568,27117,0.0743811854029975,0.0247937284676658,0.00826457615588861
NGA,Ikeja,2021,719461,268456,85906,0,0,1073823,85906,0.0800001490003474,0.0266667163334491,0.00888890544448304
NGA,Ikeja,2022,874042,322147,107382,0,0,1303571,107382,0.0823752599589896,0.0274584199863299,0.00915280666210995
NGA,Ikom,2021,218837,35122,16210,0,0,270169,16210,0.0599994818058327,0.0199998272686109,0.00666660908953696
NGA,Ikom,2022,218837,70244,18912,0,0,307993,18912,0.0614039929478917,0.0204679976492972,0.00682266588309908
NGA,Ikorodu,2021,798400,262332,79840,0,0,1140572,79840,0.0699999649298773,0.0233333216432924,0.00777777388109748
NGA,Ikorodu,2022,906269,331562,143677,0,0,1381508,143677,0.104000121606245,0.0346667072020816,0.0115555690673605
NGA,Ikpoba-okha,2021,447400,93899,11047,0,0,552346,11047,0.0200001448367509,0.00666671494558363,0.00222223831519454
NGA,Ikpoba-okha,2022,463971,138087,27617,0,0,629675,27617,0.0438591336800731,0.014619711226691,0.00487323707556367
NGA,Ikwuano,2021,125264,84313,31316,0,0,240893,31316,0.12999962639014,0.0433332087967133,0.0144444029322378
NGA,Ikwuano,2022,120447,96357,45770,0,0,262574,45770,0.174312765163344,0.0581042550544481,0.0193680850181494
NGA,Illela,2020,95364,45979,25544,3406,0,170293,28950,0.170001115724076,0.0633339792788508,0.0255559535623895
NGA,Illela,2021,94717,59603,34059,8515,0,196894,42574,0.216228021168751,0.0864915470591621,0.0384408756883286
NGA,Illela,2022,84193,61391,40342,7016,0,192942,47358,0.245452001119507,0.0939384201815399,0.0393935310438716
NGA,Ingawa,2020,213673,38616,5149,0,0,257438,5149,0.0200009322633022,0.00666697742110074,0.00222232580703358
NGA,Ingawa,2021,203375,60987,21213,0,0,285575,21213,0.0742817123347632,0.0247605707782544,0.00825352359275147
NGA,Ingawa,2022,209476,84851,34471,2652,0,331450,37123,0.112001810227787,0.0400010056821039,0.0151117145203734
NGA,Isa,2020,148770,71728,39849,5313,0,265660,45162,0.169999247158022,0.063332831438681,0.0255552209591207
NGA,Isa,2021,140922,92981,53132,13283,0,300318,66415,0.221148915482921,0.0884595661931686,0.0393153627525194
NGA,Isa,2022,125264,91338,60022,10439,0,287063,70461,0.245454830472753,0.0939398900822003,0.0393943721993662
NGA,Isi-uzo,2021,200056,33343,4763,0,0,238162,4763,0.019998992282564,0.00666633076085466,0.00222211025361822
NGA,Isi-uzo,2022,195293,78593,9526,0,0,283412,9526,0.0336118442408931,0.0112039480802977,0.00373464936009924
NGA,Isiala-ngwa north,2021,139553,93930,34888,0,0,268371,34888,0.129999142977445,0.0433330476591485,0.0144443492197162
NGA,Isiala-ngwa north,2022,134186,107349,50991,0,0,292526,50991,0.174312710665035,0.058104236888345,0.0193680789627817
NGA,Isiala-ngwa south,2021,122331,82338,30583,0,0,235252,30583,0.130001020182613,0.0433336733942042,0.0144445577980681
NGA,Isiala-ngwa south,2022,117626,94101,44698,0,0,256425,44698,0.17431217704982,0.0581040590166066,0.0193680196722022
NGA,Isiukwuato,2021,113875,63930,21976,0,0,199781,21976,0.11000045049329,0.0366668168310967,0.0122222722770322
NGA,Isiukwuato,2022,121866,79912,25971,0,0,227749,25971,0.114033431540863,0.0380111438469543,0.0126703812823181
NGA,Itas/gadau,2020,301177,51420,14692,0,0,367289,14692,0.0400011979667238,0.0133337326555746,0.00444457755185819
NGA,Itas/gadau,2021,320748,117532,25710,0,0,463990,25710,0.0554106769542447,0.0184702256514149,0.00615674188380497
NGA,Itas/gadau,2022,320748,52829,18868,0,0,392445,18868,0.0480780746346622,0.0160260248782207,0.00534200829274024
NGA,Jaba,2020,128869,70292,35146,0,0,234307,35146,0.149999786604754,0.0499999288682512,0.0166666429560837
NGA,Jaba,2021,120668,96534,42175,0,0,259377,42175,0.162601155846509,0.0542003852821697,0.0180667950940566
NGA,Jaba,2022,195482,84468,53094,0,0,333044,53094,0.159420376887138,0.053140125629046,0.017713375209682
NGA,Jada,2020,108095,110732,44820,0,0,263647,44820,0.170000037929504,0.0566666793098347,0.0188888931032782
NGA,Jada,2021,214321,131824,65912,0,0,412057,65912,0.159958452350039,0.0533194841166797,0.0177731613722266
NGA,Jada,2022,165489,135647,54259,0,0,355395,54259,0.152672378620971,0.050890792873657,0.0169635976245523
NGA,Jahun,2020,295225,46240,14228,0,0,355693,14228,0.0400007871956997,0.0133335957318999,0.0044445319106333
NGA,Jahun,2021,296466,51241,18300,0,0,366007,18300,0.0499990437341362,0.0166663479113787,0.00555544930379292
NGA,Jahun,2022,296466,76862,32941,0,0,406269,32941,0.0810817463306332,0.0270272487768777,0.00900908292562591
NGA,Jakusko,2020,128782,128782,91987,18397,5,367953,110389,0.300008424989061,0.116677945281055,0.0500124261039378
NGA,Jakusko,2021,205647,165577,110385,29436,5,511050,139826,0.273605322375501,0.110407983563252,0.0496089749861397
NGA,Jakusko,2022,232305,133290,57124,11425,0,434144,68549,0.15789461561141,0.0614035895923933,0.0263158972343022
NGA,Jalingo,2020,180709,27638,4252,0,0,212599,4252,0.0200000940738197,0.00666669802460658,0.00222223267486886
NGA,Jalingo,2021,178583,29764,10630,0,0,218977,10630,0.0485439110043521,0.0161813036681174,0.00539376788937245
NGA,Jalingo,2022,176457,63780,27638,0,0,267875,27638,0.103174988334111,0.034391662778037,0.011463887592679
NGA,Jama'are,2020,154366,26355,7530,0,0,188251,7530,0.039999787517729,0.0133332625059097,0.00444442083530322
NGA,Jama'are,2021,157132,71536,30120,0,0,258788,30120,0.116388704267586,0.0387962347558619,0.012932078251954
NGA,Jama'are,2022,162952,44618,21339,0,0,228909,21339,0.0932204500478356,0.0310734833492785,0.0103578277830928
NGA,Jega,2020,235902,53750,8958,0,0,298610,8958,0.029998995345099,0.00999966511503299,0.003333221705011
NGA,Jega,2021,258608,47778,17917,0,0,324303,17917,0.0552477158706518,0.0184159052902173,0.00613863509673909
NGA,Jega,2022,255530,49259,21551,0,0,326340,21551,0.0660384874670589,0.0220128291556863,0.0073376097185621
NGA,Jema'a,2020,229860,125378,62689,0,0,417927,62689,0.149999880361881,0.0499999601206271,0.0166666533735424
NGA,Jema'a,2021,215233,172186,75227,0,0,462646,75227,0.162601643589267,0.054200547863089,0.0180668492876963
NGA,Jema'a,2022,348677,150663,94702,0,0,594042,94702,0.15941970433067,0.0531399014435567,0.0177133004811856
NGA,Jere,2020,449597,224799,74933,0,0,749329,74933,0.100000133452729,0.0333333778175764,0.0111111259391921
NGA,Jere,2021,635341,262265,164852,22480,0,1084938,187332,0.172666087831747,0.0644620552818072,0.026091813541419
NGA,Jere,2022,519120,232442,178205,38740,0,968507,216945,0.22399941353031,0.0879997081418444,0.0382220606906644
NGA,Jibia,2020,124867,101932,28031,0,0,254830,28031,0.109998822744575,0.0366662742481916,0.0122220914160639
NGA,Jibia,2021,170608,114673,35676,2548,0,323505,38224,0.118155824484938,0.0420106850486597,0.0157538351631179
NGA,Jibia,2022,209980,91866,39371,2625,0,343842,41996,0.122137493383589,0.043257271266066,0.0161156060697129
NGA,Jos east,2020,102073,19629,9160,0,0,130862,9160,0.069997401843163,0.0233324672810543,0.00777748909368478
NGA,Jos east,2021,92913,42740,17363,0,0,153016,17363,0.113471793799341,0.0378239312664471,0.0126079770888157
NGA,Jos east,2022,84145,53425,28048,1336,0,166954,29384,0.176000575008685,0.0613342597362148,0.0222230208453959
NGA,Jos north,2020,505409,97194,45357,0,0,647960,45357,0.0699996913389716,0.0233332304463238,0.00777774348210795
NGA,Jos north,2021,460052,208211,84586,0,0,752849,84586,0.11235453590295,0.03745151196765,0.01248383732255
NGA,Jos north,2022,409916,260264,136639,6507,0,813326,143146,0.176000767220032,0.0613337497305304,0.0222224681260787
NGA,Jos south,2020,359959,69223,32304,0,0,461486,32304,0.0699999566617406,0.0233333188872469,0.00777777296241562
NGA,Jos south,2021,327655,148540,60344,0,0,536539,60344,0.112468991070547,0.0374896636901822,0.0124965545633941
NGA,Jos south,2022,292437,185674,97479,4642,0,580232,102121,0.176000289539357,0.0613335125719827,0.0222223371187923
NGA,Kabo,2020,206865,34072,2434,0,0,243371,2434,0.0100011915963693,0.00333373053212311,0.0011112435107077
NGA,Kabo,2021,203636,41373,7542,0,0,252551,7542,0.0298632751404667,0.00995442504682223,0.00331814168227408
NGA,Kabo,2022,203636,103075,12570,0,0,319281,12570,0.0393697088144926,0.0131232362714975,0.00437441209049917
NGA,Kachia,2020,208680,113825,56913,0,0,379418,56913,0.15000079068468,0.0500002635615601,0.01666675452052
NGA,Kachia,2021,195400,156320,68295,0,0,420015,68295,0.162601335666583,0.0542004452221944,0.0180668150740648
NGA,Kachia,2022,316548,136780,85976,0,0,539304,85976,0.159420289855072,0.0531400966183575,0.0177133655394525
NGA,Kaduna north,2020,328609,153351,65722,0,0,547682,65722,0.12000029214033,0.0400000973801099,0.01333336579337
NGA,Kaduna north,2021,310261,197439,82152,0,0,589852,82152,0.139275614900009,0.0464252049666696,0.0154750683222232
NGA,Kaduna north,2022,304620,265132,124105,0,0,693857,124105,0.17886250336885,0.0596208344562833,0.0198736114854278
NGA,Kaduna south,2020,363001,169400,72600,0,0,605001,72600,0.11999980165322,0.0399999338844068,0.0133333112948023
NGA,Kaduna south,2021,342733,218103,90750,0,0,651586,90750,0.139275552267851,0.0464251840892837,0.0154750613630946
NGA,Kaduna south,2022,336502,292881,137093,0,0,766476,137093,0.178861438583857,0.0596204795279522,0.0198734931759841
NGA,Kafin hausa,2020,318444,57899,37221,0,0,413564,37221,0.0900005803213046,0.0300001934404349,0.010000064480145
NGA,Kafin hausa,2021,353212,62035,45492,0,0,460739,45492,0.0987370289903828,0.0329123429967943,0.0109707809989314
NGA,Kafin hausa,2022,365979,59578,25533,0,0,451090,25533,0.0566028952093817,0.0188676317364606,0.00628921057882019
NGA,Kafur,2020,159319,127455,31864,0,0,318638,31864,0.100000627671527,0.0333335425571757,0.0111111808523919
NGA,Kafur,2021,187072,143387,44609,0,0,375068,44609,0.118935766314375,0.039645255438125,0.0132150851460417
NGA,Kafur,2022,137843,131279,114869,16410,0,400401,131279,0.327868811516455,0.122950908381015,0.0500911724884692
NGA,Kaga,2020,48252,51276,63899,28532,0,191959,92431,0.481514281695571,0.210050062773822,0.103046889063695
NGA,Kaga,2021,73275,44965,79939,41285,0,239464,121224,0.506230581632312,0.22621215158298,0.113716466775799
NGA,Kaga,2022,59952,49294,37304,9326,0,155876,46630,0.29914804075034,0.119659216300136,0.0531818739111716
NGA,Kagarko,2020,197284,107609,53805,0,0,358698,53805,0.150000836358162,0.050000278786054,0.0166667595953513
NGA,Kagarko,2021,184729,147784,64566,0,0,397079,64566,0.162602404055616,0.054200801351872,0.0180669337839573
NGA,Kagarko,2022,299262,129311,81281,0,0,509854,81281,0.159420147728565,0.0531400492428552,0.0177133497476184
NGA,Kaita,2020,136031,111045,30537,0,0,277613,30537,0.109998451081181,0.0366661503603938,0.0122220501201313
NGA,Kaita,2021,185862,124926,38866,2776,0,352430,41642,0.118156797094458,0.0420111795250121,0.0157541135040213
NGA,Kaita,2022,228754,100080,42891,2859,0,374584,45750,0.122135488969096,0.0432559853063665,0.0161147655354562
NGA,Kajuru,2020,98977,46189,19795,0,0,164961,19795,0.11999806014755,0.0399993533825167,0.0133331177941722
NGA,Kajuru,2021,93450,59468,24744,0,0,177662,24744,0.139275703301775,0.0464252344339251,0.0154750781446417
NGA,Kajuru,2022,91751,79858,37380,0,0,208989,37380,0.178861088382642,0.0596203627942141,0.019873454264738
NGA,Kala/balge,2020,48057,42050,26432,3604,0,120143,30036,0.250002080853649,0.093333222354472,0.0377772043869944
NGA,Kala/balge,2021,45965,55903,30036,6007,0,137911,36043,0.261349711045529,0.101635595903638,0.0435578823379652
NGA,Kala/balge,2022,74537,49691,43480,6211,0,173919,49691,0.285713464313847,0.107141830392309,0.0436499494336763
NGA,Kalgo,2020,101310,23083,3847,0,0,128240,3847,0.0299984404242046,0.00999948014140154,0.00333316004713385
NGA,Kalgo,2021,111061,20518,7694,0,0,139273,7694,0.0552440171461805,0.0184146723820602,0.00613822412735339
NGA,Kalgo,2022,109738,21154,9255,0,0,140147,9255,0.0660378031638209,0.0220126010546069,0.00733753368486898
NGA,Kaltungo,2020,182746,38354,4512,0,0,225612,4512,0.0199989362267965,0.00666631207559882,0.00222210402519961
NGA,Kaltungo,2021,175977,60915,24817,0,0,261709,24817,0.0948266968273922,0.0316088989424641,0.010536299647488
NGA,Kaltungo,2022,182746,67684,29330,0,0,279760,29330,0.104839862739491,0.0349466209131637,0.0116488736377212
NGA,Kanam,2020,208667,34778,4968,0,0,248413,4968,0.0199989533559033,0.00666631778530109,0.0022221059284337
NGA,Kanam,2021,201215,62778,20089,0,0,284082,20089,0.0707154976380059,0.023571832546002,0.00785727751533399
NGA,Kanam,2022,156968,75334,27622,0,0,259924,27622,0.106269524938059,0.0354231749793529,0.0118077249931176
NGA,Kankara,2020,185115,148092,37023,0,0,370230,37023,0.1,0.0333333333333333,0.0111111111111111
NGA,Kankara,2021,217363,166604,51832,0,0,435799,51832,0.118935564331263,0.0396451881104209,0.0132150627034736
NGA,Kankara,2022,160162,152535,133468,19067,0,465232,152535,0.327868676273343,0.122950843163554,0.0500911373250335
NGA,Kanke,2020,154700,25783,3683,0,0,184166,3683,0.0199982624371491,0.0066660874790497,0.00222202915968323
NGA,Kanke,2021,149175,46717,14949,0,0,210841,14949,0.0709017695799204,0.0236339231933068,0.00787797439776894
NGA,Kanke,2022,376382,62730,22404,0,0,461516,22404,0.048544362492308,0.0161814541641027,0.00539381805470088
NGA,Kankia,2020,191246,34563,4608,0,0,230417,4608,0.0199985244144312,0.00666617480481041,0.00222205826827014
NGA,Kankia,2021,182029,54586,18986,0,0,255601,18986,0.0742798345859367,0.0247599448619789,0.00825331495399296
NGA,Kankia,2022,187491,75946,30853,2373,0,296663,33226,0.111999137067986,0.03999937077874,0.0151106736525208
NGA,Kano municipal,2020,430636,129781,29496,0,0,589913,29496,0.0500005933078267,0.0166668644359422,0.00555562147864742
NGA,Kano municipal,2021,493598,206470,53092,0,0,753160,53092,0.0704923256678528,0.0234974418892843,0.00783248062976142
NGA,Kano municipal,2022,383909,243752,54844,0,0,682505,54844,0.0803569204621212,0.0267856401540404,0.00892854671801346
NGA,Karasuwa,2020,85924,60147,20622,5155,3,171851,25780,0.150013674636749,0.0600151681786354,0.0266826753667098
NGA,Karasuwa,2021,145848,46399,44681,17185,3,254116,61869,0.243467550252641,0.103705919081574,0.0496046424992261
NGA,Karasuwa,2022,113833,85375,32015,5336,0,236559,37351,0.157892956936747,0.0601498991794859,0.0250625754157643
NGA,Karaye,2020,199134,27467,2289,0,0,228890,2289,0.0100004368910831,0.00333347896369435,0.00111115965456478
NGA,Karaye,2021,198612,34334,4729,0,0,237675,4729,0.0198969180603766,0.00663230602012552,0.00221076867337517
NGA,Karaye,2022,208070,37831,9458,0,0,255359,9458,0.0370380523106685,0.0123460174368895,0.00411533914562984
NGA,Karim-lamido,2021,237994,41135,14691,0,0,293820,14691,0.05,0.0166666666666667,0.00555555555555555
NGA,Karim-lamido,2022,243871,88146,38197,0,0,370214,38197,0.103175460679499,0.0343918202264996,0.0114639400754999
NGA,Karin-lamido,2020,249747,38197,5876,0,0,293820,5876,0.0199986386222858,0.00666621287409525,0.00222207095803175
NGA,Karin-lamido,2021,246809,38197,8815,0,0,293821,8815,0.0300012592700998,0.0100004197566999,0.00333347325223331
NGA,Katagum,2020,392296,66170,14179,0,0,472645,14179,0.0299992594865068,0.00999975316216893,0.00333325105405631
NGA,Katagum,2021,416106,108708,23632,0,0,548446,23632,0.0430890187912757,0.0143630062637586,0.00478766875458619
NGA,Katagum,2022,406429,125799,29031,0,0,561259,29031,0.0517247830324324,0.0172415943441441,0.00574719811471472
NGA,Katcha,2020,88802,71428,32818,0,0,193048,32818,0.169999171190585,0.0566663903968616,0.0188887967989539
NGA,Katcha,2021,167690,77219,34749,0,0,279658,34749,0.124255340451552,0.0414184468171838,0.0138061489390613
NGA,Katcha,2022,169686,29945,7985,0,0,207616,7985,0.0384604269420469,0.0128201423140156,0.00427338077133854
NGA,Katsina,2020,237250,193674,53260,0,0,484184,53260,0.109999504320671,0.0366665014402238,0.0122221671467413
NGA,Katsina,2021,324162,217883,67786,4842,0,614673,72628,0.118157133955778,0.0420114977123338,0.015754356833272
NGA,Katsina,2022,398968,174549,74807,4987,0,653311,79794,0.122137848589722,0.0432570909311696,0.0161153468001202
NGA,Katsina-ala,2020,288253,41179,13726,0,0,343158,13726,0.0399990674849486,0.0133330224949829,0.00444434083166096
NGA,Katsina-ala,2021,295146,47369,21863,0,0,364378,21863,0.060000878208893,0.0200002927362977,0.00666676424543255
NGA,Katsina-ala,2022,291034,109313,35492,0,0,435839,35492,0.0814337404408509,0.0271445801469503,0.00904819338231676
NGA,Kaugama,2020,153669,27940,17961,0,0,199570,17961,0.0899984967680513,0.0299994989226838,0.00999983297422792
NGA,Kaugama,2021,170447,29936,21953,0,0,222336,21953,0.0987379461715602,0.0329126487238534,0.0109708829079511
NGA,Kaugama,2022,176607,28750,12321,0,0,217678,12321,0.05660195334393,0.01886731778131,0.00628910592710334
NGA,Kaura,2020,144281,78699,39349,0,0,262329,39349,0.149998665797529,0.049999555265843,0.0166665184219477
NGA,Kaura,2021,135099,108080,47219,0,0,290398,47219,0.162600982100428,0.0542003273668092,0.0180667757889364
NGA,Kaura,2022,218861,94570,59444,0,0,372875,59444,0.159420717398592,0.053140239132864,0.017713413044288
NGA,Kaura namoda,2021,262579,135817,54327,0,0,452723,54327,0.120000530125485,0.040000176708495,0.013333392236165
NGA,Kaura namoda,2022,226361,194670,108653,4527,0,534211,113180,0.211863851549294,0.0734460104091205,0.0263651545092773
NGA,Kauru,2020,182824,99722,49861,0,0,332407,49861,0.149999849581988,0.0499999498606628,0.0166666499535543
NGA,Kauru,2021,171190,136952,59833,0,0,367975,59833,0.162600720157619,0.0542002400525398,0.0180667466841799
NGA,Kauru,2022,277328,119833,75324,0,0,472485,75324,0.159420933997905,0.0531403113326349,0.0177134371108783
NGA,Kazaure,2020,201983,34911,12468,0,0,249362,12468,0.0499995989765883,0.0166665329921961,0.00555551099739869
NGA,Kazaure,2021,207840,34911,15396,0,0,258147,15396,0.059640437425188,0.019880145808396,0.00662671526946533
NGA,Kazaure,2022,189879,53885,35923,0,0,279687,35923,0.128440006149732,0.0428133353832439,0.0142711117944146
NGA,Kebbe,2020,126988,101590,25398,0,0,253976,25398,0.100001574951964,0.0333338583173213,0.0111112861057738
NGA,Kebbe,2021,154089,114289,46227,0,0,314605,46227,0.1469366348278,0.0489788782759333,0.0163262927586444
NGA,Kebbe,2022,141248,82181,59067,5136,0,287632,64203,0.223212299048785,0.0803561495243923,0.0307534164024402
NGA,Kibiya,2020,191631,26432,2203,0,0,220266,2203,0.010001543588207,0.00333384786273566,0.00111128262091189
NGA,Kibiya,2021,191129,33040,4551,0,0,228720,4551,0.0198976915005247,0.00663256383350822,0.00221085461116941
NGA,Kibiya,2022,200231,36406,9101,0,0,245738,9101,0.0370353791436408,0.0123451263812136,0.0041150421270712
NGA,Kirfi,2020,200376,30646,4715,0,0,235737,4715,0.0200011029240213,0.00666703430800709,0.0022223447693357
NGA,Kirfi,2021,194788,36072,9619,0,0,240479,9619,0.0399993346612386,0.0133331115537462,0.0044443705179154
NGA,Kirfi,2022,202002,55310,16834,0,0,274146,16834,0.0614052366257396,0.0204684122085799,0.00682280406952662
NGA,Kiri kasamma,2020,229445,41717,26818,0,0,297980,26818,0.0899993288140144,0.0299997762713381,0.00999992542377937
NGA,Kiri kasamma,2021,254496,44697,32778,0,0,331971,32778,0.0987375403273177,0.0329125134424393,0.0109708378141464
NGA,Kiri kasamma,2022,263695,42927,18397,0,0,325019,18397,0.0566028447567681,0.0188676149189227,0.00628920497297423
NGA,Kiru,2020,369345,50944,4245,0,0,424534,4245,0.00999919912186068,0.00333306637395356,0.00111102212465119
NGA,Kiru,2021,368378,63680,8771,0,0,440829,8771,0.0198966038985638,0.00663220129952128,0.00221073376650709
NGA,Kiru,2022,385920,70167,17542,0,0,473629,17542,0.0370374280291114,0.0123458093430371,0.00411526978101238
NGA,Kiyawa,2020,222113,34789,10704,0,0,267606,10704,0.039999103159122,0.013333034386374,0.004444344795458
NGA,Kiyawa,2021,223047,38551,13768,0,0,275366,13768,0.0499989105408801,0.0166663035136267,0.00555543450454224
NGA,Kiyawa,2022,223047,57827,24783,0,0,305657,24783,0.0810810810810811,0.027027027027027,0.00900900900900901
NGA,Koko/besse,2020,184680,42079,7013,0,0,233772,7013,0.0299993155724381,0.00999977185747937,0.00333325728582646
NGA,Koko/besse,2021,202456,37404,14026,0,0,253886,14026,0.0552452675610313,0.0184150891870104,0.00613836306233681
NGA,Koko/besse,2022,200046,38563,16871,0,0,255480,16871,0.0660364803507124,0.0220121601169041,0.00733738670563471
NGA,Konduga,2020,97663,76773,66680,17143,0,258259,83823,0.324569521294514,0.13031620711508,0.0581896468274097
NGA,Konduga,2021,141377,99778,91801,30056,0,363012,121857,0.335683117913457,0.13949309297397,0.0648968445487569
NGA,Konduga,2022,98459,106033,83312,10098,0,297902,93410,0.313559492719082,0.11581884870416,0.0461389614332529
NGA,Konshisha,2020,289558,41365,13788,0,0,344711,13788,0.0399987235684385,0.0133329078561462,0.00444430261871539
NGA,Konshisha,2021,296483,47584,21962,0,0,366029,21962,0.060000710326231,0.0200002367754103,0.00666674559180344
NGA,Konshisha,2022,297056,109808,36226,0,0,443090,36226,0.0817576564580559,0.0272525521526853,0.0090841840508951
NGA,Kontagora,2020,131710,86978,29821,0,0,248509,29821,0.11999967808007,0.0399998926933565,0.0133332975644522
NGA,Kontagora,2021,210726,106859,32306,0,0,349891,32306,0.0923316118448317,0.0307772039482772,0.0102590679827591
NGA,Kontagora,2022,192737,105363,35978,2570,0,336648,38548,0.114505358712958,0.0407131484517953,0.015267513182249
NGA,Kosofe,2021,1082942,355824,108294,0,0,1547060,108294,0.0699998707225318,0.0233332902408439,0.00777776341361464
NGA,Kosofe,2022,1229253,449727,194882,0,0,1873862,194882,0.104000187847344,0.0346667292824481,0.0115555764274827
NGA,Kubau,2020,295180,96988,29518,0,0,421686,29518,0.0699999525713446,0.0233333175237815,0.00777777250792717
NGA,Kubau,2021,277975,130301,42169,0,0,450445,42169,0.0936163127573844,0.0312054375857948,0.0104018125285983
NGA,Kubau,2022,356156,130301,39090,0,0,525547,39090,0.0743796463494226,0.0247932154498075,0.00826440514993584
NGA,Kudan,2020,146122,48011,14612,0,0,208745,14612,0.0699992814199143,0.0233330938066381,0.00777769793554603
NGA,Kudan,2021,137605,64502,20875,0,0,222982,20875,0.0936174220340655,0.0312058073446885,0.0104019357815628
NGA,Kudan,2022,176306,64502,19351,0,0,260159,19351,0.0743814359680042,0.0247938119893347,0.00826460399644491
NGA,Kuje,2020,329219,171099,89680,0,0,589998,89680,0.152000515255984,0.0506668384186613,0.0168889461395538
NGA,Kuje,2021,535240,227149,102069,1770,0,866228,103839,0.119874905913916,0.040639415950535,0.0140005479696646
NGA,Kuje,2022,502997,167264,130095,0,0,800356,130095,0.162546416844504,0.0541821389481681,0.0180607129827227
NGA,Kukawa,2020,27647,27647,33176,22117,0,110587,55293,0.4999954786729,0.233330620537073,0.122220514165318
NGA,Kukawa,2021,29359,46974,55294,27647,0,159274,82941,0.520744126473875,0.231441833988389,0.115720916994195
NGA,Kukawa,2022,31707,52845,38753,17615,0,140920,56368,0.4,0.175,0.0861111111111111
NGA,Kumbotso,2020,341489,102915,23390,0,0,467794,23390,0.0500006413079261,0.0166668804359754,0.00555562681199179
NGA,Kumbotso,2021,391417,163728,42101,0,0,597246,42101,0.0704918911135445,0.0234972970378482,0.00783243234594939
NGA,Kumbotso,2022,304436,193292,43491,0,0,541219,43491,0.0803574892973085,0.0267858297657695,0.00892860992192317
NGA,Kunchi,2020,148803,24509,1751,0,0,175063,1751,0.0100021135248453,0.00333403784161511,0.00111134594720504
NGA,Kunchi,2021,146480,29761,5425,0,0,181666,5425,0.0298624949082382,0.00995416496941273,0.00331805498980424
NGA,Kunchi,2022,146480,74144,9042,0,0,229666,9042,0.0393702158787108,0.0131234052929036,0.00437446843096787
NGA,Kura,2020,165987,50023,11369,0,0,227379,11369,0.0500002198971761,0.0166667399657254,0.00555557998857512
NGA,Kura,2021,190255,79583,20464,0,0,290302,20464,0.0704921082183382,0.0234973694061127,0.00783245646870424
NGA,Kura,2022,147976,93953,21139,0,0,263068,21139,0.0803556494898657,0.0267852164966219,0.00892840549887397
NGA,Kurfi,2020,87030,71045,19537,0,0,177612,19537,0.109998198319933,0.0366660661066444,0.0122220220355481
NGA,Kurfi,2021,118912,79926,24866,1776,0,225480,26642,0.11815682100408,0.042011117024422,0.0157540456901819
NGA,Kurfi,2022,146353,64029,27441,1829,0,239652,29270,0.122135429706408,0.0432557764313811,0.0161145698299571
NGA,Kurmi,2020,121708,13830,2766,0,0,138304,2766,0.0199994215640907,0.0066664738546969,0.00222215795156563
NGA,Kurmi,2021,118941,19363,5532,0,0,143836,5532,0.0384604688673211,0.012820156289107,0.00427338542970235
NGA,Kurmi,2022,116175,17980,7924,0,0,142079,7924,0.0557717889343253,0.0185905963114418,0.00619686543714725
NGA,Kusada,2020,124236,22452,2994,0,0,149682,2994,0.0200024050988095,0.00666746836626983,0.00222248945542328
NGA,Kusada,2021,118249,35460,12334,0,0,166043,12334,0.0742819631059424,0.0247606543686475,0.00825355145621583
NGA,Kusada,2022,121796,49335,20042,1542,0,192715,21584,0.111999584879226,0.0400003459339785,0.0151115492941505
NGA,Kwali,2020,254049,164385,74720,4981,0,498135,79701,0.159998795507242,0.0566660309621555,0.0211107430716573
NGA,Kwali,2021,451903,184310,79702,9963,0,725878,89665,0.123526267499497,0.0457505714918118,0.0183002898252568
NGA,Kwali,2022,424680,141221,109839,0,0,675740,109839,0.162546245597419,0.0541820818658064,0.0180606939552688
NGA,Kwami,2020,241183,47060,5883,0,0,294126,5883,0.0200016319536525,0.00666721065121751,0.00222240355040584
NGA,Kwami,2021,241183,55884,11765,0,0,308832,11765,0.0380951455807688,0.0126983818602563,0.00423279395341876
NGA,Kwami,2022,244125,73532,26471,0,0,344128,26471,0.0769219592709689,0.025640653090323,0.00854688436344099
NGA,Kwande,2020,317876,45411,15137,0,0,378424,15137,0.0400001057015411,0.0133333685671804,0.00444445618906013
NGA,Kwande,2021,325477,52237,24109,0,0,401823,24109,0.0599990543099823,0.0199996847699941,0.00666656158999803
NGA,Kwande,2022,323762,120547,39483,0,0,483792,39483,0.0816115189999008,0.0272038396666336,0.00906794655554453
NGA,Kware,2020,72490,57066,23135,1542,0,154233,24677,0.159998184564912,0.0566653483149953,0.0211101961894594
NGA,Kware,2021,128677,69405,24677,4627,0,227386,29304,0.128873369512635,0.0497406759137912,0.0211021493554279
NGA,Kware,2022,108025,42892,23829,1589,0,176335,25418,0.144146085575751,0.0510524475193996,0.0190199840581217
NGA,Kwaya kusar,2020,115634,20898,2786,0,0,139318,2786,0.0199974159835771,0.00666580532785905,0.00222193510928635
NGA,Kwaya kusar,2021,118124,34829,6966,0,0,159919,6966,0.0435595520232118,0.0145198506744039,0.00483995022480131
NGA,Kwaya kusar,2022,100838,40335,17286,0,0,158459,17286,0.109088155295692,0.0363627184318972,0.0121209061439657
NGA,Lagos island,2021,839748,426991,156563,0,0,1423302,156563,0.109999845429853,0.0366666151432842,0.0122222050477614
NGA,Lagos island,2022,896460,498156,170796,0,0,1565412,170796,0.109106101141425,0.0363687003804749,0.012122900126825
NGA,Lagos mainland,2021,614754,312587,114615,0,0,1041956,114615,0.109999846442652,0.036666615480884,0.0122222051602947
NGA,Lagos mainland,2022,656271,364685,125035,0,0,1145991,125035,0.109106441499104,0.0363688138330348,0.0121229379443449
NGA,Lamurde,2020,71394,73135,29602,0,0,174131,29602,0.169998449443235,0.0566661498144118,0.0188887166048039
NGA,Lamurde,2021,71673,87066,43533,0,0,202272,43533,0.215220099667774,0.0717400332225914,0.0239133444075305
NGA,Lamurde,2022,91383,84216,34045,0,0,209644,34045,0.162394344698632,0.0541314482328773,0.0180438160776258
NGA,Langtang north,2020,179277,27419,4218,0,0,210914,4218,0.0199986724446931,0.00666622414823103,0.00222207471607701
NGA,Langtang north,2021,173027,29906,10681,0,0,213614,10681,0.0500014044023332,0.0166671348007777,0.00555571160025924
NGA,Langtang north,2022,173027,64084,25634,0,0,262745,25634,0.0975622752098042,0.0325207584032681,0.0108402528010894
NGA,Langtang south,2020,132487,20263,3117,0,0,155867,3117,0.0199978186530824,0.00666593955102748,0.00222197985034249
NGA,Langtang south,2021,128439,22199,7928,0,0,158566,7928,0.0499981080433384,0.0166660360144461,0.00555534533814871
NGA,Langtang south,2022,128439,47570,19028,0,0,195037,19028,0.0975609756097561,0.032520325203252,0.010840108401084
NGA,Lapai,2020,84531,67992,31240,0,0,183763,31240,0.170001578119643,0.0566671927065478,0.0188890642355159
NGA,Lapai,2021,159624,73505,33077,0,0,266206,33077,0.124253397744604,0.0414177992482013,0.0138059330827338
NGA,Lapai,2022,161525,28504,7601,0,0,197630,7601,0.038460760006072,0.0128202533353573,0.00427341777845244
NGA,Lau,2020,122591,18749,2885,0,0,144225,2885,0.0200034668053389,0.00666782226844629,0.00222260742281543
NGA,Lau,2021,121149,20192,7211,0,0,148552,7211,0.0485419247132317,0.0161806415710772,0.00539354719035908
NGA,Lau,2022,119707,43268,18749,0,0,181724,18749,0.103172943584777,0.0343909811949256,0.0114636603983085
NGA,Lavun,2020,154188,124021,56983,0,0,335192,56983,0.170001074011313,0.0566670246704376,0.0188890082234792
NGA,Lavun,2021,291162,134077,60335,0,0,485574,60335,0.12425500541627,0.0414183351387567,0.0138061117129189
NGA,Lavun,2022,294629,51993,13865,0,0,360487,13865,0.0384618585413621,0.0128206195137874,0.00427353983792912
NGA,Lere,2020,357261,117386,35726,0,0,510373,35726,0.0699997844713572,0.0233332614904524,0.0077777538301508
NGA,Lere,2021,336438,157705,51037,0,0,545180,51037,0.093614952859606,0.0312049842865353,0.0104016614288451
NGA,Lere,2022,431061,157705,47312,0,0,636078,47312,0.0743808149315021,0.0247936049771674,0.00826453499238912
NGA,Logo,2020,216786,30969,10323,0,0,258078,10323,0.039999535024295,0.0133331783414317,0.00444439278047722
NGA,Logo,2021,221971,35625,16442,0,0,274038,16442,0.0599989782438932,0.0199996594146311,0.00666655313821035
NGA,Logo,2022,208194,82211,25390,0,0,315795,25390,0.0804002596621226,0.0268000865540409,0.00893336218468029
NGA,Machina,2020,45873,43688,17475,2184,2,109222,19661,0.180009521891194,0.0666807053524015,0.0266826585608516
NGA,Machina,2021,96087,49149,32766,5461,2,183465,38229,0.208372169078571,0.0793866223348686,0.0330841183755909
NGA,Machina,2022,91565,33913,27130,5652,0,158260,32782,0.207140149121698,0.0809511773874216,0.0349200331381552
NGA,Madagali,2020,95910,68732,40054,6826,0,211522,46880,0.221631792437666,0.0846342224449466,0.0353827130143542
NGA,Madagali,2021,104474,88814,57431,8646,0,259365,66077,0.254764521041775,0.096033260720092,0.0394189227108087
NGA,Madagali,2022,89239,89239,63120,10883,0,252481,74003,0.293103243412376,0.112069158999423,0.046935104907784
NGA,Madobi,2020,159713,48133,10939,0,0,218785,10939,0.049998857325685,0.0166662857752283,0.00555542859174278
NGA,Madobi,2021,183063,76575,19691,0,0,279329,19691,0.0704939336767754,0.0234979778922585,0.00783265929741949
NGA,Madobi,2022,142383,90402,20340,0,0,253125,20340,0.0803555555555556,0.0267851851851852,0.0089283950617284
NGA,Mafa,2020,56133,50071,27793,4141,0,138138,31934,0.23117462247897,0.0870506305288914,0.0356784922002313
NGA,Mafa,2021,71263,54394,37980,2584,0,166221,40564,0.244036553744713,0.0865273741986071,0.0322970289220041
NGA,Mafa,2022,58760,43758,31256,5001,0,138775,36257,0.261264637002342,0.0991004623791509,0.0410416541564083
NGA,Magama,2020,153623,101449,34782,0,0,289854,34782,0.119998343993873,0.0399994479979576,0.0133331493326525
NGA,Magama,2021,245785,124637,37681,0,0,408103,37681,0.0923320828320301,0.0307773609440101,0.01025912031467
NGA,Magama,2022,224804,122893,41963,2997,0,392657,44960,0.114501969912672,0.0407115285520611,0.0152666463492452
NGA,Magumeri,2020,101733,115826,118910,59898,0,396367,178808,0.45111727262865,0.200744932516245,0.100496649709879
NGA,Magumeri,2021,116575,118467,152821,96894,0,484757,249715,0.515134386919632,0.238338659025725,0.123864350821362
NGA,Magumeri,2022,102003,119489,90345,31366,3648,346851,125359,0.36142032169433,0.157628683978615,0.0796502757027593
NGA,Mai'adua,2020,254920,46070,6143,0,0,307133,6143,0.0200011070122716,0.00666703567075719,0.00222234522358573
NGA,Mai'adua,2021,242634,72760,25308,0,0,340702,25308,0.0742819237926399,0.0247606412642133,0.0082535470880711
NGA,Mai'adua,2022,249913,101231,41125,3163,0,395432,44288,0.111999028910154,0.0399992919136539,0.0151106188225086
NGA,Maiduguri,2020,464285,325000,139286,0,0,928571,139286,0.150000376923251,0.0500001256410836,0.0166667085470279
NGA,Maiduguri,2021,624092,371428,278571,46429,0,1320520,325000,0.246115166752491,0.0937582669453448,0.0390660076670133
NGA,Maiduguri,2022,576085,316847,201630,19203,0,1113765,220833,0.198276117493367,0.0718392120420376,0.0277778525990671
NGA,Maigatari,2020,221905,38354,13698,0,0,273957,13698,0.0500005475311819,0.0166668491770606,0.00555561639235355
NGA,Maigatari,2021,228341,38354,16914,0,0,283609,16914,0.0596384458885296,0.0198794819628432,0.0066264939876144
NGA,Maigatari,2022,208607,59199,39466,0,0,307272,39466,0.128439948970293,0.0428133163234311,0.0142711054411437
NGA,Maiha,2020,68978,77600,25867,0,0,172445,25867,0.150001449737597,0.0500004832458658,0.0166668277486219
NGA,Maiha,2021,106467,86222,31040,0,0,223729,31040,0.138739278323329,0.0462464261077762,0.0154154753692587
NGA,Maiha,2022,120663,85174,33715,0,0,239552,33715,0.140741884851723,0.0469139616172411,0.015637987205747
NGA,Maiyama,2020,207274,47227,7871,0,0,262372,7871,0.0299993901788301,0.00999979672627668,0.00333326557542556
NGA,Maiyama,2021,227225,41980,15742,0,0,284947,15742,0.0552453614180883,0.0184151204726961,0.0061383734908987
NGA,Maiyama,2022,224520,43281,18935,0,0,286736,18935,0.0660363539981028,0.0220121179993676,0.00733737266645586
NGA,Makoda,2020,297274,48963,3497,0,0,349734,3497,0.00999902783258133,0.00333300927752711,0.00111100309250904
NGA,Makoda,2021,292633,59455,10838,0,0,362926,10838,0.0298628370521814,0.00995427901739381,0.00331809300579794
NGA,Makoda,2022,292633,148123,18064,0,0,458820,18064,0.0393705592607123,0.0131235197535708,0.00437450658452358
NGA,Makurdi,2020,384016,59431,13715,0,0,457162,13715,0.0300003062371763,0.0100001020790588,0.00333336735968626
NGA,Makurdi,2021,402909,64003,29126,0,0,496038,29126,0.0587172756925881,0.0195724252308627,0.0065241417436209
NGA,Makurdi,2022,393272,58252,33980,0,0,485504,33980,0.069989124703401,0.023329708234467,0.007776569411489
NGA,Malam madori,2021,217769,31485,13119,0,0,262373,13119,0.0500013339787249,0.0166671113262416,0.00555570377541388
NGA,Malam madori,2022,225640,36732,15742,0,0,278114,15742,0.0566026881063161,0.0188675627021054,0.00628918756736846
NGA,Malam-maduri,2020,196333,35697,22948,0,0,254978,22948,0.0899999215618602,0.0299999738539534,0.00999999128465114
NGA,Malam-maduri,2021,188684,38247,28048,0,0,254979,28048,0.110001215786398,0.0366670719287994,0.0122223573095998
NGA,Malumfashi,2020,139177,111341,27835,0,0,278353,27835,0.0999989222318423,0.0333329740772808,0.0111109913590936
NGA,Malumfashi,2021,163421,125259,38969,0,0,327649,38969,0.118935201999701,0.0396450673332336,0.0132150224444112
NGA,Malumfashi,2022,120416,114682,100346,14335,0,349779,114681,0.327867024606966,0.122950015104776,0.0500906763032277
NGA,Mangu,2020,374114,62352,8907,0,0,445373,8907,0.0199989671578654,0.00666632238595514,0.00222210746198505
NGA,Mangu,2021,360753,112019,35846,0,0,508618,35846,0.0704772540492079,0.0234924180164026,0.00783080600546754
NGA,Mangu,2022,264364,134422,49288,0,0,448074,49288,0.10999968755161,0.0366665625172033,0.0122221875057344
NGA,Mani,2020,222708,40248,5366,0,0,268322,5366,0.0199983601791877,0.00666612005972923,0.00222204001990974
NGA,Mani,2021,211975,63566,22110,0,0,297651,22110,0.0742816251247266,0.0247605417082422,0.0082535139027474
NGA,Mani,2022,218335,88439,35928,2764,0,345466,38692,0.111999444228955,0.040000077190423,0.0151113118062109
NGA,Maradun,2021,183202,101779,54282,0,0,339263,54282,0.15999976419474,0.0533332547315799,0.0177777515771933
NGA,Maradun,2022,193380,118742,74638,6785,0,393545,81423,0.206896288861503,0.0747123370050863,0.0287353839247524
NGA,Mariga,2020,168971,111584,38257,0,0,318812,38257,0.119998619876291,0.0399995399587636,0.0133331799862545
NGA,Mariga,2021,270341,137089,41446,0,0,448876,41446,0.0923328491610155,0.0307776163870052,0.0102592054623351
NGA,Mariga,2022,247263,135170,46156,3297,0,431886,49453,0.114504753569229,0.0407129041768738,0.0152674033837119
NGA,Markafi,2020,154133,50644,15413,0,0,220190,15413,0.0699986375403061,0.023332879180102,0.00777762639336735
NGA,Markafi,2021,145149,68039,22019,0,0,235207,22019,0.093615411105962,0.0312051370353207,0.0104017123451069
NGA,Markafi,2022,185972,68039,20412,0,0,274423,20412,0.074381520499375,0.0247938401664584,0.00826461338881945
NGA,Marte,2020,0,6071,10927,7285,0,24283,18212,0.749989704731705,0.349997940946341,0.183333562117073
NGA,Marte,2021,0,4856,10927,8499,0,24282,19426,0.800016473107652,0.38334294264613,0.205561504177763
NGA,Marte,2022,6704,11603,6446,2063,0,26816,8509,0.317310560859189,0.131414081145585,0.0609006231768762
NGA,Maru,2021,225442,164385,79844,0,0,469671,79844,0.169999850959501,0.0566666169865005,0.0188888723288335
NGA,Maru,2022,258320,187869,108024,14090,0,568303,122114,0.214874811500203,0.0798893078750831,0.0321393497639268
NGA,Mashegu,2020,182173,120303,41247,0,0,343723,41247,0.120000698236662,0.0400002327455538,0.0133334109151846
NGA,Mashegu,2021,291463,147800,44684,0,0,483947,44684,0.0923324248316448,0.0307774749438816,0.0102591583146272
NGA,Mashegu,2022,266582,145732,49762,3554,0,465630,53316,0.114502931512145,0.0407118670761477,0.01526677118456
NGA,Mashi,2020,216100,39054,5207,0,0,260361,5207,0.0199991550193769,0.00666638500645898,0.00222212833548633
NGA,Mashi,2021,205686,61680,21454,0,0,288820,21454,0.0742815594487916,0.0247605198162639,0.00825350660542129
NGA,Mashi,2022,211857,85815,34862,2682,0,335216,37544,0.111999427234977,0.0400000795506977,0.015111317942925
NGA,Matazu,2021,101698,53525,23194,0,0,178417,23194,0.129998822982115,0.0433329409940383,0.0144443136646794
NGA,Matazu,2022,74935,71367,62446,8921,0,217669,71367,0.327869379654429,0.122951208792555,0.0500913466471263
NGA,Matazuu,2020,86610,69288,17322,0,0,173220,17322,0.1,0.0333333333333333,0.0111111111111111
NGA,Matazuu,2021,71020,77949,24251,0,0,173220,24251,0.140001154601085,0.0466670515336951,0.015555683844565
NGA,Mayo-belwa,2020,95666,107624,35875,0,0,239165,35875,0.150001045303452,0.0500003484344839,0.0166667828114946
NGA,Mayo-belwa,2021,125511,119582,59791,0,0,304884,59791,0.196110651920075,0.0653702173066915,0.0217900724355638
NGA,Mayo-belwa,2022,115667,98440,61525,0,0,275632,61525,0.223214285714286,0.0744047619047619,0.0248015873015873
NGA,Michika,2020,128777,72893,41306,0,0,242976,41306,0.170000329250626,0.0566667764168752,0.0188889254722917
NGA,Michika,2021,95008,107509,60744,0,0,263261,60744,0.230736797322809,0.0769122657742696,0.0256374219247565
NGA,Michika,2022,92508,122510,67506,0,0,282524,67506,0.238938992793533,0.0796463309311775,0.0265487769770592
NGA,Miga,2020,164224,25722,7914,0,0,197860,7914,0.0399979783685434,0.0133326594561811,0.00444421981872705
NGA,Miga,2021,164915,28504,10180,0,0,203599,10180,0.050000245580774,0.0166667485269247,0.00555558284230822
NGA,Miga,2022,164915,42756,18324,0,0,225995,18324,0.081081439854864,0.027027146618288,0.00900904887276267
NGA,Mikang,2020,121421,18570,2857,0,0,142848,2857,0.0200002800179211,0.00666676000597372,0.00222225333532457
NGA,Mikang,2021,117894,20377,7277,0,0,145548,7277,0.0499972517657405,0.0166657505885802,0.00555525019619339
NGA,Mikang,2022,117894,43664,17466,0,0,179024,17466,0.0975623380105461,0.0325207793368487,0.0108402597789496
NGA,Minjibir,2020,254746,76773,17448,0,0,348967,17448,0.0499989970398347,0.0166663323466116,0.00555544411553719
NGA,Minjibir,2021,291991,122138,31407,0,0,445536,31407,0.0704926201249731,0.0234975400416577,0.00783251334721923
NGA,Minjibir,2022,227104,144193,32443,0,0,403740,32443,0.0803561698122554,0.0267853899374185,0.00892846331247282
NGA,Misau,2020,345033,58908,16831,0,0,420772,16831,0.0400002851900792,0.0133334283966931,0.00444447613223102
NGA,Misau,2021,353952,189347,63116,0,0,606415,63116,0.104080538904875,0.0346935129682918,0.0115645043227639
NGA,Misau,2022,315103,103596,38848,0,0,457547,38848,0.0849049387276061,0.0283016462425354,0.00943388208084512
NGA,Mobbar,2020,44790,83637,107410,62764,0,298601,170174,0.569904320481177,0.260032618778906,0.133387214227533
NGA,Mobbar,2021,37170,71751,122340,86015,0,317276,208355,0.656699529746971,0.309268061036238,0.163334832203577
NGA,Mobbar,2022,37170,61331,74341,55755,0,228597,130096,0.569106331229194,0.271002389940959,0.144534316334471
NGA,Mokwa,2020,176961,142338,65398,0,0,384697,65398,0.169998726270285,0.0566662420900951,0.0188887473633651
NGA,Mokwa,2021,334165,153879,69245,0,0,557289,69245,0.124253304838244,0.0414177682794146,0.0138059227598049
NGA,Mokwa,2022,338143,59672,15913,0,0,413728,15913,0.0384624680949803,0.0128208226983268,0.00427360756610892
NGA,Monguno,2020,89422,79707,51991,8287,0,229407,60278,0.262755713644309,0.0996264281386357,0.0412362695510115
NGA,Monguno,2021,117054,101477,59692,12992,0,291215,72684,0.249588791786137,0.0980672927791036,0.0426031168266287
NGA,Monguno,2022,94544,90042,53984,11255,0,249825,65239,0.261138797158011,0.102063444411088,0.0440326005981965
NGA,Mubi north,2020,194461,30829,11857,0,0,237147,11857,0.049998524122169,0.0166661747073897,0.00555539156912988
NGA,Mubi north,2021,197660,47430,16600,0,0,261690,16600,0.0634338339256372,0.0211446113085457,0.00704820376951524
NGA,Mubi north,2022,165937,97610,41484,0,0,305031,41484,0.135999291875252,0.0453330972917507,0.0151110324305836
NGA,Mubi south,2020,164757,28477,10170,0,0,203404,10170,0.0499990167351675,0.0166663389117225,0.00555544630390749
NGA,Mubi south,2021,169535,52885,12558,0,0,234978,12558,0.0534433010749943,0.0178144336916648,0.00593814456388825
NGA,Mubi south,2022,136047,87907,37675,0,0,261629,37675,0.144001620615452,0.0480005402051506,0.0160001800683835
NGA,Munya,2021,78608,61520,30760,0,0,170888,30760,0.180000936285754,0.0600003120952515,0.0200001040317505
NGA,Munya,2022,1312499,656250,218750,0,0,2187499,218750,0.100000045714307,0.0333333485714355,0.0111111161904785
NGA,Musawa,2020,129371,103497,25874,0,0,258742,25874,0.0999992270292415,0.0333330756764138,0.0111110252254713
NGA,Musawa,2021,151908,116434,36224,0,0,304566,36224,0.118936453839234,0.0396454846130778,0.0132151615376926
NGA,Musawa,2022,111932,106602,93277,13325,0,325136,106602,0.327868953299542,0.122950601184325,0.0500908337844266
NGA,Mushin,2021,1465624,546875,175000,0,0,2187499,175000,0.0800000365714453,0.0266666788571484,0.00888889295238281
NGA,Mushin,2022,1780523,254360,148377,0,0,2183260,148377,0.0679612139644385,0.0226537379881462,0.00755124599604872
NGA,Muya,2020,84279,62796,18178,0,0,165253,18178,0.110001028725651,0.036667009575217,0.0122223365250723
NGA,Muya,2021,79321,66101,19830,0,0,165252,19830,0.119998547672645,0.0399995158908818,0.0133331719636273
NGA,Nafada,2020,170652,33298,4162,0,0,208112,4162,0.0199988467748136,0.00666628225827119,0.0022220940860904
NGA,Nafada,2021,170652,39541,8324,0,0,218517,8324,0.0380931460710151,0.012697715357005,0.00423257178566834
NGA,Nafada,2022,172733,52028,18730,0,0,243491,18730,0.0769227610055402,0.0256409203351801,0.00854697344506003
NGA,Nangere,2020,126755,73128,36564,7313,3,243763,43880,0.180010912238527,0.070011992522792,0.030012302477771
NGA,Nangere,2021,206879,109692,60940,12188,3,389702,73131,0.187658775166666,0.0729831170141972,0.0312828776860268
NGA,Nangere,2022,128668,111008,40367,5046,0,285089,45413,0.159294115171052,0.0589979503476692,0.0235992580874355
NGA,Nasarawa,2020,691828,208496,47385,0,0,947709,47385,0.0499995251707011,0.0166665083902337,0.00555550279674457
NGA,Nasarawa,2021,792977,331698,85294,0,0,1209969,85294,0.0704927151026183,0.0234975717008728,0.00783252390029093
NGA,Nasarawa,2022,616760,391594,88109,0,0,1096463,88109,0.0803574767228808,0.0267858255742936,0.00892860852476453
NGA,Ngala,2020,46964,53673,29520,4025,0,134182,33545,0.249996273717786,0.0933309485127166,0.0377762210198752
NGA,Ngala,2021,69372,60382,40254,6709,0,176717,46963,0.265752587470362,0.10123908094109,0.042182950392121
NGA,Ngala,2022,47173,62435,34686,8325,0,152619,43011,0.281819432704971,0.112122343875926,0.0494958032748216
NGA,Nganzai,2020,60795,67660,55207,26183,0,209845,81390,0.387857704496176,0.170876917089598,0.0846863160904477
NGA,Nganzai,2021,78694,89624,68739,33635,0,270692,102374,0.378193666602633,0.16748309271546,0.0834400556926527
NGA,Nganzai,2022,96181,85594,67150,17345,0,266270,84495,0.317328275810268,0.127489640840751,0.0569722462162467
NGA,Ngaski,2020,148521,30466,11425,0,0,190412,11425,0.060001470495557,0.0200004901651857,0.00666683005506189
NGA,Ngaski,2021,144713,53005,13742,0,0,211460,13742,0.0649862858223778,0.0216620952741259,0.00722069842470864
NGA,Ngaski,2022,119752,58895,35337,0,0,213984,35337,0.165138515029161,0.055046171676387,0.018348723892129
NGA,Nguru,2020,145710,106247,45534,6071,2,303564,51607,0.170003689502049,0.0633386479731896,0.0255615143941823
NGA,Nguru,2021,150810,121425,75891,15178,2,363306,91071,0.250672986408152,0.0974871504094803,0.0417832656524008
NGA,Nguru,2022,163377,131959,50270,9426,0,355032,59696,0.168142589963722,0.0648974364752098,0.0275324164832716
NGA,Ningi,2020,519390,80382,18550,0,0,618322,18550,0.0300005498753077,0.0100001832917692,0.00333339443058974
NGA,Ningi,2021,548139,129847,37099,0,0,715085,37099,0.051880545669396,0.017293515223132,0.00576450507437733
NGA,Ningi,2022,516270,159343,38242,0,0,713855,38242,0.0535711033753353,0.0178570344584451,0.0059523448194817
NGA,Nkanu east,2021,200541,33423,4775,0,0,238739,4775,0.0200009215084255,0.00666697383614184,0.00222232461204728
NGA,Nkanu east,2022,195766,78784,9550,0,0,284100,9550,0.0336149243224217,0.0112049747741406,0.00373499159138019
NGA,Nkanu west,2021,197739,32956,4708,0,0,235403,4708,0.0199997451179467,0.00666658170598222,0.00222219390199407
NGA,Nkanu west,2022,193030,77683,9416,0,0,280129,9416,0.0336130853999407,0.0112043617999802,0.00373478726666008
NGA,Nsukka,2021,411269,38708,33869,0,0,483846,33869,0.0699995453098713,0.0233331817699571,0.00777772725665237
NGA,Nsukka,2022,396754,154831,38708,0,0,590293,38708,0.0655742148390714,0.0218580716130238,0.00728602387100794
NGA,Numan,2020,77377,42987,22927,0,0,143291,22927,0.160003070674362,0.053334356891454,0.017778118963818
NGA,Numan,2021,61927,66351,42987,0,0,171265,42987,0.25099699296412,0.0836656643213733,0.0278885547737911
NGA,Numan,2022,78146,66351,28015,0,0,172512,28015,0.162394500092747,0.0541315000309157,0.0180438333436386
NGA,Obanliku,2021,151995,23523,5428,0,0,180946,5428,0.0299978999259448,0.00999929997531492,0.00333309999177164
NGA,Obanliku,2022,155614,25333,9047,0,0,189994,9047,0.0476172931776793,0.0158724310592264,0.00529081035307548
NGA,Obi,2020,130698,16525,3005,0,0,150228,3005,0.0200029288814336,0.00666764296047785,0.00222254765349262
NGA,Obi,2021,129210,20737,9571,0,0,159518,9571,0.0599994984891987,0.0199998328297329,0.0066666109432443
NGA,Obi,2022,129210,47855,15952,0,0,193017,15952,0.0826455700793195,0.0275485233597731,0.00918284111992438
NGA,Obi ngwa,2021,171037,107690,38008,0,0,316735,38008,0.119999368557311,0.0399997895191038,0.0133332631730346
NGA,Obi ngwa,2022,190042,123527,44343,0,0,357912,44343,0.123893582780125,0.0412978609267082,0.0137659536422361
NGA,Obubra,2021,230671,37021,17087,0,0,284779,17087,0.0600009129886684,0.0200003043295561,0.00666676810985205
NGA,Obubra,2022,230671,74043,19935,0,0,324649,19935,0.061404778699457,0.0204682595664857,0.00682275318882855
NGA,Obudu,2021,223844,34643,7994,0,0,266481,7994,0.0299983863765147,0.00999946212550488,0.00333315404183496
NGA,Obudu,2022,229174,37307,13324,0,0,279805,13324,0.0476188774324976,0.0158729591441659,0.00529098638138863
NGA,Odukpani,2021,264231,44569,9551,0,0,318351,9551,0.0300014763578566,0.0100004921192855,0.00333349737309518
NGA,Odukpani,2022,261048,76404,25468,0,0,362920,25468,0.0701752452331092,0.0233917484110364,0.00779724947034547
NGA,Ogbadibo,2020,173442,21929,3987,0,0,199358,3987,0.0199991974237302,0.00666639914124339,0.00222213304708113
NGA,Ogbadibo,2021,171466,27519,12701,0,0,211686,12701,0.0599992441635252,0.0199997480545084,0.00666658268483614
NGA,Ogbadibo,2022,171466,63506,21169,0,0,256141,21169,0.0826458864453563,0.0275486288151188,0.00918287627170625
NGA,Ogoja,2021,237870,36813,8495,0,0,283178,8495,0.0299987993417568,0.00999959978058559,0.00333319992686186
NGA,Ogoja,2022,243534,39645,14159,0,0,297338,14159,0.0476192077702816,0.0158730692567605,0.00529102308558685
NGA,Ohafia,2021,243929,136942,47074,0,0,427945,47074,0.110000116837444,0.0366667056124814,0.0122222352041605
NGA,Ohafia,2022,261046,171178,55633,0,0,487857,55633,0.114035465310532,0.0380118217701772,0.0126706072567257
NGA,Ohimini,2020,93598,11834,2152,0,0,107584,2152,0.0200029744199881,0.00666765813999604,0.00222255271333201
NGA,Ohimini,2021,92532,14851,6854,0,0,114237,6854,0.0599980741791189,0.0199993580597063,0.00666645268656876
NGA,Ohimini,2022,92532,34271,11424,0,0,138227,11424,0.0826466609273152,0.0275488869757717,0.00918296232525724
NGA,Oji-river,2021,168602,30470,4063,0,0,203135,4063,0.0200014768503704,0.00666715895012348,0.00222238631670783
NGA,Oji-river,2022,164539,60941,20314,0,0,245794,20314,0.0826464437699863,0.0275488145899954,0.00918293819666514
NGA,Ojo,2021,1044193,389624,124680,0,0,1558497,124680,0.0800001539945217,0.0266667179981739,0.00888890599939129
NGA,Ojo,2022,1268544,467549,155850,0,0,1891943,155850,0.0823756318240032,0.0274585439413344,0.0091528479804448
NGA,Oju,2020,223100,28208,5129,0,0,256437,5129,0.0200010138942508,0.00666700463141694,0.00222233487713898
NGA,Oju,2021,220558,35398,16338,0,0,272294,16338,0.0600013221003768,0.0200004407001256,0.00666681356670853
NGA,Oju,2022,214791,81688,27229,0,0,323708,27229,0.0841159316420972,0.0280386438806991,0.00934621462689969
NGA,Okpokwu,2020,232508,29398,5345,0,0,267251,5345,0.0199999251639844,0.00666664172132814,0.00222221390710938
NGA,Okpokwu,2021,229859,36891,17027,0,0,283777,17027,0.0600013390796294,0.0200004463598765,0.00666681545329216
NGA,Okpokwu,2022,229859,85133,28378,0,0,343370,28378,0.0826455427090311,0.0275485142363437,0.00918283807878123
NGA,Oredo,2021,450338,94515,11119,0,0,555972,11119,0.0199992085932385,0.00666640286441284,0.00222213428813761
NGA,Oredo,2022,467017,138993,27799,0,0,633809,27799,0.0438602165636651,0.0146200721878884,0.00487335739596279
NGA,Orhionmwon,2021,221222,46429,5462,0,0,273113,5462,0.0199990480130935,0.00666634933769783,0.00222211644589928
NGA,Orhionmwon,2022,229416,68279,13656,0,0,311351,13656,0.0438604661619844,0.0146201553873281,0.00487338512910938
NGA,Oshodi-isolo,2021,1258267,469503,150241,0,0,1878011,150241,0.0800000638973893,0.0266666879657964,0.00888889598859881
NGA,Oshodi-isolo,2022,1528613,563403,187801,0,0,2279817,187801,0.0823754713645876,0.0274584904548625,0.00915283015162084
NGA,Osisioma ngwa,2021,199373,134193,49843,0,0,383409,49843,0.129999556609261,0.0433331855364202,0.0144443951788067
NGA,Osisioma ngwa,2022,191705,153364,72848,0,0,417917,72848,0.174312124177767,0.0581040413925891,0.0193680137975297
NGA,Oturkpo,2020,352756,44601,8109,0,0,405466,8109,0.0199992107846281,0.00666640359487602,0.00222213453162534
NGA,Oturkpo,2021,348737,55970,25832,0,0,430539,25832,0.0599992102922151,0.0199997367640717,0.00666657892135723
NGA,Oturkpo,2022,348737,129162,43054,0,0,520953,43054,0.0826446915556682,0.0275482305185561,0.00918274350618535
NGA,Ovia north east,2021,186800,39205,4612,0,0,230617,4612,0.0199985256941162,0.00666617523137207,0.00222205841045736
NGA,Ovia north east,2022,193718,57654,11531,0,0,262903,11531,0.0438602830701818,0.0146200943567273,0.00487336478557575
NGA,Ovia south west,2021,166054,34851,4100,0,0,205005,4100,0.0199995122070193,0.00666650406900645,0.00222216802300215
NGA,Ovia south west,2022,172204,51251,10250,0,0,233705,10250,0.0438587107678484,0.0146195702559495,0.00487319008531649
NGA,Owan east,2021,185974,36736,6888,0,0,229598,6888,0.0300002613263182,0.0100000871087727,0.00333336236959091
NGA,Owan east,2022,172198,84951,16072,0,0,273221,16072,0.0588241753013129,0.019608058433771,0.00653601947792365
NGA,Owan west,2021,119148,23535,4413,0,0,147096,4413,0.0300008157937673,0.0100002719312558,0.00333342397708526
NGA,Owan west,2022,110322,54426,10297,0,0,175045,10297,0.0588248736039304,0.0196082912013101,0.00653609706710338
NGA,Paikoro,2021,120196,94067,47033,0,0,261296,47033,0.179998928418345,0.0599996428061152,0.0199998809353717
NGA,Paikoro,2022,138487,107131,49646,0,0,295264,49646,0.168141053430151,0.0560470178100502,0.0186823392700167
NGA,Pailoro,2020,128867,96018,27795,0,0,252680,27795,0.11000079151496,0.0366669305049865,0.0122223101683289
NGA,Pailoro,2021,121286,101072,30322,0,0,252680,30322,0.120001583029919,0.0400005276766398,0.0133335092255466
NGA,Pankshin,2020,236671,39445,5635,0,0,281751,5635,0.0199999290153362,0.00666664300511208,0.00222221433503736
NGA,Pankshin,2021,228218,71113,22756,0,0,322087,22756,0.0706517183245521,0.0235505727748507,0.00785019092495023
NGA,Pankshin,2022,238939,85335,31290,0,0,355564,31290,0.0880010349754193,0.0293336783251398,0.00977789277504659
NGA,Potiskum,2020,344938,191632,102204,0,0,638774,102204,0.160000250479825,0.0533334168266085,0.0177778056088695
NGA,Potiskum,2021,350400,242734,166081,19163,0,778378,185244,0.237987199021555,0.0875354476445463,0.0346494034175341
NGA,Potiskum,2022,396679,231396,105781,19834,0,753690,125615,0.166666666666667,0.0643275086574056,0.0272904716203685
NGA,Qua'an pan,2020,248511,38008,5847,0,0,292366,5847,0.0199989054814855,0.00666630182716185,0.00222210060905395
NGA,Qua'an pan,2021,239740,41309,14753,0,0,295802,14753,0.0498745782651909,0.0166248594217303,0.00554161980724343
NGA,Qua'an pan,2022,239003,88520,35408,0,0,362931,35408,0.0975612444238712,0.0325204148079571,0.010840138269319
NGA,Rabah,2020,135199,65185,36214,4829,0,241427,41043,0.170001698235906,0.0633345345245837,0.0255563793610491
NGA,Rabah,2021,127544,84499,48285,12071,0,272399,60356,0.221572032202761,0.0886285681420759,0.0393903387636845
NGA,Rabah,2022,113372,82667,54324,9448,0,259811,63772,0.245455350235363,0.0939400820853107,0.0393944486996744
NGA,Rafi,2020,149829,111637,32316,0,0,293782,32316,0.10999993192231,0.0366666439741033,0.0122222146580344
NGA,Rafi,2021,141015,117513,54684,0,0,313212,54684,0.174591011838627,0.058197003946209,0.019399001315403
NGA,Rafi,2022,161014,124558,57722,0,0,343294,57722,0.168141592920354,0.056047197640118,0.0186823992133727
NGA,Rano,2020,204983,28274,2356,0,0,235613,2356,0.00999944824776222,0.00333314941592074,0.00111104980530691
NGA,Rano,2021,204446,35342,4868,0,0,244656,4868,0.019897325223988,0.00663244174132932,0.00221081391377644
NGA,Rano,2022,214181,38942,9736,0,0,262859,9736,0.037038868747123,0.0123462895823743,0.00411542986079144
NGA,Rijau,2020,149232,98549,33788,0,0,281569,33788,0.119999005572346,0.0399996685241155,0.0133332228413718
NGA,Rijau,2021,238760,121075,36604,0,0,396439,36604,0.092331985500922,0.0307773285003073,0.0102591095001024
NGA,Rijau,2022,218378,119380,40764,2912,0,381434,43676,0.11450473738576,0.040713028553651,0.0152675313568155
NGA,Rimi,2020,114916,93809,25797,0,0,234522,25797,0.109998209123238,0.036666069707746,0.0122220232359153
NGA,Rimi,2021,157013,105535,32833,2345,0,297726,35178,0.118155619596542,0.042010663048127,0.01575385869334
NGA,Rimi,2022,193246,84545,36234,2416,0,316441,38650,0.122139672166375,0.0432581955772693,0.0161160462069636
NGA,Rimin gado,2020,139619,22996,1643,0,0,164258,1643,0.010002556953086,0.00333418565102867,0.00111139521700956
NGA,Rimin gado,2021,137440,27924,5090,0,0,170454,5090,0.0298614288899058,0.00995380962996859,0.00331793654332286
NGA,Rimin gado,2022,137440,69568,8484,0,0,215492,8484,0.0393703710578583,0.0131234570192861,0.00437448567309537
NGA,Ringim,2020,119869,20718,7399,0,0,147986,7399,0.049997972781209,0.0166659909270697,0.00555533030902323
NGA,Ringim,2021,123345,20718,9137,0,0,153200,9137,0.0596409921671018,0.0198803307223673,0.00662677690745576
NGA,Ringim,2022,112686,31978,21319,0,0,165983,21319,0.128440864425875,0.0428136214752916,0.0142712071584306
NGA,Riyom,2020,152331,29294,13671,0,0,195296,13671,0.0700014337211208,0.0233338112403736,0.00777793708012453
NGA,Riyom,2021,148425,63359,25739,0,0,237523,25739,0.108364242620715,0.0361214142069049,0.0120404714023016
NGA,Riyom,2022,124737,79198,41579,1980,0,247494,43559,0.176000226268112,0.0613334734040691,0.0222223120111554
NGA,Rogo,2020,314655,43401,3617,0,0,361673,3617,0.0100007465307059,0.00333358217690197,0.00111119405896732
NGA,Rogo,2021,313830,54251,7472,0,0,375553,7472,0.0198959933751029,0.00663199779170095,0.00221066593056698
NGA,Rogo,2022,328774,59777,14944,0,0,403495,14944,0.0370363945030298,0.0123454648343433,0.00411515494478109
NGA,Roni,2020,241143,41679,14885,0,0,297707,14885,0.0499988243474289,0.0166662747824763,0.00555542492749209
NGA,Roni,2021,248137,41679,18380,0,0,308196,18380,0.0596373736193851,0.019879124539795,0.00662637484659834
NGA,Roni,2022,226693,64332,42888,0,0,333913,42888,0.128440641724042,0.0428135472413473,0.0142711824137824
NGA,Sabon birni,2020,163096,78635,43686,5825,0,291242,49511,0.169999519300101,0.0633333562238047,0.0255556852682267
NGA,Sabon birni,2021,155102,101935,58248,14562,0,329847,72810,0.220738706127386,0.0882954824509545,0.0392424366448687
NGA,Sabon birni,2022,137869,100529,66062,11489,0,315949,77551,0.245454171401081,0.0939392117082187,0.0393938402857564
NGA,Sabon-gari,2020,306384,100669,30638,0,0,437691,30638,0.0699991546547679,0.0233330515515893,0.00777768385052976
NGA,Sabon-gari,2021,288527,135247,43769,0,0,467543,43769,0.0936149188416894,0.0312049729472298,0.0104016576490766
NGA,Sabon-gari,2022,369675,135247,40574,0,0,545496,40574,0.074380013785619,0.0247933379285397,0.00826444597617989
NGA,Sabuwa,2020,107054,85643,21411,0,0,214108,21411,0.10000093410802,0.0333336447026734,0.0111112149008911
NGA,Sabuwa,2021,125703,96349,29975,0,0,252027,29975,0.118935669590957,0.0396452231969855,0.0132150743989952
NGA,Sabuwa,2022,92623,88213,77186,11027,0,269049,88213,0.327869644562886,0.122951581310468,0.0500916602964929
NGA,Safana,2020,138120,112751,31007,0,0,281878,31007,0.110001490006315,0.0366671633354383,0.0122223877784794
NGA,Safana,2021,188717,126845,39463,2819,0,357844,42282,0.118157632935022,0.0420117891222618,0.0157545373589236
NGA,Safana,2022,232267,101617,43550,2903,0,380337,46453,0.122136421121269,0.0432563752671973,0.0161149483513597
NGA,Sakaba,2020,108036,22161,8310,0,0,138507,8310,0.0599969676622842,0.0199989892207614,0.0066663297402538
NGA,Sakaba,2021,105266,38557,9996,0,0,153819,9996,0.0649854699354436,0.0216618233118145,0.00722060777060485
NGA,Sakaba,2022,87109,42841,25704,0,0,155654,25704,0.165135492823827,0.0550451642746091,0.0183483880915364
NGA,Sandamu,2020,172992,31264,4168,0,0,208424,4168,0.0199976970022646,0.00666589900075487,0.00222196633358496
NGA,Sandamu,2021,164655,49376,17174,0,0,231205,17174,0.0742804005103696,0.0247601335034565,0.00825337783448551
NGA,Sandamu,2022,169594,68696,27908,2147,0,268345,30055,0.112001341556578,0.0400007453092102,0.0151115582966372
NGA,Sanga,2020,125161,68270,34135,0,0,227566,34135,0.150000439432956,0.0500001464776519,0.0166667154925506
NGA,Sanga,2021,117196,93757,40962,0,0,251915,40962,0.162602465117202,0.0542008217057341,0.018066940568578
NGA,Sanga,2022,189857,82037,51566,0,0,323460,51566,0.159420021022692,0.0531400070075641,0.017713335669188
NGA,Sardauna,2020,299151,33994,6799,0,0,339944,6799,0.0200003529993175,0.00666678433310585,0.00222226144436861
NGA,Sardauna,2021,292352,47592,13598,0,0,353542,13598,0.0384621911965198,0.0128207303988399,0.00427357679961331
NGA,Sardauna,2022,285553,44193,20397,0,0,350143,20397,0.0582533422058987,0.0194177807352996,0.00647259357843319
NGA,Shagari,2020,134681,107744,26936,0,0,269361,26936,0.099999628751007,0.033333209583669,0.011111069861223
NGA,Shagari,2021,166465,121212,49940,0,0,337617,49940,0.147919091751896,0.0493063639172988,0.0164354546390996
NGA,Shagari,2022,152593,88781,63812,5549,0,310735,69361,0.223215923536132,0.0803578612000579,0.030754322636473
NGA,Shanga,2020,149746,30717,11519,0,0,191982,11519,0.0600004167057328,0.0200001389019109,0.00666671296730365
NGA,Shanga,2021,145906,53442,13855,0,0,213203,13855,0.064985014282163,0.0216616714273877,0.00722055714246256
NGA,Shanga,2022,120739,59380,35628,0,0,215747,35628,0.165137869819743,0.0550459566065809,0.0183486522021936
NGA,Shani,2020,129983,82716,23633,0,0,236332,23633,0.0999991537328842,0.0333330512442948,0.0111110170814316
NGA,Shani,2021,200381,106349,35450,0,0,342180,35450,0.103600444210649,0.0345334814035498,0.0115111604678499
NGA,Shani,2022,158839,85529,36655,0,0,281023,36655,0.130434163751721,0.0434780545839071,0.0144926848613024
NGA,Shanono,2020,187915,30951,2211,0,0,221077,2211,0.010001040361503,0.003333680120501,0.00111122670683367
NGA,Shanono,2021,184982,37583,6851,0,0,229416,6851,0.0298627820204345,0.00995426067347816,0.00331808689115939
NGA,Shanono,2022,184982,93633,11419,0,0,290034,11419,0.0393712461297641,0.0131237487099214,0.00437458290330712
NGA,Shelleng,2020,95289,97613,39510,0,0,232412,39510,0.169999827891847,0.0566666092972824,0.0188888697657608
NGA,Shelleng,2021,193714,116207,58103,0,0,368024,58103,0.157878290546269,0.0526260968487562,0.0175420322829187
NGA,Shelleng,2022,136317,107619,55005,0,0,298941,55005,0.183999518299598,0.0613331727665325,0.0204443909221775
NGA,Shendam,2020,258391,39519,6080,0,0,303990,6080,0.0200006579163788,0.00666688597212628,0.00222229532404209
NGA,Shendam,2021,249271,42936,15334,0,0,307541,15334,0.0498600186641781,0.0166200062213927,0.00554000207379757
NGA,Shendam,2022,248418,92007,36803,0,0,377228,36803,0.0975616868313063,0.0325205622771021,0.0108401874257007
NGA,Shinkafi,2021,126591,65478,26191,0,0,218260,26191,0.119999083661688,0.039999694553896,0.0133332315179653
NGA,Shinkafi,2022,109130,93852,52383,2183,0,257548,54566,0.211867302405765,0.0734477974332293,0.0263661746763926
NGA,Shira,2020,317650,44845,11211,0,0,373706,11211,0.0299995183379448,0.0099998394459816,0.0033332798153272
NGA,Shira,2021,328429,149482,29896,0,0,507807,29896,0.0588727607142084,0.0196242535714028,0.00654141785713426
NGA,Shira,2022,332292,92733,23183,0,0,448208,23183,0.0517237532574162,0.0172412510858054,0.00574708369526847
NGA,Shiroro,2020,191972,143038,41406,0,0,376416,41406,0.110000637592451,0.0366668791974836,0.0122222930658279
NGA,Shiroro,2021,180680,150566,70065,0,0,401311,70065,0.174590280356133,0.0581967601187109,0.0193989200395703
NGA,Shiroro,2022,206303,159593,73958,0,0,439854,73958,0.168142156260941,0.0560473854203137,0.0186824618067712
NGA,Shomgom,2020,184838,38793,4564,0,0,228195,4564,0.0200004382216964,0.00666681274056545,0.00222227091352182
NGA,Shomgom,2021,177992,61613,25101,0,0,264706,25101,0.0948259578551298,0.0316086526183766,0.0105362175394589
NGA,Shomgom,2022,184838,68459,29665,0,0,282962,29665,0.104837398661304,0.0349457995537681,0.011648599851256
NGA,Shomolu,2021,1187816,390282,118782,0,0,1696880,118782,0.0700002357267456,0.0233334119089152,0.0077778039696384
NGA,Shomolu,2022,1348297,493279,213754,0,0,2055330,213754,0.10399984430724,0.0346666147690801,0.01155553825636
NGA,Silame,2020,78142,61516,24939,1663,0,166260,26602,0.160002405870324,0.0566682705802157,0.0211121803868105
NGA,Silame,2021,138711,74817,26602,4988,0,245118,31590,0.128876704281203,0.0497420290091575,0.0211027613911123
NGA,Silame,2022,116449,46237,25687,1712,0,190085,27399,0.144140779125128,0.0510490920728446,0.0190178078228161
NGA,Soba,2020,302688,99455,30269,0,0,432412,30269,0.0700003700174833,0.0233334566724944,0.00777781889083148
NGA,Soba,2021,285046,133615,43241,0,0,461902,43241,0.0936150958428411,0.0312050319476137,0.0104016773158712
NGA,Soba,2022,365215,133615,40085,0,0,538915,40085,0.0743809320579312,0.0247936440193104,0.0082645480064368
NGA,Sokoto IDPs,2022,13016,22637,19808,7357,0,62818,27165,0.432439746569455,0.183185286595137,0.0870875651352585
NGA,Sokoto north,2020,166213,130848,53047,3536,0,353644,56583,0.159999886891903,0.056666214234277,0.0211106838138542
NGA,Sokoto north,2021,295045,159140,56583,10609,0,521377,67192,0.12887411604271,0.0497407186482462,0.0211020261943107
NGA,Sokoto north,2022,247692,98348,54638,3643,0,404321,58281,0.144145369644416,0.0510518457694093,0.0190195414039835
NGA,Sokoto south,2020,145425,114483,46412,3094,0,309414,49506,0.159999224340204,0.0566662572906634,0.0211108741039513
NGA,Sokoto south,2021,258144,139236,49506,9282,0,456168,58788,0.128873572894197,0.0497404465021659,0.0211018747478999
NGA,Sokoto south,2022,216714,86048,47804,3187,0,353753,50991,0.144142947197621,0.0510506860248064,0.0190189199808906
NGA,Song,2020,122202,137477,45826,0,0,305505,45826,0.150000818317212,0.0500002727724042,0.0166667575908014
NGA,Song,2021,97761,172900,54991,0,0,325652,54991,0.168864309139818,0.056288103046606,0.0187627010155353
NGA,Song,2022,166613,194906,72304,0,0,433823,72304,0.166667050847926,0.0555556836159755,0.0185185612053252
NGA,Sule-tankarkar,2020,97023,16769,5989,0,0,119781,5989,0.0499995825715264,0.0166665275238421,0.00555550917461404
NGA,Sule-tankarkar,2021,99837,16769,7395,0,0,124001,7395,0.0596366158337433,0.0198788719445811,0.0066262906481937
NGA,Sule-tankarkar,2022,91209,25884,17256,0,0,134349,17256,0.128441596141393,0.0428138653804643,0.0142712884601548
NGA,Suleja,2020,175199,130540,37788,0,0,343527,37788,0.11000008732938,0.0366666957764601,0.0122222319254867
NGA,Suleja,2021,164893,137411,63944,0,0,366248,63944,0.174592079683712,0.0581973598945705,0.0193991199648568
NGA,Suleja,2022,188278,145649,67496,0,0,401423,67496,0.168141835420492,0.0560472784734972,0.0186824261578324
NGA,Sumaila,2020,346136,47743,3979,0,0,397858,3979,0.0100010556530219,0.00333368521767398,0.00111122840589133
NGA,Sumaila,2021,345228,59679,8220,0,0,413127,8220,0.0198970292428236,0.00663234308094121,0.0022107810269804
NGA,Sumaila,2022,361668,65758,16439,0,0,443865,16439,0.0370360357315851,0.0123453452438617,0.00411511508128723
NGA,Suru,2020,179355,38113,6726,0,0,224194,6726,0.0300008028760805,0.0100002676253602,0.00333342254178673
NGA,Suru,2021,179355,53163,11557,0,0,244075,11557,0.0473501997336884,0.0157833999112295,0.00526113330374316
NGA,Suru,2022,157178,64720,34672,0,0,256570,34672,0.135136609892037,0.0450455366306791,0.015015178876893
NGA,Surulere,2021,1244572,632833,232039,0,0,2109444,232039,0.110000075849371,0.0366666919497902,0.0122222306499301
NGA,Surulere,2022,1328622,738305,253133,0,0,2320060,253133,0.109106230011293,0.0363687433370976,0.0121229144456992
NGA,Tafa,2020,67760,50488,14615,0,0,132863,14615,0.110000526858493,0.0366668422861644,0.0122222807620548
NGA,Tafa,2021,63774,53145,24731,0,0,141650,24731,0.174592304977056,0.058197434992352,0.0193991449974507
NGA,Tafa,2022,72818,56331,26105,0,0,155254,26105,0.16814381594033,0.0560479386467767,0.0186826462155922
NGA,Tafawa-balewa,2020,295098,49183,7026,0,0,351307,7026,0.0199996014881571,0.0066665338293857,0.00222217794312856
NGA,Tafawa-balewa,2021,310619,52696,10963,0,0,374278,10963,0.0292910617241729,0.00976368724139098,0.00325456241379699
NGA,Tafawa-balewa,2022,314273,51161,14617,0,0,380051,14617,0.0384606276526045,0.0128202092175348,0.00427340307251161
NGA,Takai,2020,267258,38640,3220,0,0,309118,3220,0.0104167340627204,0.00347224468757346,0.00115741489585782
NGA,Takai,2021,279403,48300,6652,0,0,334355,6652,0.0198950217583108,0.00663167391943693,0.00221055797314564
NGA,Takai,2022,292708,53220,13305,0,0,359233,13305,0.0370372432376758,0.0123457477458919,0.00411524924863065
NGA,Takum,2020,203708,25756,4683,0,0,234147,4683,0.0200002562492793,0.0066667520830931,0.00222225069436437
NGA,Takum,2021,199025,30439,11707,0,0,241171,11707,0.0485423205941013,0.0161807735313671,0.00539359117712237
NGA,Takum,2022,196683,28098,14049,0,0,238830,14049,0.0588242683080015,0.0196080894360005,0.00653602981200017
NGA,Talata mafara,2021,186960,103867,55396,0,0,346223,55396,0.160000924259798,0.0533336414199326,0.0177778804733109
NGA,Talata mafara,2022,197348,121179,76169,6924,0,401620,83093,0.206894576963299,0.0747115847484355,0.0287350120899247
NGA,Tambuwal,2020,171919,137535,34384,0,0,343838,34384,0.100000581669274,0.0333335272230915,0.0111111757410305
NGA,Tambuwal,2021,212491,154727,63747,0,0,430965,63747,0.147916884201733,0.0493056280672444,0.0164352093557481
NGA,Tambuwal,2022,194784,113329,81455,7083,0,396651,88538,0.223213858026325,0.0803569552747041,0.0307538757132985
NGA,Tangaza,2020,71572,56344,22842,1523,0,152281,24365,0.160000262672297,0.0566671701219018,0.0211115561947248
NGA,Tangaza,2021,127048,68526,24365,4568,0,224507,28933,0.128873487240932,0.0497400971907335,0.0211015444705263
NGA,Tangaza,2022,106658,42349,23527,1568,0,174102,25095,0.144139642278664,0.0510486190087803,0.0190175873912994
NGA,Tarauni,2020,257336,77553,17626,0,0,352515,17626,0.0500007091896799,0.0166669030632266,0.00555563435440887
NGA,Tarauni,2021,294960,123380,31726,0,0,450066,31726,0.070491883412655,0.023497294470885,0.007832431490295
NGA,Tarauni,2022,229413,145659,32773,0,0,407845,32773,0.080356507987103,0.0267855026623677,0.00892850088745588
NGA,Tarka,2020,101355,15686,3620,0,0,120661,3620,0.0300014089059431,0.0100004696353144,0.00333348987843812
NGA,Tarka,2021,106341,16893,7687,0,0,130921,7687,0.0587147974732854,0.0195715991577618,0.0065238663859206
NGA,Tarka,2022,105776,15375,8969,0,0,130120,8969,0.0689286812173379,0.0229762270724459,0.00765874235748198
NGA,Tarmua,2020,64482,37201,16121,6200,5,124009,22326,0.180035320017096,0.0767041101855511,0.0367052212160228
NGA,Tarmua,2021,47487,43401,41070,14880,5,146843,55955,0.381053233725816,0.160818016521046,0.076147086797918
NGA,Tarmua,2022,43637,38503,50054,12834,0,145028,62888,0.433626610033924,0.174039955502845,0.0776784866064178
NGA,Taura,2020,168961,29203,10430,0,0,208594,10430,0.0500014382005235,0.0166671460668412,0.00555571535561372
NGA,Taura,2021,173861,29203,12879,0,0,215943,12879,0.0596407385282227,0.0198802461760742,0.00662674872535808
NGA,Taura,2022,158836,45075,30050,0,0,233961,30050,0.12844021012049,0.0428134033734967,0.0142711344578322
NGA,Tofa,2020,133180,21935,1567,0,0,156682,1567,0.0100011488237321,0.00333371627457738,0.00111123875819246
NGA,Tofa,2021,131101,26636,4856,0,0,162593,4856,0.0298659843904719,0.00995532813015731,0.00331844271005243
NGA,Tofa,2022,131101,66360,8093,0,0,205554,8093,0.0393716492989677,0.0131238830996559,0.0043746276998853
NGA,Toro,2020,475637,72744,11191,0,0,559572,11191,0.0199992136847448,0.00666640456158159,0.00222213485386053
NGA,Toro,2021,491341,78340,16787,0,0,586468,16787,0.0286238976380638,0.00954129921268793,0.00318043307089598
NGA,Toro,2022,491341,85699,22853,0,0,599893,22853,0.0380951269643086,0.0126983756547695,0.00423279188492318
NGA,Toungo,2020,37568,32668,11434,0,0,81670,11434,0.140002448879638,0.0466674829598792,0.0155558276532931
NGA,Toungo,2021,66390,38384,17967,817,0,123558,18784,0.152025769274349,0.0528793495092723,0.0190958452260837
NGA,Toungo,2022,52944,25211,13446,0,0,91601,13446,0.146788790515387,0.0489295968384625,0.0163098656128208
NGA,Tsafe,2021,205445,149803,72762,0,0,428010,72762,0.170000700918203,0.0566669003060676,0.0188889667686892
NGA,Tsafe,2022,235405,171204,98442,12840,0,517891,111282,0.2148753309094,0.0798893975759378,0.0321393240405156
NGA,Tsanyawa,2020,213041,35089,2506,0,0,250636,2506,0.00999856365406406,0.00333285455135469,0.00111095151711823
NGA,Tsanyawa,2021,209715,42608,7767,0,0,260090,7767,0.0298627398208313,0.00995424660694375,0.00331808220231458
NGA,Tsanyawa,2022,209715,106152,12945,0,0,328812,12945,0.0393690011313456,0.0131230003771152,0.0043743334590384
NGA,Tudun wada,2020,316108,43601,3633,0,0,363342,3633,0.00999884406427003,0.00333294802142334,0.00111098267380778
NGA,Tudun wada,2021,315279,54501,7507,0,0,377287,7507,0.0198973195471882,0.00663243984906274,0.00221081328302091
NGA,Tudun wada,2022,330292,60053,15013,0,0,405358,15013,0.0370363974560759,0.012345465818692,0.00411515527289732
NGA,Tureta,2020,57907,46325,11581,0,0,115813,11581,0.0999974096172278,0.0333324698724093,0.0111108232908031
NGA,Tureta,2021,69334,52116,20800,0,0,142250,20800,0.14622144112478,0.0487404803749268,0.0162468267916423
NGA,Tureta,2022,63556,36978,26578,2311,0,129423,28889,0.223213802801666,0.080356659944523,0.0307535926552639
NGA,Udenu,2021,243426,22911,20047,0,0,286384,20047,0.0700004190178222,0.0233334730059407,0.00777782433531358
NGA,Udenu,2022,234835,91643,22911,0,0,349389,22911,0.0655744742965577,0.0218581580988526,0.00728605269961752
NGA,Udi,2021,311669,56326,7510,0,0,375505,7510,0.0199997336919615,0.0066665778973205,0.00222219263244017
NGA,Udi,2022,304159,112652,37551,0,0,454362,37551,0.0826455557462992,0.0275485185820997,0.00918283952736658
NGA,Ugwunagbo,2021,77882,49037,17307,0,0,144226,17307,0.119999167972488,0.0399997226574959,0.013333240885832
NGA,Ugwunagbo,2022,86535,56248,20192,0,0,162975,20192,0.123896303113975,0.0412987677046582,0.0137662559015527
NGA,Uhunmwonde,2021,146411,30728,3615,0,0,180754,3615,0.0199995574095179,0.00666651913650597,0.00222217304550199
NGA,Uhunmwonde,2022,151833,45189,9038,0,0,206060,9038,0.0438610113559158,0.0146203371186386,0.00487344570621286
NGA,Ukum,2020,277402,39629,13210,0,0,330241,13210,0.0400010901129781,0.013333696704326,0.00444456556810868
NGA,Ukum,2021,284035,45586,21040,0,0,350661,21040,0.0600009695974175,0.0200003231991392,0.00666677439971305
NGA,Ukum,2022,261089,105198,31840,0,0,398127,31840,0.0799744805049645,0.0266581601683215,0.0088860533894405
NGA,Ukwa east,2021,55490,34938,12331,0,0,102759,12331,0.119999221479384,0.0399997404931279,0.0133332468310426
NGA,Ukwa east,2022,61656,40076,14386,0,0,116118,14386,0.123891214109785,0.0412970713699283,0.0137656904566428
NGA,Ukwa west,2021,83478,52560,18551,0,0,154589,18551,0.120002070004981,0.0400006900016603,0.0133335633338868
NGA,Ukwa west,2022,92753,60290,21642,0,0,174685,21642,0.12389157626585,0.0412971920886167,0.0137657306962056
NGA,Umu-nneochi,2021,163115,91573,31478,0,0,286166,31478,0.109999091436439,0.0366663638121463,0.0122221212707154
NGA,Umu-nneochi,2022,174562,114467,37202,0,0,326231,37202,0.114035759936977,0.0380119199789924,0.0126706399929975
NGA,Umuahia north,2021,200306,134821,50077,0,0,385204,50077,0.130001246092979,0.0433337486976598,0.0144445828992199
NGA,Umuahia north,2022,192602,154082,73189,0,0,419873,73189,0.174312232508401,0.0581040775028004,0.0193680258342668
NGA,Umuahia south,2021,125788,84665,31447,0,0,241900,31447,0.13,0.0433333333333333,0.0144444444444444
NGA,Umuahia south,2022,120950,96760,45961,0,0,263671,45961,0.174311926605505,0.0581039755351682,0.0193679918450561
NGA,Ungogo,2020,422325,127276,28926,0,0,578527,28926,0.0499993950152715,0.0166664650050905,0.00555548833503017
NGA,Ungogo,2021,484071,202485,52067,0,0,738623,52067,0.070491983054955,0.023497327684985,0.00783244256166166
NGA,Ungogo,2022,376500,239048,53786,0,0,669334,53786,0.0803574896837752,0.0267858298945917,0.00892860996486391
NGA,Ushongo,2020,245379,35054,11685,0,0,292118,11685,0.0400009585167638,0.0133336528389213,0.00444455094630709
NGA,Ushongo,2021,251247,40324,18611,0,0,310182,18611,0.0600002579130962,0.0200000859710321,0.00666669532367735
NGA,Ushongo,2022,253260,93054,30885,0,0,377199,30885,0.0818798565213588,0.0272932855071196,0.00909776183570653
NGA,Ussa,2020,116326,14708,2674,0,0,133708,2674,0.0199988033625512,0.00666626778751708,0.00222208926250569
NGA,Ussa,2021,113652,17382,6685,0,0,137719,6685,0.0485408694515644,0.0161802898171881,0.00539342993906271
NGA,Ussa,2022,112315,16045,8022,0,0,136382,8022,0.058820078896042,0.0196066929653473,0.00653556432178245
NGA,Uzo-uwani,2021,169792,15980,13983,0,0,199755,13983,0.0700007509198769,0.023333583639959,0.00777786121331965
NGA,Uzo-uwani,2022,163799,63922,15980,0,0,243701,15980,0.0655721560436765,0.0218573853478922,0.00728579511596405
NGA,Vandeikya,2020,299882,42840,14280,0,0,357002,14280,0.0399997759116195,0.0133332586372065,0.00444441954573551
NGA,Vandeikya,2021,307053,49280,22745,0,0,379078,22745,0.060000844153446,0.020000281384482,0.006666760461494
NGA,Vandeikya,2022,309222,113723,37710,0,0,460655,37710,0.0818616969315431,0.0272872323105144,0.00909574410350479
NGA,Wamako,2020,107183,84378,34207,2280,0,228048,36487,0.159997018171613,0.0566649711171917,0.0211100781901666
NGA,Wamako,2021,190261,102622,36488,6841,0,336212,43329,0.128874043758105,0.0497404415468018,0.0211017651561118
NGA,Wamako,2022,159726,63420,35234,2349,0,260729,37583,0.144145837248637,0.0510517305963919,0.0190193223189169
NGA,Warawa,2020,152953,46096,10476,0,0,209525,10476,0.0499988068249612,0.0166662689416537,0.00555542298055125
NGA,Warawa,2021,175316,73334,18857,0,0,267507,18857,0.0704916133035771,0.0234972044345257,0.00783240147817523
NGA,Warawa,2022,136357,86576,19480,0,0,242413,19480,0.0803587266359478,0.0267862422119826,0.00892874740399419
NGA,Warji,2020,150224,23816,9160,0,0,183200,9160,0.05,0.0166666666666667,0.00555555555555556
NGA,Warji,2021,161384,73280,21984,0,0,256648,21984,0.0856581777376017,0.0285527259125339,0.00951757530417797
NGA,Warji,2022,159485,28480,9493,0,0,197458,9493,0.0480760465516718,0.0160253488505573,0.00534178295018575
NGA,Wasagu/danko,2020,312434,64089,24033,0,0,400556,24033,0.0599991012492635,0.0199997004164212,0.00666656680547373
NGA,Wasagu/danko,2021,304423,68095,28039,0,0,400557,28039,0.0700000249652359,0.0233333416550786,0.00777778055169288
NGA,Wase,2020,201378,30799,4738,0,0,236915,4738,0.0199987337230652,0.00666624457435508,0.00222208152478503
NGA,Wase,2021,194270,33546,11981,0,0,239797,11981,0.0499630937834919,0.0166543645944973,0.00555145486483243
NGA,Wase,2022,194088,71885,28754,0,0,294727,28754,0.0975614721420162,0.0325204907140054,0.0108401635713351
NGA,Wudil,2020,260783,35970,2998,0,0,299751,2998,0.0100016346901261,0.00333387823004205,0.00111129274334735
NGA,Wudil,2021,260100,44963,6193,0,0,311256,6193,0.0198968052021487,0.00663226840071624,0.00221075613357208
NGA,Wudil,2022,272486,49543,12386,0,0,334415,12386,0.0370378122990895,0.0123459374330298,0.00411531247767661
NGA,Wukari,2020,314099,39714,7221,0,0,361034,7221,0.0200008863431145,0.0066669621143715,0.0022223207047905
NGA,Wukari,2021,306878,46934,18052,0,0,371864,18052,0.0485446292192845,0.0161815430730948,0.00539384769103161
NGA,Wukari,2022,303268,43324,21662,0,0,368254,21662,0.0588235294117647,0.0196078431372549,0.0065359477124183
NGA,Wurno,2020,144758,69794,38774,5170,0,258496,43944,0.169998762069819,0.0633330238507882,0.0255555211686061
NGA,Wurno,2021,141895,90474,51699,12925,0,296993,64624,0.217594354075685,0.0870379661024558,0.038683665196748
NGA,Wurno,2022,126129,91969,60437,10511,0,289046,70948,0.245455740608761,0.0939400649031642,0.0393943447678839
NGA,Wushishi,2020,69208,45704,15670,0,0,130582,15670,0.12000122528373,0.0400004084279099,0.01333346947597
NGA,Wushishi,2021,110729,56150,16976,0,0,183855,16976,0.0923336324821191,0.0307778774940397,0.0102592924980132
NGA,Wushishi,2022,101276,55364,18905,1350,0,176895,20255,0.114502953729614,0.0407115332070814,0.0152664323782784
NGA,Yabo,2020,85082,68065,17016,0,0,170163,17016,0.0999982369845384,0.0333327456615128,0.0111109152205043
NGA,Yabo,2021,105161,76573,31548,0,0,213282,31548,0.147916842490224,0.0493056141634081,0.016435204721136
NGA,Yabo,2022,96397,56086,40312,3505,0,196300,43817,0.223214467651554,0.0803565970453388,0.0307533820116602
NGA,Yakurr,2021,262393,42112,19437,0,0,323942,19437,0.0600014817467324,0.0200004939155775,0.00666683130519249
NGA,Yakurr,2022,262393,84225,22676,0,0,369294,22676,0.061403651291383,0.0204678837637943,0.00682262792126478
NGA,Yala,2021,293304,45392,10475,0,0,349171,10475,0.0299996276895848,0.00999987589652825,0.00333329196550942
NGA,Yala,2022,300287,48884,17459,0,0,366630,17459,0.0476202165671113,0.0158734055223704,0.00529113517412347
NGA,Yamaltu/deba,2020,322907,46130,15377,0,0,384414,15377,0.0400011445993122,0.0133337148664374,0.0044445716221458
NGA,Yamaltu/deba,2021,315219,123012,38441,0,0,476672,38441,0.0806445522287863,0.0268815174095954,0.00896050580319847
NGA,Yamaltu/deba,2022,319063,134545,46130,0,0,499738,46130,0.0923083695856629,0.0307694565285543,0.0102564855095181
NGA,Yankwashi,2020,165261,28564,10201,0,0,204026,10201,0.0499985295991687,0.0166661765330562,0.00555539217768541
NGA,Yankwashi,2021,170054,28564,12597,0,0,211215,12597,0.05964065052198,0.01988021684066,0.00662673894688666
NGA,Yankwashi,2022,155358,44088,29392,0,0,228838,29392,0.128440206609042,0.0428134022030141,0.0142711340676714
NGA,Yauri,2020,118444,24296,9111,0,0,151851,9111,0.0599996048758322,0.0199998682919441,0.00666662276398136
NGA,Yauri,2021,115407,42271,10959,0,0,168637,10959,0.064985738598291,0.021661912866097,0.00722063762203233
NGA,Yauri,2022,95500,46967,28180,0,0,170647,28180,0.165136216868741,0.0550454056229136,0.0183484685409712
NGA,Yola north,2020,256271,40628,15626,0,0,312525,15626,0.0499992000639949,0.0166664000213316,0.00555546667377721
NGA,Yola north,2021,225018,128635,48238,0,0,401891,48238,0.120027569664411,0.0400091898881372,0.0133363966293791
NGA,Yola north,2022,147930,160794,57886,0,0,366610,57886,0.157895311093533,0.0526317703645109,0.017543923454837
NGA,Yola south,2020,251808,39921,15354,0,0,307083,15354,0.0499995115327127,0.0166665038442376,0.00555550128141252
NGA,Yola south,2021,221100,142195,47398,0,0,410693,47398,0.115409807325667,0.0384699357752222,0.0128233119250741
NGA,Yola south,2022,157994,157994,56878,0,0,372866,56878,0.152542736532695,0.0508475788442318,0.0169491929480773
NGA,Yorro,2020,115733,17700,2723,0,0,136156,2723,0.0199991186580099,0.00666637288600331,0.00222212429533444
NGA,Yorro,2021,114371,19062,6808,0,0,140241,6808,0.0485450046705314,0.0161816682235105,0.00539388940783683
NGA,Yorro,2022,113009,40847,17700,0,0,171556,17700,0.103173307841171,0.0343911026137238,0.0114637008712413
NGA,Yunusari,2020,58607,70732,60628,12126,6,202099,72760,0.360021573585223,0.140027082436496,0.0600288857331198
NGA,Yunusari,2021,50200,80837,77391,16167,6,224601,93564,0.416578732953104,0.162871046878687,0.0703039315645671
NGA,Yunusari,2022,46016,75299,81574,18825,0,221714,100399,0.452831124782377,0.179245935454384,0.0786167966138559
NGA,Yusufari,2020,90997,53527,30332,3568,2,178426,33902,0.190005940838219,0.0700084815740606,0.0277874300830596
NGA,Yusufari,2021,114495,71370,44606,8921,2,239394,53529,0.223602095290609,0.0869612438072801,0.0372737458378703
NGA,Yusufari,2022,94182,66481,46167,5540,0,212370,51707,0.243476008852474,0.0898541853055202,0.0357484055605259
NGA,Zaki,2020,253768,39747,12230,0,0,305745,12230,0.0400006541398878,0.0133335513799626,0.0044445171266542
NGA,Zaki,2021,266257,85608,24460,0,0,376325,24460,0.0649970105626785,0.0216656701875595,0.00722189006251984
NGA,Zaki,2022,266257,50119,12530,0,0,328906,12530,0.0380959909518221,0.0126986636506074,0.00423288788353579
NGA,Zamfara IDPs,2022,45658,54218,45658,21402,0,166936,67060,0.401710835290171,0.176638552099807,0.0873694775908798
NGA,Zango,2020,197129,35626,4750,0,0,237505,4750,0.0199995789562325,0.00666652631874417,0.00222217543958139
NGA,Zango,2021,187629,56265,19570,0,0,263464,19570,0.0742795979716394,0.0247598659905465,0.00825328866351549
NGA,Zango,2022,193258,78282,31802,2446,0,305788,34248,0.111999162818685,0.039999389555291,0.0151106867066944
NGA,Zango-kataf,2020,263562,143761,71880,0,0,479203,71880,0.14999906094077,0.0499996869802568,0.0166665623267523
NGA,Zango-kataf,2021,246790,197432,86257,0,0,530479,86257,0.162602101119931,0.0542007003733104,0.0180669001244368
NGA,Zango-kataf,2022,399799,172753,108587,0,0,681139,108587,0.159419736646999,0.0531399122156662,0.0177133040718887
NGA,Zaria,2020,427979,140622,42798,0,0,611399,42798,0.0700001144915186,0.0233333714971729,0.00777779049905763
NGA,Zaria,2021,403034,188922,61140,0,0,653096,61140,0.0936156399671717,0.0312052133223906,0.0104017377741302
NGA,Zaria,2022,516388,188922,56677,0,0,761987,56677,0.0743805340511059,0.0247935113503686,0.00826450378345621
NGA,Zing,2020,164440,25150,3869,0,0,193459,3869,0.0199990695702965,0.00666635652343218,0.00222211884114406
NGA,Zing,2021,162506,27084,9673,0,0,199263,9673,0.0485438842133261,0.0161812947377754,0.00539376491259179
NGA,Zing,2022,160571,58038,25150,0,0,243759,25150,0.103175677616006,0.0343918925386687,0.0114639641795562
NGA,Zurmi,2021,274216,141836,56734,0,0,472786,56734,0.119999323161007,0.0399997743870024,0.0133332581290008
NGA,Zurmi,2022,236393,203298,113469,4728,0,557888,118197,0.211865105540897,0.0734466416198233,0.0263655070551795
NGA,Zuru,2020,194730,39945,14979,0,0,249654,14979,0.0599990386695186,0.0199996795565062,0.00666655985216874
NGA,Zuru,2021,189737,69496,18018,0,0,277251,18018,0.0649880433253622,0.0216626811084541,0.00722089370281802
NGA,Zuru,2022,157010,77218,46331,0,0,280559,46331,0.165138170580876,0.055046056860292,0.0183486856200973
PAK,Awaran,2019,8744,17487,52462,13115,0,91808,65577,0.71428415824329,0.285712210991054,0.1269823980481
PAK,Badin,2019,32791,49187,73780,24593,0,180351,98373,0.545453033251826,0.227271635126318,0.106059849959246
PAK,Badin,2021,762997,610398,305199,76300,0,1754894,381499,0.217391477775866,0.0869566290993454,0.0386474118158197
PAK,Badin,2022,610398,686697,152599,76300,0,1525994,228899,0.149999934468943,0.0666667103540381,0.0333333915831619
PAK,Bajaur,2020,460490,276294,138147,92098,0,967029,230245,0.238095238095238,0.111111111111111,0.0582010582010582
PAK,Bajaur,2021,497124,434984,248562,62141,0,1242811,310703,0.250000201156894,0.100000187746434,0.0444445874893465
PAK,Bajaur,2022,497124,434984,248562,62141,0,1242811,310703,0.250000201156894,0.100000187746434,0.0444445874893465
PAK,Chagai,2019,20969,52422,83876,62907,0,220174,146783,0.666668180620782,0.317461038390849,0.169312553808453
PAK,Chagai,2021,95414,87152,71561,12450,0,266577,84011,0.315147218252137,0.120616807401489,0.0505840922343471
PAK,Chagai,2022,87152,87152,62252,12450,0,249006,74702,0.300000803193497,0.116666532801084,0.0499996876469733
PAK,Dadu,2019,37369,43597,43597,18684,0,143247,62281,0.434780484059003,0.188404178330669,0.0917862929842238
PAK,Dadu,2021,611107,427775,122221,61111,0,1222214,183332,0.149999918181268,0.0666667212124882,0.0333334060610953
PAK,Dadu,2022,733328,366664,122221,0,0,1222213,122221,0.0999997545436025,0.0333332515145342,0.0111110838381781
PAK,Dera Bugti,2021,57157,114315,57157,34294,0,262923,91451,0.347824267941565,0.159419297665096,0.0821250159003037
PAK,Dera bugti,2019,42660,63991,74656,53326,0,234633,127982,0.545456095263667,0.257576726206459,0.13636426059231
PAK,Ghotki,2021,603663,402442,268295,134147,0,1408547,402442,0.285714285714286,0.126984048100631,0.0634919846085679
PAK,Gwadar,2019,15287,25479,61149,10192,0,112107,71341,0.636365258190836,0.242426134555975,0.101011632735789
PAK,Gwadar,2021,41926,41926,15722,5241,0,104815,20963,0.2,0.0833341283849322,0.0388896839404877
PAK,Jamshoro,2017,175489,280783,236911,175489,0,868672,412400,0.474747660797171,0.225589175200766,0.120089695023617
PAK,Jamshoro,2019,32712,40890,65424,40890,0,179916,106314,0.590909090909091,0.272727272727273,0.141414141414141
PAK,Jamshoro,2021,232416,174312,145260,29052,0,581040,174312,0.3,0.116666666666667,0.05
PAK,Jamshoro,2022,261468,174312,116208,29052,0,581040,145260,0.25,0.1,0.0444444444444444
PAK,Jhal magsi,2019,28280,42420,49490,21210,0,141400,70700,0.5,0.216666666666667,0.105555555555556
PAK,Kachhi,2019,101299,50650,40520,20260,0,212729,60780,0.285715628804723,0.12698472391321,0.0634923619566052
PAK,Kech,2019,60698,151745,364188,91047,0,667678,455235,0.681818181818182,0.272727272727273,0.121212121212121
PAK,Kech,2021,270751,280769,203063,35096,0,789679,238159,0.301589633256045,0.115344336116321,0.0483244176149775
PAK,Kech,2022,245673,280769,140384,35096,0,701922,175480,0.24999928767014,0.099999715068056,0.0444443178080249
PAK,Khairpur,2021,786166,611462,262055,174704,0,1834387,436759,0.238095341931664,0.111111232253608,0.0582011562687941
PAK,Kharan,2019,39024,44599,27874,5575,0,117072,33449,0.285713065463988,0.111111111111111,0.0476193187857805
PAK,Kharan,2021,49306,54095,30816,12021,0,146238,42837,0.292926599105568,0.125042738549488,0.0599479387482506
PAK,Kharan,2022,49306,36979,30816,6163,0,123264,36979,0.299998377466251,0.116665584977501,0.0499992788738895
PAK,Khuzdar,2021,144319,346366,86591,28864,0,606140,115455,0.190475797670505,0.0793650531780337,0.0370370981401436
PAK,Khyber,2020,573688,191229,143422,47807,0,956146,191229,0.199999790826924,0.0833331590224366,0.038888761060898
PAK,Khyber,2021,503362,302017,151008,50336,0,1006723,201344,0.199999404006862,0.0833330850028591,0.0388887730013342
PAK,Khyber,2022,453025,352353,151008,50336,0,1006722,201344,0.199999602670847,0.0833331677795194,0.0388888116304424
PAK,Killa Abdullah,2021,320444,249234,106815,35605,0,712098,142420,0.200000561720437,0.0833335673835156,0.0388889981123073
PAK,Killa Abdullah,2022,320444,249234,106815,35605,0,712098,142420,0.200000561720437,0.0833335673835156,0.0388889981123073
PAK,Killa abdullah,2019,243294,182471,152059,60824,0,638648,212883,0.333333855269256,0.142857515668516,0.0687833256086817
PAK,Kurram,2020,183282,160371,91641,45820,0,481114,137461,0.285713988784363,0.126983764069777,0.0634917665621407
PAK,Kurram,2021,216043,246906,123453,30863,0,617265,154316,0.249999594987566,0.0999997299917107,0.0444442644389183
PAK,Kurram,2022,216043,216043,154317,30863,0,617266,185180,0.300000324009422,0.116666612665096,0.0499998739963358
PAK,Lasbela,2021,158635,95181,47591,15864,0,317271,63455,0.200002521503699,0.0833346466165098,0.03888964183791
PAK,Loralai,2019,149608,99739,99739,16623,0,365709,116362,0.318181942473387,0.121212038351075,0.0505049400236557
PAK,Loralai,2021,91066,145705,109279,18213,0,364263,127492,0.349999862736539,0.133333150315386,0.0555554030405992
PAK,Loralai,2022,91066,127492,127492,18213,0,364263,145705,0.399999450946157,0.149999679718592,0.0611109128416678
PAK,Mirpur khas,2021,580397,522357,232159,58040,0,1392953,290199,0.208333662370518,0.0833335128081613,0.0370371433924906
PAK,Mirpur khas,2022,580397,348238,174119,58040,0,1160794,232159,0.20000017229586,0.0833334769132163,0.0388889941808031
PAK,Mohmand,2020,254449,226177,84816,28272,0,593714,113088,0.190475548833277,0.0793648120138653,0.0370369122731371
PAK,Mohmand,2021,178975,153407,153407,25568,0,511357,178975,0.350000097779047,0.133333463705396,0.0555556641989408
PAK,Mohmand,2022,178975,153407,153407,25568,0,511357,178975,0.350000097779047,0.133333463705396,0.0555556641989408
PAK,North Waziristan,2020,341274,238891,102382,34127,0,716674,136509,0.190475725364671,0.0793647692907328,0.037036830320806
PAK,North Waziristan,2021,175556,234074,146296,29259,0,585185,175555,0.29999914556935,0.116666239451342,0.0499997626581527
PAK,North Waziristan,2022,175556,204815,175556,29259,0,585186,204815,0.349999829114162,0.133333105485549,0.0555553656824022
PAK,Nushki,2019,22510,33103,52964,23834,0,132411,76798,0.579997130147797,0.253332427064217,0.124444175920262
PAK,Nushki,2021,89765,52363,14511,14511,0,171150,29022,0.169570552147239,0.0847852760736196,0.0471029311520109
PAK,Nushki,2022,82284,59843,7480,0,0,149607,7480,0.0499976605372743,0.0166658868457581,0.0055552956152527
PAK,Orakzai,2020,132718,58986,73732,29493,0,294929,103225,0.349999491403016,0.149999943489224,0.0722222787329983
PAK,Orakzai,2021,52224,130561,65281,13056,0,261122,78337,0.300001531851012,0.11666704962942,0.050000042551417
PAK,Orakzai,2022,52224,130561,65281,13056,0,261122,78337,0.300001531851012,0.11666704962942,0.050000042551417
PAK,Panjgur,2019,70818,35409,106227,35409,0,247863,141636,0.571428571428571,0.238095238095238,0.111111111111111
PAK,Panjgur,2021,110278,97112,49012,24506,0,280908,73518,0.261715579477979,0.116318035323546,0.058159017661773
PAK,Panjgur,2022,110278,61266,49012,24506,0,245062,73518,0.299997551639993,0.13333224517333,0.0666661225866651
PAK,Pishin,2019,267003,148335,178002,59334,0,652674,237336,0.363636363636364,0.151515151515152,0.0707070707070707
PAK,Pishin,2021,269100,235462,134550,33637,0,672749,168187,0.24999962839038,0.099999653164355,0.0444441801887149
PAK,Pishin,2022,235462,235462,168187,33637,0,672748,201824,0.299999405423725,0.116666270282483,0.0499997357438777
PAK,Qambar Shahdadkot,2019,9610,12012,22583,8649,0,52854,31232,0.590910810913081,0.251516756852209,0.120203243315969
PAK,Sanghar,2017,590825,437648,656472,481413,0,2166358,1137885,0.525252520589856,0.249158264700479,0.132435482347177
PAK,Sanghar,2019,10075,10075,17631,15113,0,52894,32744,0.619049419593905,0.301590602588826,0.164024064901291
PAK,Sanghar,2021,632446,711502,316223,79056,0,1739227,395279,0.227272805677465,0.0909091606021909,0.0404040926738654
PAK,Sanghar,2022,711502,553390,237167,79056,0,1581115,316223,0.2,0.0833333860387553,0.0388889415943109
PAK,Shaheed Benazirabad,2021,476350,416807,238175,119088,0,1250420,357263,0.285714399961613,0.126984266619749,0.0634921777393907
PAK,South Waziristan,2020,381660,173482,138785,69393,0,763320,208178,0.272727034533354,0.121212160911108,0.0606061532370289
PAK,South Waziristan,2021,111622,260451,297658,74415,0,744146,372073,0.5,0.200000179176309,0.0888890680651975
PAK,South Waziristan,2022,111622,223244,334865,74415,0,744146,409280,0.549999596853306,0.216666711460744,0.0944445788266759
PAK,Sujawal,2021,298080,223560,149040,74520,0,745200,223560,0.3,0.133333333333333,0.0666666666666667
PAK,Sujawal,2022,298080,223560,149040,74520,0,745200,223560,0.3,0.133333333333333,0.0666666666666667
PAK,Sukkur,2021,501340,208892,83557,41778,0,835567,125335,0.149999940160394,0.0666665070943842,0.0333331870587411
PAK,Tharparkar,2017,316689,275382,234075,550764,0,1376910,784839,0.570000217879164,0.323333405959721,0.196666690875463
PAK,Tharparkar,2019,303767,379709,455651,455651,0,1594778,911302,0.571428750584721,0.28571437529236,0.158730208495756
PAK,Tharparkar,2021,662938,745806,414337,165735,0,1988816,580072,0.291667001874482,0.125000167603908,0.0601852782984672
PAK,Tharparkar,2022,662938,414337,414337,165735,0,1657347,580072,0.350000331855671,0.150000170955952,0.0722223194324691
PAK,Thatta,2021,302414,388818,129606,43202,0,864040,172808,0.2,0.0833333333333333,0.0388888888888889
PAK,Thatta,2022,259212,432021,129606,43202,0,864041,172808,0.199999768529503,0.0833332368872928,0.0388888438807366
PAK,Tribal Sub Division Bannu,2020,28925,22497,12855,3214,0,67491,16069,0.238091004726556,0.0952373896766482,0.0423282775151913
PAK,Tribal Sub Division Dera Ismail Khan,2020,46184,34638,28865,5773,0,115460,34638,0.3,0.116666666666667,0.05
PAK,Tribal Sub Division Kohat,2020,59267,39512,9878,4939,0,113596,14817,0.130435930842635,0.057971524818949,0.0289857624094745
PAK,Tribal Sub Division Lakki Marwat,2020,6957,5963,4969,2981,0,20870,7950,0.380929563967417,0.174588723846031,0.0899377096310494
PAK,Tribal Sub Division Peshawar,2020,57256,31809,31809,6362,0,127236,38171,0.300001571882172,0.116667714588115,0.0500006986142985
PAK,Tribal Sub Division Tank,2020,13580,5659,3395,1132,0,23766,4527,0.190482201464277,0.0793710903531656,0.037041712249993
PAK,Umer Kot,2019,32018,40022,48027,48027,0,168094,96054,0.571430271157805,0.285715135578902,0.158730630877168
PAK,Umer kot,2021,355660,311202,177830,44457,0,889149,222287,0.249999718832277,0.0999997375767916,0.0444442445029523
PAK,Umer kot,2022,355660,355660,133372,44457,0,889149,177829,0.199999100263285,0.0833328647204612,0.0388886202175089
PAK,Umerkot,2017,389459,239667,179750,179750,0,988626,359500,0.363635995816416,0.181817997908208,0.101009998837893
PAK,Umerkot,2021,400117,311202,222287,44457,0,978063,266744,0.272726807986807,0.106060311724978,0.045454354394576
PAK,Washuk,2019,15433,38584,61734,46300,0,162051,108034,0.666666666666667,0.317459729755859,0.169311581607711
PAK,Washuk,2021,68702,58528,42939,16722,0,186891,59661,0.319228855322086,0.136234489622293,0.065294743995163
PAK,Washuk,2022,68702,42939,51527,8588,0,171756,60115,0.350002328885163,0.133334497775915,0.0555562024681008
SDN,Abassiya,2020,57501,57501,38334,6389,0,159725,44723,0.28,0.106666666666667,0.0444444444444444
SDN,Abassiya,2021,65807,46064,26322,6580,0,144773,32902,0.227266133878555,0.0909055325693787,0.0404019472630332
SDN,Abassiya,2022,74559,54224,27112,13556,0,169451,40668,0.239998583661353,0.106666037182824,0.0533330185914119
SDN,Abu hamad,2019,92466,16711,2228,0,0,111405,2228,0.0199991023742202,0.0066663674580734,0.00222212248602446
SDN,Abu hamad,2020,142994,44686,17874,0,0,205554,17874,0.0869552526343443,0.0289850842114481,0.00966169473714936
SDN,Abu hamad,2021,74958,46128,11532,0,0,132618,11532,0.0869565217391304,0.0289855072463768,0.00966183574879227
SDN,Abu hamad,2022,100473,11820,5910,5910,0,124113,11820,0.0952357931884653,0.0476178965942327,0.0264543869967959
SDN,Abu hujar,2019,165885,14161,22253,0,0,202299,22253,0.110000543749598,0.0366668479165328,0.0122222826388443
SDN,Abu hujar,2020,81729,102161,40864,10216,0,234970,51080,0.217389453972848,0.086955781589139,0.0386470140396174
SDN,Abu hujar,2021,116872,84998,63748,10624,0,276242,74372,0.269227706141716,0.102562246146495,0.0427338670038911
SDN,Abu hujar,2022,98969,98969,43986,10996,0,252920,54982,0.217388897675154,0.0869550318941431,0.038646387966331
SDN,Abu jabrah,2019,22213,53311,8885,4443,0,88852,13328,0.150002250934138,0.0666689176008043,0.0333350840598848
SDN,Abu jabrah,2020,58043,40184,13395,0,0,111622,13395,0.120003225170665,0.0400010750568884,0.0133336916856295
SDN,Abu jabrah,2021,55185,41389,22994,9197,0,128765,32191,0.249998058478624,0.107140915621481,0.0515857915151201
SDN,Abu jabrah,2022,37710,37710,23568,4713,0,103701,28281,0.272716752972488,0.106054907860098,0.0454511849773226
SDN,Abu jubayhah,2019,82348,56614,18871,13725,0,171558,32596,0.18999988342135,0.0900006606123488,0.0477784642964932
SDN,Abu jubayhah,2020,95199,95199,28560,0,0,218958,28560,0.130435974022415,0.0434786580074718,0.0144928860024906
SDN,Abu jubayhah,2021,107859,88249,29416,9805,0,235329,39221,0.166664541981651,0.0694432050448521,0.0324066401600407
SDN,Abu jubayhah,2022,111096,70697,40398,10100,0,232291,50498,0.2173911171763,0.0869570208631989,0.0386478837129099
SDN,Abu karinka,2019,37263,102068,14581,8101,0,162013,22682,0.140001111021955,0.0633344237808077,0.0322230657759288
SDN,Abu karinka,2020,81412,81412,24423,0,0,187247,24423,0.13043199624026,0.0434773320800867,0.0144924440266956
SDN,Abu karinka,2021,117395,75468,41927,8385,0,243175,50312,0.206896268119667,0.0804592029060005,0.0344822544349634
SDN,Abu karinka,2022,68760,68760,42975,8595,0,189090,51570,0.272727272727273,0.106060606060606,0.0454545454545455
SDN,Abu kershola,2020,35917,51310,35917,15393,0,138537,51310,0.37037037037037,0.160493827160494,0.0781893004115226
SDN,Abu kershola,2021,52849,42279,21139,5284,0,121551,26423,0.217382004261586,0.086951156304761,0.0386440442466308
SDN,Abu kershola,2022,48991,43547,27217,10886,0,130641,38103,0.291661882563667,0.1249964916578,0.0601827399769853
SDN,Abu zabad,2019,63532,32861,8763,4382,0,109538,13145,0.120004016870858,0.0533361329705977,0.0266685736659627
SDN,Abu zabad,2020,55317,44254,16595,0,0,116166,16595,0.142855913089889,0.0476186376966295,0.0158728792322098
SDN,Abu zabad,2021,84635,33854,11284,5642,0,135415,16926,0.124993538382011,0.0555526837253382,0.0277763418626691
SDN,Abu zabad,2022,63307,40286,23020,11510,0,138123,34530,0.249994570057123,0.111108697803166,0.0555543489015829
SDN,Abyei,2019,55230,24100,14059,7029,0,100418,21088,0.210002190842279,0.0933332005550134,0.0466660470345069
SDN,Abyei,2020,122648,89198,44599,11150,0,267595,55749,0.208333489041275,0.0833336447492168,0.0370373138511557
SDN,Abyei,2021,80603,37201,12400,6200,0,136404,18600,0.136359637547286,0.0606042833543493,0.0303021416771747
SDN,Abyei,2022,56918,44269,25297,12648,0,139132,37945,0.272726619325533,0.121211032209221,0.0606051168035471
SDN,Abyei pca area,2019,60186,42130,14445,3611,0,120372,18056,0.150001661515967,0.0600001107677312,0.0266664082086273
SDN,Ad dabbah,2019,179617,24493,0,0,0,204110,0,0,0,0
SDN,Ad dabbah,2020,143591,71796,20513,0,0,235900,20513,0.0869563374311149,0.0289854458103716,0.00966181527012388
SDN,Ad dabbah,2021,126770,63385,21128,10564,0,221847,31692,0.142855211023814,0.0634912048994728,0.0317456024497364
SDN,Ad dabbah,2022,151596,97454,21656,10828,0,281534,32484,0.115382156329253,0.051280958368557,0.0256404791842785
SDN,Ad dali,2019,81015,17517,10948,0,0,109480,10948,0.1,0.0333333333333333,0.0111111111111111
SDN,Ad dali,2020,60816,38701,22115,5529,0,127161,27644,0.217393697753242,0.0869580033710546,0.038648292759223
SDN,Ad dali,2021,57498,51748,22999,5749,0,137994,28748,0.20832789831442,0.0833297099873908,0.0370346214730753
SDN,Ad dali,2022,47608,53559,17853,11902,0,130922,29755,0.227272727272727,0.106060606060606,0.0555555555555556
SDN,Ad damar,2019,315859,59224,19741,0,0,394824,19741,0.0499994934451806,0.0166664978150602,0.00555549927168674
SDN,Ad damar,2020,277759,138879,39680,0,0,456318,39680,0.0869569028616009,0.0289856342872003,0.00966187809573343
SDN,Ad damar,2021,245221,143045,40870,20435,0,449571,61305,0.136363333044169,0.0606059257974084,0.0303029628987042
SDN,Ad damar,2022,230406,188514,41892,20946,0,481758,62838,0.130434782608696,0.0579710144927536,0.0289855072463768
SDN,Ad dinder,2019,229074,29750,38675,0,0,297499,38675,0.130000436976259,0.0433334789920862,0.0144444929973621
SDN,Ad dinder,2020,180284,135213,45071,15024,0,375592,60095,0.160000745489787,0.0666671991593715,0.0311114779394189
SDN,Ad dinder,2021,156246,140621,46873,0,0,343740,46873,0.136361785070111,0.0454539283567037,0.0151513094522346
SDN,Ad dinder,2022,145544,145544,64686,16172,0,371946,80858,0.217391771923881,0.0869570672445283,0.0386477845947769
SDN,Ad diwaim,2019,272854,86620,43310,30317,0,433101,73627,0.169999607481858,0.07999981528558,0.0422221247340561
SDN,Ad diwaim,2020,174973,196845,43743,21872,0,437433,65615,0.150000114303219,0.0666669714752507,0.033333612741202
SDN,Ad diwaim,2021,227465,227465,45493,22746,0,523169,68239,0.13043395155294,0.0579704327537246,0.0289851101864046
SDN,Ad diwaim,2022,188341,258969,47085,23542,0,517937,70627,0.136362144430693,0.0606051829984471,0.0303024842360708
SDN,Ad du'ayn,2019,28078,98272,8423,5616,0,140389,14039,0.10000071230652,0.0466679488184022,0.0244455683058423
SDN,Ad du'ayn,2020,70545,63490,14109,0,0,148144,14109,0.0952384166756669,0.031746138891889,0.0105820462972963
SDN,Ad du'ayn,2021,72661,72661,29064,14532,0,188918,43596,0.230766787706836,0.102563016758594,0.0512815083792968
SDN,Adila,2019,23534,84982,13074,9152,0,130742,22226,0.169998929188784,0.0799997960359589,0.0422222562162291
SDN,Adila,2020,72268,52558,39419,6570,0,170815,45989,0.269232795714662,0.102565153333528,0.0427356431747147
SDN,Adila,2021,87969,74435,13533,6766,0,182703,20299,0.111103813292612,0.0493788644229524,0.0246891281357054
SDN,Adila,2022,62424,62424,27744,6936,0,159528,34680,0.217391304347826,0.0869565217391304,0.0386473429951691
SDN,Ag geneina,2020,438708,125345,125345,62673,0,752071,188018,0.250000332415424,0.111111406591488,0.0555557771658379
SDN,Ag geneina,2021,161382,355040,129106,129106,0,774634,258212,0.333334193954823,0.166667096977411,0.0925928316541174
SDN,Ag geneina,2022,231583,264666,165416,132333,0,793998,297749,0.374999685137746,0.180555450601471,0.0972221872375273
SDN,Agig,2019,53623,8512,17023,5958,0,85116,22981,0.269996240424832,0.113331610194715,0.0533324456558631
SDN,Agig,2020,47048,42771,17108,4277,0,111204,21385,0.19230423366066,0.0769216934642639,0.0341874193174506
SDN,Agig,2021,34558,38878,17279,8639,0,99354,25918,0.260865189121726,0.115938965718542,0.0579689236914915
SDN,Agig,2022,30722,43889,17555,8777,0,100943,26332,0.26086008935736,0.115936716760944,0.0579678080148643
SDN,Aj jabalain,2019,200460,82949,41474,20737,0,345620,62211,0.179998263989352,0.0799992284397122,0.0399996142198561
SDN,Aj jabalain,2020,122177,157085,69815,17454,0,366531,87269,0.23809445858604,0.0952379653198956,0.0423280856341089
SDN,Aj jabalain,2021,181520,163368,54456,18152,0,417496,72608,0.173913043478261,0.072463768115942,0.0338164251207729
SDN,Aj jabalain,2022,131511,169085,75149,37574,0,413319,112723,0.272726392931368,0.121211461365193,0.060605596269333
SDN,Al buhaira,2019,46513,16612,3322,0,0,66447,3322,0.0499947326440622,0.0166649108813541,0.00555497029378469
SDN,Al buhaira,2021,37830,27513,6878,0,0,72221,6878,0.0952354578308248,0.0317451526102749,0.0105817175367583
SDN,Al buhaira,2022,52877,14100,7050,3525,0,77552,10575,0.136360119661646,0.0606044976273984,0.0303022488136992
SDN,Al buram,2020,41199,65917,57678,41199,0,205993,98877,0.480001747632201,0.226667896481919,0.120000841452541
SDN,Al buram,2021,76382,67895,25460,33947,0,203684,59407,0.291662575361835,0.15277586850219,0.0879619628662263
SDN,Al buram,2022,69932,69932,43707,34966,0,218537,78673,0.359998535717064,0.173332967262599,0.0933332926588073
SDN,Al burgaig,2019,102088,19445,0,0,0,121533,0,0,0,0
SDN,Al burgaig,2020,85499,36642,12214,0,0,134355,12214,0.0909084142756131,0.0303028047585377,0.0101009349195126
SDN,Al burgaig,2021,75483,44031,12580,0,0,132094,12580,0.0952352112889306,0.0317450704296435,0.0105816901432145
SDN,Al burgaig,2022,90265,45132,12895,6447,0,154739,19342,0.124997576564408,0.0555537604180803,0.0277765211815451
SDN,Al butanah,2019,92193,10689,26723,4008,0,133613,30731,0.230000074843017,0.0866657186551209,0.0355545909122283
SDN,Al butanah,2020,46998,53712,40284,6714,0,147708,46998,0.318181818181818,0.121212121212121,0.0505050505050505
SDN,Al butanah,2021,63447,63447,21149,7049,0,155092,28198,0.181814664844093,0.0757550357207335,0.0353517768664907
SDN,Al butanah,2022,51322,65986,43991,14664,0,175963,58655,0.333337122008604,0.138890941087994,0.0648160250860819
SDN,Al dibab,2019,42242,23468,7823,4694,0,78227,12517,0.160008692650875,0.0733378501029057,0.0377803628471556
SDN,Al dibab,2020,51355,23702,7901,3950,0,86908,11851,0.136362590325402,0.0606043172090026,0.0303015193589134
SDN,Al dibab,2021,52382,24176,12088,4029,0,92675,16117,0.173908821149177,0.0724611096124449,0.0338147049126278
SDN,Al dibab,2022,45210,28769,20550,4110,0,98639,24660,0.25000253449447,0.0972232078589604,0.0416670890824116
SDN,Al fao,2019,166065,109603,46498,9964,0,332130,56462,0.169999698913076,0.0666666666666667,0.0288889557970942
SDN,Al fao,2020,166895,183585,50069,16689,0,417238,66758,0.15999980826291,0.0666661873239414,0.0311106743766281
SDN,Al fao,2021,175240,157716,52572,35048,0,420576,87620,0.208333333333333,0.0972222222222222,0.0509259259259259
SDN,Al fao,2022,145800,164025,109350,18225,0,437400,127575,0.291666666666667,0.111111111111111,0.0462962962962963
SDN,Al fashaga,2019,17794,3878,684,456,0,22812,1140,0.049973698053656,0.0233210590917061,0.0122157928575603
SDN,Al fashaga,2020,9171,9171,5732,1146,0,25220,6878,0.272720063441713,0.106053396775046,0.0454489382324434
SDN,Al fashaga,2021,13240,10832,3610,1203,0,28885,4813,0.16662627661416,0.0694247302521493,0.0323966687823361
SDN,Al fashaga,2022,10014,11266,6259,1252,0,28791,7511,0.260880136153659,0.101455315897329,0.043481952307627
SDN,Al fasher,2019,70299,281198,98419,18747,0,468663,117166,0.250000533432338,0.0966671858741427,0.0411115117780675
SDN,Al fasher,2020,113013,310786,141266,84760,0,649825,226026,0.34782595314123,0.159420356762718,0.0821257005091114
SDN,Al fasher,2021,199750,285358,171214,28535,0,684857,199749,0.291665267347782,0.111110299911758,0.046295796056695
SDN,Al fasher,2022,201148,229884,143677,28735,0,603444,172412,0.2857133387688,0.111110558726245,0.0476187056665113
SDN,Al firdous,2019,10224,66459,16359,9202,0,102244,25561,0.25,0.113333463740334,0.057777908184778
SDN,Al firdous,2020,46240,56515,20551,5138,0,128444,25689,0.200001557098813,0.0800011418724632,0.0355563514060602
SDN,Al firdous,2021,84670,47627,21167,5291,0,158755,26458,0.166659317816762,0.0666624673238638,0.0296270633645834
SDN,Al firdous,2022,48817,43393,27121,5424,0,124755,32545,0.260871307763216,0.101449507701762,0.043478105976603
SDN,Al galabat al gharbyah - kassab,2019,120860,31078,15539,5180,0,172657,20719,0.120000926692807,0.0500008687745067,0.0233339961761051
SDN,Al galabat al gharbyah - kassab,2020,78084,86760,26028,8676,0,199548,34704,0.173913043478261,0.072463768115942,0.0338164251207729
SDN,Al galabat al gharbyah - kassab,2021,91098,81988,27329,18219,0,218634,45548,0.208329902942818,0.0972203164497135,0.0509247824624207
SDN,Al galabat al gharbyah - kassab,2022,75794,85268,56845,18948,0,236855,75793,0.319997466804585,0.133331926002547,0.0622213778237506
SDN,Al ganab,2019,38162,33074,40706,15265,0,127207,55971,0.439999371103791,0.186666876298736,0.0888892382756714
SDN,Al ganab,2020,57529,51136,25568,12784,0,147017,38352,0.260867790799703,0.115941240355424,0.0579706201777119
SDN,Al ganab,2021,51648,64560,19368,12912,0,148488,32280,0.217391304347826,0.101449275362319,0.0531400966183575
SDN,Al ganab,2022,32796,65593,19677,26237,0,144303,45914,0.318177723262857,0.166665511689524,0.0959593509644444
SDN,Al gitaina,2019,233427,82597,35912,7182,0,359118,43094,0.119999554463992,0.0466661840026584,0.0199996163439934
SDN,Al gitaina,2020,145084,163219,36271,18135,0,362709,54406,0.149999035039109,0.0666659314583684,0.0333328125607887
SDN,Al gitaina,2021,207469,188608,37721,18860,0,452658,56581,0.124997238533286,0.0555540827733079,0.0277769186548
SDN,Al gitaina,2022,175689,195210,39042,19521,0,429462,58563,0.136363636363636,0.0606060606060606,0.0303030303030303
SDN,Al golid,2019,89836,21073,0,0,0,110909,0,0,0,0
SDN,Al golid,2020,78024,33438,22293,0,0,133755,22293,0.166670404844679,0.0555568016148929,0.018518933871631
SDN,Al golid,2021,63143,40182,11480,5740,0,120545,17220,0.142851217387698,0.0634894299500878,0.0317447149750439
SDN,Al golid,2022,88257,35303,11767,5883,0,141210,17650,0.124991147935699,0.0555508344545948,0.0277750238022173
SDN,Al hasahisa,2019,758413,89225,44613,0,0,892251,44613,0.050000504342388,0.016666834780796,0.00555561159359866
SDN,Al hasahisa,2020,405528,405528,135175,45059,0,991290,180234,0.181817631570983,0.0757575146189981,0.035353596492113
SDN,Al hasahisa,2021,796637,187444,93722,46861,0,1124664,140583,0.125,0.0555555555555556,0.0277777777777778
SDN,Al hasahisa,2022,485011,436510,97002,48501,0,1067024,145503,0.136363380767443,0.0606059470077524,0.0303029735038762
SDN,Al idia,2019,84053,36423,14009,5604,0,140089,19613,0.140003854692374,0.0600023318509424,0.0288903641415259
SDN,Al idia,2020,113192,35372,21224,14149,0,183937,35373,0.192310410629726,0.0897444958509345,0.0470088490443286
SDN,Al idia,2021,64944,64944,28864,7216,0,165968,36080,0.217391304347826,0.0869565217391304,0.0386473429951691
SDN,Al idia,2022,80963,44161,29441,14720,0,169285,44161,0.260867767374546,0.115940573588918,0.0579699586167968
SDN,Al kamlin,2019,517973,70633,0,0,0,588606,0,0,0,0
SDN,Al kamlin,2020,297246,267521,89173,29725,0,683665,118898,0.173912661903125,0.0724638529104167,0.0338165947097222
SDN,Al kamlin,2021,525531,154568,61827,30913,0,772839,92740,0.119999120127219,0.0533327985087019,0.0266663273693198
SDN,Al kamlin,2022,351951,255964,63991,0,0,671906,63991,0.0952380243665037,0.0317460081221679,0.0105820027073893
SDN,Al khiwai,2019,44662,26797,12505,5359,0,89323,17864,0.199993282805101,0.0866630095272214,0.0422200577927546
SDN,Al khiwai,2020,45109,36087,13533,9022,0,103751,22555,0.217395494983181,0.101451230992151,0.0531411209958887
SDN,Al khiwai,2021,55213,32207,9202,4601,0,101223,13803,0.136362289203047,0.0606054618680208,0.0303027309340104
SDN,Al khiwai,2022,56317,28159,14079,9386,0,107941,23465,0.217387276382468,0.101447395645152,0.0531391120046033
SDN,Al koma,2019,2127,13827,4680,638,0,21272,5318,0.25,0.0933308261251097,0.0377752705695541
SDN,Al koma,2020,70619,82388,58849,23539,0,235395,82388,0.349998937955352,0.149998937955352,0.0722213961874957
SDN,Al koma,2021,10362,11657,5181,1295,0,28495,6476,0.227267941744166,0.090904837105925,0.040400850051666
SDN,Al koma,2022,9130,11738,7825,1304,0,29997,9129,0.304330433043304,0.115933815603783,0.0483048304830483
SDN,Al kurmuk,2019,80653,53769,28677,16131,0,179230,44808,0.250002789711544,0.11333482117949,0.0577786456880359
SDN,Al kurmuk,2020,63044,81056,45031,18013,0,207144,63044,0.304348665662534,0.130435832078168,0.0628027952642713
SDN,Al kurmuk,2021,83488,74211,55658,18552,0,231909,74210,0.319996205408156,0.1333310335807,0.0622207657122214
SDN,Al kurmuk,2022,47542,76067,57050,38033,0,218692,95083,0.434780421780404,0.202897225321457,0.1062793538147
SDN,Al lagowa,2019,56376,24300,12636,3888,0,97200,16524,0.17,0.07,0.0322222222222222
SDN,Al lagowa,2020,73629,19634,9817,0,0,103080,9817,0.0952367093519596,0.0317455697839866,0.0105818565946622
SDN,Al lagowa,2021,70094,25033,15020,5006,0,115153,20026,0.173907757505232,0.0724601182774222,0.0338139499429262
SDN,Al lagowa,2022,56175,30641,20427,10213,0,117456,30640,0.26086364255551,0.115938450710621,0.0579687523649518
SDN,Al lait,2019,26421,47557,26421,5284,0,105683,31705,0.300000946225978,0.116666508962337,0.0499996320232309
SDN,Al lait,2020,31855,70081,25484,6371,0,133791,31855,0.238095238095238,0.0952380952380952,0.0423280423280423
SDN,Al lait,2021,45042,70781,25738,6434,0,147995,32172,0.217385722490625,0.0869533880649121,0.0386454497336622
SDN,Al lait,2022,45358,71277,32398,19439,0,168472,51837,0.307689111543758,0.141024423445241,0.072649065324406
SDN,Al leri,2020,12263,24525,6131,2044,0,44963,8175,0.18181615995374,0.0757585866897968,0.0353549955889657
SDN,Al leri,2021,21050,16840,6315,2105,0,46310,8420,0.181818181818182,0.0757575757575758,0.0353535353535354
SDN,Al leri,2022,26018,15177,6505,4336,0,52036,10841,0.208336536244139,0.0972211545852871,0.0509241465310341
SDN,Al mafaza,2019,80041,20582,11434,2287,0,114344,13721,0.119997551248863,0.0466662002378787,0.0200000777381313
SDN,Al mafaza,2020,40221,51712,22983,5746,0,120662,28729,0.238094843446984,0.0952384898863492,0.0423285246759083
SDN,Al mafaza,2021,42231,60331,24132,6033,0,132727,30165,0.227271014940442,0.0909084059761767,0.0404037359894119
SDN,Al mafaza,2022,50195,56470,25098,12549,0,144312,37647,0.260872276733744,0.115943234103886,0.057971617051943
SDN,Al malha,2019,7606,45634,17493,5324,0,76057,22817,0.299998685196629,0.123332938892322,0.0566665644041822
SDN,Al malha,2020,13755,55020,22925,4585,0,96285,27510,0.285714285714286,0.111111111111111,0.0476190476190476
SDN,Al malha,2021,18523,50939,27785,4630,0,101877,32415,0.318177802644365,0.121208254398278,0.0505020760328632
SDN,Al malha,2022,23316,37306,37306,18653,0,116581,55959,0.480001029327249,0.213333790812111,0.106666895406055
SDN,Al manaqil,2019,980620,295529,67166,0,0,1343315,67166,0.0500001861067583,0.0166667287022528,0.00555557623408425
SDN,Al manaqil,2020,366322,366322,122107,40702,0,895453,162809,0.181817471157057,0.0757571865860073,0.0353533041066614
SDN,Al manaqil,2021,719619,211652,84661,42330,0,1058262,126991,0.119999584223945,0.053333043550022,0.0266664692780343
SDN,Al manaqil,2022,394308,438121,131436,43812,0,1007677,175248,0.173912870890176,0.0724636962042401,0.0338163915619787
SDN,Al matama,2019,175172,31658,4221,0,0,211051,4221,0.0199999052361751,0.00666663507872505,0.00222221169290835
SDN,Al matama,2020,169684,63631,21211,0,0,254526,21211,0.0833352977691867,0.0277784325897289,0.00925947752990963
SDN,Al matama,2021,131080,87387,21846,10923,0,251236,32769,0.130431148402299,0.0579693992899107,0.0289846996449553
SDN,Al matama,2022,145554,67179,22393,11196,0,246322,33589,0.136362160099382,0.0606049534078699,0.0303022511635628
SDN,Al meiram,2019,28171,10955,8869,4173,0,52168,13042,0.25,0.10999718857026,0.0544416330147046
SDN,Al meiram,2020,26345,23711,10538,2635,0,63229,13173,0.208337946195575,0.0833372872152546,0.0370399658384602
SDN,Al meiram,2021,37620,13436,8061,2687,0,61804,10748,0.173904601643907,0.0724602506849611,0.0338147836529818
SDN,Al meiram,2022,30150,16445,10963,2740,0,60298,13703,0.227254635311287,0.0908985372649176,0.0403975071957426
SDN,Al quoz,2019,39239,47087,8829,2943,0,98098,11772,0.120002446533059,0.0500010193887745,0.0233338090480948
SDN,Al quoz,2020,36558,67024,36558,6093,0,146233,42651,0.291664672132829,0.111110351288697,0.0462959797036237
SDN,Al quoz,2021,62758,50206,18827,6275,0,138066,25102,0.181811597351991,0.0757536250778613,0.03535104788853
SDN,Al quoz,2022,58177,51713,25856,6464,0,142210,32320,0.227269530975318,0.0909078123901273,0.0404034721733899
SDN,Al qurashi,2020,222182,222182,74060,24687,0,543111,98747,0.181817344888982,0.0757573804740958,0.035353526054322
SDN,Al qurashi,2021,282417,179720,77022,25674,0,564833,102696,0.181816572331999,0.0757569051383329,0.0353532223978887
SDN,Al qurashi,2022,318874,186010,79718,26572,0,611174,106290,0.173911193866231,0.0724627247450535,0.0338157927747799
SDN,Al qureisha,2019,110381,20333,11619,2905,0,145238,14524,0.100001377050083,0.0400010098367278,0.0177784816033759
SDN,Al qureisha,2020,58386,72982,36491,7298,0,175157,43789,0.249998572709055,0.0972213499888671,0.0416661116090771
SDN,Al qureisha,2021,84294,76631,30652,7663,0,199240,38315,0.192305761895202,0.0769223047580807,0.0341876910035914
SDN,Al qureisha,2022,55787,71726,39848,15939,0,183300,55787,0.304348063284233,0.130434624477178,0.0628017215251258
SDN,Al radoum,2019,10797,112601,26222,4627,0,154247,30849,0.199997406756695,0.0766649162274361,0.0322210480592815
SDN,Al radoum,2020,62008,69759,38755,0,0,170522,38755,0.227272727272727,0.0757575757575758,0.0252525252525253
SDN,Al radoum,2021,111769,47901,23950,7983,0,191603,31933,0.166662317395865,0.0694421973211971,0.0324061267887826
SDN,Al radoum,2022,139247,40955,16382,8191,0,204775,24573,0.12,0.0533333333333333,0.0266666666666667
SDN,Al wihda,2019,4066,44729,9294,0,0,58089,9294,0.159995868408821,0.0533319561362737,0.0177773187120912
SDN,Al wihda,2020,17514,32110,11676,8757,0,70057,20433,0.291662503390097,0.138886906376236,0.0740730167339928
SDN,Al wihda,2021,39085,18039,12026,3006,0,72156,15032,0.208326403902655,0.0833287137128814,0.037033957290069
SDN,Al wihda,2022,27762,24678,12339,6169,0,70948,18508,0.260867113942606,0.115939373437823,0.0579689036727995
SDN,An nuhud,2019,157549,65645,26258,13129,0,262581,39387,0.149999428747701,0.0666664127767559,0.0333332063883779
SDN,An nuhud,2020,212166,106083,26521,13260,0,358030,39781,0.111110800770885,0.0493822677801674,0.0246909787199707
SDN,An nuhud,2021,202883,54102,40576,13525,0,311086,54101,0.173910108458754,0.0724622773123831,0.033815586543771
SDN,An nuhud,2022,151757,82776,41388,27592,0,303513,68980,0.227271978465502,0.106060256617234,0.0555553725137894
SDN,Ar rahad,2019,178539,28056,43360,5101,0,255056,48461,0.190001411454739,0.0700003136566088,0.0277777777777778
SDN,Ar rahad,2020,76899,115349,89716,12816,0,294780,102532,0.347825496980799,0.130433995974399,0.0531394410897769
SDN,Ar rahad,2021,121117,134574,40372,13457,0,309520,53829,0.173911217368829,0.0724627380029293,0.0338158008098561
SDN,Ar rahad,2022,111965,125961,55983,13996,0,307905,69979,0.227274646400676,0.0909100750772695,0.0404045980993416
SDN,Ar rahad (1),2019,118937,39103,4888,0,0,162928,4888,0.0300009820288717,0.0100003273429572,0.00333344244765241
SDN,Ar rahad (1),2020,98734,57595,24684,0,0,181013,24684,0.136365896372084,0.0454552987906946,0.0151517662635649
SDN,Ar rahad (1),2021,91412,58171,24930,8310,0,182823,33240,0.181815198306559,0.0757563326277328,0.0353529552262753
SDN,Ar rahad (1),2022,91960,75240,41800,0,0,209000,41800,0.2,0.0666666666666667,0.0222222222222222
SDN,Ar rashad,2019,133466,91758,25025,27805,0,278054,52830,0.189999064929834,0.0966658754534491,0.0544438610245971
SDN,Ar rashad,2020,26365,32957,9887,0,0,69209,9887,0.142857142857143,0.0476190476190476,0.0158730158730159
SDN,Ar rashad,2021,33945,27156,10183,3394,0,74678,13577,0.181807225688958,0.0757518948016819,0.0353502890930246
SDN,Ar rashad,2022,31467,27970,17481,6992,0,83910,24473,0.291657728518651,0.124995034362213,0.0601822058025133
SDN,Ar reif ash shargi,2020,22260,31801,15900,3180,0,73141,19080,0.260865998550744,0.10144788832529,0.0434776664251241
SDN,Ar reif ash shargi,2021,29479,26203,9826,3275,0,68783,13101,0.19046857508396,0.0793606947453101,0.0370343447266524
SDN,Ar reif ash shargi,2022,30363,30363,13494,6747,0,80967,20241,0.249990736966912,0.111106994207517,0.0555534971037583
SDN,Ar rusayris,2019,226917,73312,31419,17455,0,349103,48874,0.139998796916669,0.0633327890813504,0.0322219453220906
SDN,Ar rusayris,2020,112006,124451,49781,12445,0,298683,62226,0.20833458884503,0.0833336123359325,0.037037037037037
SDN,Ar rusayris,2021,153822,76911,38455,25637,0,294825,64092,0.217389977105062,0.101448882105204,0.0531399983040787
SDN,Ar rusayris,2022,118250,118250,52555,26277,0,315332,78832,0.249996828739234,0.111109349299574,0.0555544984686334
SDN,As salam - sd,2019,37421,53459,16038,0,0,106918,16038,0.150002805888625,0.0500009352962083,0.0166669784320694
SDN,As salam - sd,2020,37608,53726,21490,5373,0,118197,26863,0.22727311183871,0.0909103727956998,0.0404052368315421
SDN,As salam - sd,2021,71939,44270,16601,5534,0,138344,22135,0.159999710865668,0.0666671485572197,0.0311116572537379
SDN,As salam - sd,2022,79487,34066,22710,5677,0,141940,28387,0.199992954769621,0.0799962425437979,0.0355533637061043
SDN,As salam - wk,2019,72418,33424,4456,1114,0,111412,5570,0.0499946145837073,0.0199978458334829,0.00888793148154797
SDN,As salam - wk,2020,67516,39384,16879,0,0,123779,16879,0.136364003587038,0.0454546678623461,0.0151515559541154
SDN,As salam - wk,2021,80345,28695,17217,5739,0,131996,22956,0.173914361041244,0.0724643171005182,0.0338166813135752
SDN,As salam - wk,2022,70244,35122,17561,5853,0,128780,23414,0.181813946264948,0.0757545167469069,0.0353514175769184
SDN,As salam / ar rawat,2019,157982,69117,72409,29622,0,329130,102031,0.31000212681919,0.133334346104376,0.0644449845890006
SDN,As salam / ar rawat,2020,132968,149589,66484,16621,0,365662,83105,0.227272727272727,0.0909090909090909,0.0404040404040404
SDN,As salam / ar rawat,2021,138287,155573,69144,17286,0,380290,86430,0.227273922532804,0.0909095690131216,0.0404042528947207
SDN,As salam / ar rawat,2022,125236,161018,89454,35781,0,411489,125235,0.304345924192384,0.13043362033979,0.0628011927414828
SDN,As serief,2019,7821,32848,10428,1043,0,52140,11471,0.220003835826621,0.0800025572177471,0.0311128159229425
SDN,As serief,2020,15717,37720,12573,6287,0,72297,18860,0.260868362449341,0.115943031292216,0.0579722840812513
SDN,As serief,2021,25398,31748,6350,3175,0,66671,9525,0.142865713728608,0.0634958727682701,0.031747936384135
SDN,As serief,2022,22378,28772,19181,6393,0,76724,25574,0.333324644179136,0.138883096119424,0.0648109529685047
SDN,As suki,2019,270629,32606,22824,0,0,326059,22824,0.0699996012991514,0.0233332004330505,0.00777773347768349
SDN,As suki,2020,181125,164660,49398,0,0,395183,49398,0.125000316309153,0.041666772103051,0.0138889240343503
SDN,As suki,2021,239744,102748,34249,0,0,376741,34249,0.0909086083011937,0.0303028694337312,0.0101009564779104
SDN,As suki,2022,194963,159516,35448,17724,0,407651,53172,0.130435102575487,0.0579711567002166,0.0289855783501083
SDN,As sunta,2019,66520,22173,48781,10348,0,147822,59129,0.400001352978582,0.156668154943107,0.0677789653923112
SDN,As sunta,2020,59424,81709,22284,0,0,163417,22284,0.136362801911674,0.0454542673038913,0.0151514224346304
SDN,As sunta,2021,91811,61207,30604,15301,0,198923,45905,0.230767683978223,0.102562297974593,0.051280590423877
SDN,As sunta,2022,94197,62798,23549,7849,0,188393,31398,0.166662243289294,0.0694417166950648,0.0324056626307772
SDN,As sunut,2019,77843,38921,16681,5560,0,139005,22241,0.160001438797166,0.0666666666666667,0.0311107913784077
SDN,As sunut,2020,112316,28079,14039,0,0,154434,14039,0.0909061476099822,0.0303020492033274,0.0101006830677758
SDN,As sunut,2021,107402,21480,21480,7160,0,157522,28640,0.181815873338327,0.0757566138909697,0.0353530864824525
SDN,As sunut,2022,87640,36516,21910,14606,0,160672,36516,0.227270464050986,0.106058720042488,0.0555541724756025
SDN,Assalaya,2019,28279,73269,20567,6427,0,128542,26994,0.210001400320518,0.0866668741215582,0.0399998962725542
SDN,Assalaya,2020,64592,51674,25837,6459,0,148562,32296,0.2173907190264,0.0869558388641331,0.0386467901915998
SDN,Assalaya,2021,86489,53224,26612,13306,0,179631,39918,0.222222222222222,0.0987654320987654,0.0493827160493827
SDN,Assalaya,2022,54554,54554,27277,6819,0,143204,34096,0.238093907991397,0.0952370976602143,0.0423273403287928
SDN,At tadamon - bn,2019,75371,28892,13818,7537,0,125618,21355,0.169999522361445,0.0766662951700128,0.0388886235341361
SDN,At tadamon - bn,2020,50498,44186,31562,12625,0,138871,44187,0.318187382534871,0.136366363987682,0.0656580567577104
SDN,At tadamon - bn,2021,71518,65017,19505,6502,0,162542,26007,0.160001722631689,0.0666678971178731,0.0311119587552756
SDN,At tadamon - bn,2022,46649,66642,33321,13328,0,159940,46649,0.291665624609228,0.124998957942562,0.0601843746960666
SDN,At tadamon - sk,2020,28743,41062,20531,8212,0,98548,28743,0.291664975443439,0.124998308776772,0.0601838697893412
SDN,At tadamon - sk,2021,46523,29606,16918,4229,0,97276,21147,0.217391751305564,0.0869553298518305,0.0386460517839275
SDN,At tadamon - sk,2022,39207,34850,17425,8713,0,100195,26138,0.260871300963122,0.115943909376715,0.0579725091626883
SDN,At tawisha,2019,5213,58208,19113,4344,0,86878,23457,0.269999309376367,0.106666820138585,0.0466669736105036
SDN,At tawisha,2020,15712,62849,20950,5237,0,104748,26187,0.25,0.0999987271037792,0.0444431715482237
SDN,At tawisha,2021,26449,68767,15869,0,0,111085,15869,0.142854570824144,0.0476181902747146,0.0158727300915715
SDN,At tawisha,2022,37287,47941,26634,5326,0,117188,31960,0.272724169710209,0.106057503043543,0.0454521319968294
SDN,Atbara,2019,158957,18701,9350,0,0,187008,9350,0.0499978610540726,0.0166659536846909,0.00555531789489695
SDN,Atbara,2020,131560,75177,18794,0,0,225531,18794,0.0833322248382706,0.0277774082794235,0.00925913609314117
SDN,Atbara,2021,125827,67753,19358,0,0,212938,19358,0.0909090909090909,0.0303030303030303,0.0101010101010101
SDN,Atbara,2022,99210,89289,29763,9921,0,228183,39684,0.173913043478261,0.072463768115942,0.0338164251207729
SDN,Azum,2019,42005,20591,13178,6589,0,82363,19767,0.239998543035101,0.106666019126711,0.0533330095633557
SDN,Azum,2020,49665,24833,20694,4139,0,99331,24833,0.250002516837644,0.0972237602896712,0.0416676454368615
SDN,Azum,2021,29840,46891,12788,8525,0,98044,21313,0.217381991758802,0.101444249520623,0.0531371402408896
SDN,Azum,2022,26216,48063,17477,13108,0,104864,30585,0.291663487946292,0.138887829315431,0.0740737208829214
SDN,Babanusa,2019,30708,19541,5025,558,0,55832,5583,0.0999964178249033,0.0366635621149162,0.0144421359316043
SDN,Babanusa,2020,25376,25376,11278,2820,0,64850,14098,0.21739398612182,0.0869596504754562,0.0386498757817185
SDN,Babanusa,2021,37386,17255,5751,2875,0,63267,8626,0.136342801144356,0.060595044283223,0.0302966440289215
SDN,Babanusa,2022,29334,17600,11733,5866,0,64533,17599,0.272713185501991,0.121204138451128,0.0606012083395748
SDN,Bahr al arab,2019,14266,117696,33882,12483,0,178327,46365,0.259999887846484,0.110000168230274,0.0522224153754993
SDN,Bahr al arab,2020,80649,98571,26883,8961,0,215064,35844,0.166666666666667,0.0694444444444445,0.0324074074074074
SDN,Bahr al arab,2021,119988,73838,36919,9229,0,239974,46148,0.192304166284681,0.0769208330902514,0.0341865739158779
SDN,Bahr al arab,2022,75684,85145,47303,9460,0,217592,56763,0.2608689657708,0.101448276284667,0.0434773950022672
SDN,Bahri,2019,760566,109961,45817,0,0,916344,45817,0.0499997817413548,0.0166665939137849,0.00555553130459498
SDN,Bahri,2020,467336,373868,140201,46734,0,1028139,186935,0.181818800765266,0.0757579147047886,0.0353537367569517
SDN,Bahri,2021,680441,243014,97205,48602,0,1069262,145807,0.136362276037117,0.0606053521026652,0.0303026240944169
SDN,Bahri,2022,704256,251520,100608,0,0,1056384,100608,0.0952380952380952,0.0317460317460317,0.0105820105820106
SDN,Bara,2019,138092,45400,5675,0,0,189167,5675,0.029999947136657,0.00999998237888568,0.00333332745962856
SDN,Bara,2020,105082,57317,47765,0,0,210164,47765,0.227274890085838,0.0757582966952792,0.0252527655650931
SDN,Bara,2021,106132,48242,48242,9648,0,212264,57890,0.272726416161007,0.10605974949434,0.0454538792363388
SDN,Bara,2022,97063,77650,29119,9706,0,213538,38825,0.181817756090251,0.0757570081203346,0.035353062322501
SDN,Barbar,2019,173617,27525,10586,0,0,211728,10586,0.049998110783647,0.0166660369278823,0.00555534564262744
SDN,Barbar,2020,138312,95754,21279,0,0,255345,21279,0.0833343124008694,0.0277781041336231,0.00925936804454105
SDN,Barbar,2021,153419,76709,21917,0,0,252045,21917,0.0869566942411077,0.0289855647470359,0.00966185491567864
SDN,Barbar,2022,202185,33697,11232,0,0,247114,11232,0.0454527060385086,0.0151509020128362,0.00505030067094539
SDN,Basundah,2019,52953,16155,17950,2693,0,89751,20643,0.230003008323027,0.0866694150111605,0.0355576353838212
SDN,Basundah,2020,31570,40590,22550,4510,0,99220,27060,0.272727272727273,0.106060606060606,0.0454545454545455
SDN,Basundah,2021,47355,33148,18942,4735,0,104180,23677,0.227270109425993,0.0909067639342164,0.0404022951728845
SDN,Basundah,2022,34474,44324,24625,9850,0,113273,34475,0.304353199791654,0.130437085624994,0.0628030412268492
SDN,Baw,2020,52600,78900,43833,17533,0,192866,61366,0.318179461387699,0.136362379406773,0.0656558324317287
SDN,Baw,2021,72237,72237,54177,18059,0,216710,72236,0.333330257025518,0.138887607093966,0.0648142166438507
SDN,Baw,2022,55532,74043,64787,37021,0,231383,101808,0.439997752643885,0.199998847509685,0.102221569144377
SDN,Beida,2020,111290,66774,55645,22258,0,255967,77903,0.304347826086957,0.130434782608696,0.0628019323671498
SDN,Beida,2021,80239,126090,34388,22925,0,263642,57313,0.217389490293656,0.101448175935549,0.0531394003147366
SDN,Beida,2022,82245,82245,58746,46997,0,270233,105743,0.391303060692069,0.188405314426193,0.101449078716844
SDN,Beliel,2019,0,118315,101806,55030,0,275151,156836,0.569999745594237,0.256666339573543,0.129999729441491
SDN,Beliel,2020,110611,138264,41479,27653,0,318007,69132,0.217391441068907,0.101449548804481,0.0531403396780574
SDN,Beliel,2021,213618,99688,42723,28482,0,384511,71205,0.185183258736421,0.0864188540769965,0.0452670188022363
SDN,Beliel,2022,160725,131503,58445,29222,0,379895,87667,0.230766395977836,0.102562550178339,0.0512811288499308
SDN,Bendasi,2019,54472,22697,27236,9079,0,113484,36315,0.320001057417786,0.133334508241984,0.0622231621491429
SDN,Bendasi,2020,91241,22810,11405,0,0,125456,11405,0.0909083662798112,0.0303027887599371,0.0101009295866457
SDN,Bendasi,2021,52862,64610,17620,5873,0,140965,23493,0.166658390380591,0.0694404048286218,0.0324052069662682
SDN,Bendasi,2022,48164,48164,36123,24082,0,156533,60205,0.384615384615385,0.17948717948718,0.094017094017094
SDN,Buram,2019,116614,33318,14993,1666,0,166591,16659,0.0999993997274763,0.0366666466575825,0.0144445578292545
SDN,Buram,2020,75341,92083,25114,0,0,192538,25114,0.130436589140845,0.0434788630469483,0.0144929543489828
SDN,Buram,2021,120712,43111,17244,8622,0,189689,25866,0.136360041963424,0.0606044630948553,0.0303022315474276
SDN,Buram,2022,123851,70772,26539,17693,0,238855,44232,0.185183479516862,0.0864192362172308,0.0452673518801504
SDN,Damso,2019,133273,24989,8330,0,0,166592,8330,0.0500024010756819,0.0166674670252273,0.00555582234174243
SDN,Damso,2020,66970,66970,41856,16742,0,192538,58598,0.304345116288733,0.130433126620892,0.0628008785567294
SDN,Damso,2021,112090,68978,34489,17244,0,232801,51733,0.222219835825448,0.0987638941986217,0.0493817084596334
SDN,Damso,2022,150391,70772,17693,0,0,238856,17693,0.0740739190139666,0.0246913063379889,0.00823043544599629
SDN,Dar as salam,2019,30370,57702,10123,3037,0,101232,13160,0.129998419472104,0.0533329382013593,0.0244444005408918
SDN,Dar as salam,2020,48822,61027,12205,6103,0,128157,18308,0.142856028152969,0.0634924350601216,0.0317466510261285
SDN,Dar as salam,2021,43146,67801,12327,6163,0,129437,18490,0.14284941709094,0.0634877713997286,0.0317434564906308
SDN,Dar as salam,2022,55862,37241,55862,12413,0,161378,68275,0.423075016421073,0.16666460112283,0.0726479308070355
SDN,Delami,2020,18210,26015,18210,7804,0,70239,26014,0.370364042768263,0.160490136059264,0.0781870154440949
SDN,Delami,2021,26795,21436,10718,2679,0,61628,13397,0.217384954890634,0.0869518184375068,0.0386440506840325
SDN,Delami,2022,27599,22079,11040,2760,0,63478,13800,0.217398153691043,0.086959261476417,0.0386485606561853
SDN,Delgo,2019,48652,9965,0,0,0,58617,0,0,0,0
SDN,Delgo,2020,32401,20618,11782,0,0,64801,11782,0.181818181818182,0.0606060606060606,0.0202020202020202
SDN,Delgo,2021,33372,24271,6067,3033,0,66743,9100,0.136343886250243,0.0605956180173701,0.0302969766284271
SDN,Delgo,2022,40426,27987,6219,3109,0,77741,9328,0.119988165832701,0.0533266444561643,0.026662607604453
SDN,Dilling,2019,2766,132750,135515,5531,0,276562,141046,0.509997758188037,0.176665630129953,0.0633327949770556
SDN,Dilling,2020,76337,109053,65432,21811,0,272633,87243,0.320001613891202,0.133334311449213,0.0622228416956128
SDN,Dilling,2021,112324,89859,44929,11232,0,258344,56161,0.217388443315889,0.0869551192724946,0.0386465763134081
SDN,Dilling,2022,104124,92555,46277,23139,0,266095,69416,0.260869238429884,0.11594230130843,0.0579713594351224
SDN,Dongola,2019,181484,29544,0,0,0,211028,0,0,0,0
SDN,Dongola,2020,137854,84833,21208,0,0,243895,21208,0.0869554521412903,0.0289851507137634,0.00966171690458781
SDN,Dongola,2021,109222,98300,32766,0,0,240288,32766,0.136361366360368,0.0454537887867892,0.0151512629289297
SDN,Dongola,2022,134343,100757,22390,11195,0,268685,33585,0.124997673856002,0.0555545217137788,0.0277772608568894
SDN,Dordieb,2019,18087,27777,14857,3876,0,64597,18733,0.28999798752264,0.116666924676585,0.0522229274493312
SDN,Dordieb,2020,32460,25968,12984,6492,0,77904,19476,0.25,0.111111111111111,0.0555555555555556
SDN,Dordieb,2021,26227,29506,9835,6556,0,72124,16391,0.227261383173424,0.106053463479563,0.0555509338854689
SDN,Dordieb,2022,16654,33309,13323,9992,0,73278,23315,0.3181718933377,0.151509775557921,0.0808049103717654
SDN,Ed al fursan,2019,73480,146959,24493,0,0,244932,24493,0.0999991834468342,0.0333330611489447,0.0111110203829816
SDN,Ed al fursan,2020,98463,123079,61539,12308,0,295389,73847,0.249999153658396,0.0972220811652883,0.0416667136856447
SDN,Ed al fursan,2021,190156,76062,50708,12677,0,329603,63385,0.192307108855199,0.0769228435420794,0.0341879304631464
SDN,Ed al fursan,2022,182093,78040,39020,13006,0,312159,52026,0.166665064918839,0.069443243133574,0.0324065620404986
SDN,Ed damazine,2019,268346,48165,17202,10321,0,344034,27523,0.0800008138730474,0.0366669185797528,0.0188889599412978
SDN,Ed damazine,2020,89513,164107,104432,14919,0,372971,119351,0.320000750728609,0.120000393238795,0.0488891152991043
SDN,Ed damazine,2021,215129,107564,30732,15366,0,368791,46098,0.124997627382447,0.0555545010588653,0.0277772505294327
SDN,Ed damazine,2022,126004,141754,63002,31501,0,362261,94503,0.260869925274871,0.115942189011054,0.0579710945055269
SDN,El daein,2022,67030,67030,29791,7448,0,171299,37239,0.217391811977887,0.0869571139742011,0.0386478224235596
SDN,Foro baranga,2020,41688,33350,16675,0,0,91713,16675,0.181817190583669,0.0606057301945562,0.0202019100648521
SDN,Foro baranga,2021,30056,47231,12881,8587,0,98755,21468,0.21738646144499,0.101446340269691,0.0531382377263599
SDN,Foro baranga,2022,39610,39610,17604,8802,0,105626,26406,0.249995266317005,0.111109007252002,0.0555545036260012
SDN,Gala'a al nahal,2019,74539,33543,9939,6212,0,124233,16151,0.130005715067655,0.0600028441181758,0.0311126852142524
SDN,Gala'a al nahal,2020,43699,68669,31213,6242,0,149823,37455,0.24999499409303,0.0972191630568515,0.0416647199250671
SDN,Gala'a al nahal,2021,45883,65548,26219,13109,0,150759,39328,0.260866681259494,0.115940010214979,0.0579696366017581
SDN,Gala'a al nahal,2022,47719,61353,34085,13634,0,156791,47719,0.304347826086957,0.130434782608696,0.0628019323671498
SDN,Galabat ash-shargiah,2019,162049,25587,21322,4264,0,213222,25586,0.119996998433558,0.0466649782855428,0.0199989786336411
SDN,Galabat ash-shargiah,2020,85715,107144,64286,10714,0,267859,75000,0.279998058680127,0.106665571563148,0.0444437807453424
SDN,Galabat ash-shargiah,2021,101250,112501,45000,11250,0,270001,56250,0.208332561731253,0.0833330246925011,0.0370368998633338
SDN,Galabat ash-shargiah,2022,93601,105301,58501,23400,0,280803,81901,0.291667111818606,0.12499985161602,0.0601849378785523
SDN,Gebrat al sheikh,2019,169451,59666,9547,0,0,238664,9547,0.0400018435960178,0.0133339478653393,0.00444464928844643
SDN,Gebrat al sheikh,2020,120526,96420,48210,12052,0,277208,60262,0.217389108539436,0.0869551624291747,0.0386464716426334
SDN,Gebrat al sheikh,2021,158250,73038,36519,0,0,267807,36519,0.136363127177408,0.0454543757258025,0.0151514585752675
SDN,Gebrat al sheikh,2022,122461,97969,48984,12246,0,281660,61230,0.217389760704395,0.0869559042817581,0.0386470685696703
SDN,Geisan,2019,74041,35597,21358,11391,0,142387,32749,0.229999929768869,0.103333403564464,0.0522223080602708
SDN,Geisan,2020,57240,50085,50085,14309,0,171719,64394,0.374996360332869,0.152774785162582,0.0694422606441661
SDN,Geisan,2021,73696,66326,22108,14739,0,176869,36847,0.208329328486055,0.0972207302202949,0.0509253238900605
SDN,Geisan,2022,45322,67984,37769,22661,0,173736,60430,0.34782658746604,0.159420039600313,0.0821252423856375
SDN,Gereida,2019,10122,57360,86040,15183,0,168705,101223,0.6,0.229999110874011,0.0966657775406775
SDN,Gereida,2020,67819,84774,59342,16955,0,228890,76297,0.333334789636944,0.135803224256193,0.0617288265590944
SDN,Gereida,2021,104780,69853,34926,17463,0,227022,52389,0.230766181251156,0.102562747222736,0.0512813736113681
SDN,Gereida,2022,107504,53752,35834,17917,0,215007,53751,0.249996511741478,0.11110956077399,0.0555547803869952
SDN,Ghadeer,2020,18969,27099,13550,2710,0,62328,16260,0.260877936080092,0.101452530697814,0.0434796560133487
SDN,Ghadeer,2021,27912,19538,8373,2791,0,58614,11164,0.190466441464497,0.0793610172768736,0.0370351413958743
SDN,Ghadeer,2022,34499,23000,11500,5750,0,74749,17250,0.230772318024321,0.102565474677476,0.0512827373387381
SDN,Gharb bara,2019,132261,45924,5511,0,0,183696,5511,0.0300006532532009,0.010000217751067,0.00333340591702233
SDN,Gharb bara,2020,92767,64937,47764,0,0,205468,47764,0.232464422683824,0.0774881408946081,0.0258293802982027
SDN,Gharb bara,2021,103063,46847,37477,18738,0,206125,56215,0.272722862340813,0.121209621993127,0.0606045414729466
SDN,Gharb bara,2022,84830,84830,47128,18851,0,235639,65979,0.280000339502374,0.119999943416271,0.0577776457490766
SDN,Gharb jabal marrah,2019,146670,44001,41557,12223,0,244451,53780,0.220003190823519,0.0900016772277471,0.0411120792669651
SDN,Gharb jabal marrah,2020,147403,49134,61418,12284,0,270239,73702,0.272728954740063,0.106061671335374,0.0454552369486927
SDN,Gharb jabal marrah,2021,88564,139173,37956,25304,0,290997,63260,0.217390557290969,0.101448926735785,0.053139914004459
SDN,Gharb jabal marrah,2022,116715,116715,51873,12968,0,298271,64841,0.217389555136101,0.0869555985440533,0.0386468085138087
SDN,Ghubaish,2019,82638,43573,19533,4508,0,150252,24041,0.160004525730107,0.0633358180479018,0.0277792567745447
SDN,Ghubaish,2020,83465,60701,30351,7588,0,182105,37939,0.208335850196315,0.0833347061676871,0.037037850568506
SDN,Ghubaish,2021,92873,54176,23218,7739,0,178006,30957,0.17390986820669,0.072461976937107,0.0338153395578426
SDN,Ghubaish,2022,86836,47365,31577,7894,0,173672,39471,0.227273250725506,0.0909089164248315,0.0404037495969414
SDN,Guli,2020,153623,172826,38405,19202,0,384056,57607,0.149996354698273,0.066664757222905,0.0333322339566221
SDN,Guli,2021,239652,159768,59913,19971,0,479304,79884,0.166666666666667,0.0694444444444445,0.0324074074074074
SDN,Guli,2022,186030,206700,41340,20670,0,454740,62010,0.136363636363636,0.0606060606060606,0.0303030303030303
SDN,Habila - sk,2020,25010,35728,21437,7146,0,89321,28583,0.320003134761142,0.133335572448435,0.0622237647237367
SDN,Habila - sk,2021,36800,25760,14720,3680,0,80960,18400,0.227272727272727,0.0909090909090909,0.0404040404040404
SDN,Habila - sk,2022,34114,30323,15162,7581,0,87180,22743,0.260874053682037,0.115944023858683,0.0579720119293416
SDN,Habila - wd,2020,76868,38434,25623,12811,0,153736,38434,0.25,0.111110388371407,0.0555548328158517
SDN,Habila - wd,2021,46184,72576,19793,13195,0,151748,32988,0.217386720088568,0.101446696716486,0.0531385366968044
SDN,Habila - wd,2022,67628,54102,27051,13525,0,162306,40576,0.24999691939916,0.111109057377218,0.0555541863996265
SDN,Hala'ib,2019,12949,3378,5630,6193,0,28150,11823,0.42,0.213333333333333,0.12
SDN,Hala'ib,2020,7073,11316,8487,7073,0,33949,15560,0.458334560664526,0.222225495105403,0.120373370513286
SDN,Hala'ib,2021,8571,12857,7143,5714,0,34285,12857,0.37500364590929,0.180555150454523,0.0972210069191256
SDN,Hala'ib,2022,7257,13063,7257,5806,0,33383,13063,0.391306952640566,0.188409270187421,0.101452169600628
SDN,Halfa,2019,36590,8032,0,0,0,44622,0,0,0,0
SDN,Halfa,2020,31392,17938,2242,0,0,51572,2242,0.0434732025129915,0.0144910675043305,0.00483035583477684
SDN,Halfa,2021,25404,18476,4619,2309,0,50808,6928,0.136356479294599,0.0606006928042828,0.0302992529610385
SDN,Halfa,2022,23672,26039,4734,2367,0,56812,7101,0.124991199042456,0.0555516440188693,0.0277758220094346
SDN,Halfa aj jadeedah,2019,253488,34005,21639,0,0,309132,21639,0.069999223632623,0.0233330745442077,0.00777769151473589
SDN,Halfa aj jadeedah,2020,248542,62136,31068,15534,0,357280,46602,0.130435512763099,0.0579713390058218,0.0289856695029109
SDN,Halfa aj jadeedah,2021,193863,113086,32310,16155,0,355414,48465,0.136362101661724,0.0606053785163218,0.0303026892581609
SDN,Halfa aj jadeedah,2022,149759,166399,49919,16639,0,382716,66558,0.173909635343179,0.0724619125757307,0.0338153269439132
SDN,Haya,2019,123245,126405,50562,15801,0,316013,66363,0.210000854395231,0.0866673206482012,0.0400004641159277
SDN,Haya,2020,158797,127037,47639,31759,0,365232,79398,0.217390590090682,0.101448759509937,0.0531397394897855
SDN,Haya,2021,128307,160384,64153,16038,0,368882,80191,0.217389300643566,0.0869555395311599,0.0386468060548119
SDN,Haya,2022,97770,162950,81475,32590,0,374785,114065,0.304347826086957,0.130434782608696,0.0628019323671498
SDN,Heiban,2020,81748,70070,70070,35035,0,256923,105105,0.409091439847736,0.181818417710105,0.0909092088550526
SDN,Heiban,2021,96228,84200,48114,48114,0,276656,96228,0.347825458330924,0.173912729165462,0.096618182869701
SDN,Heiban,2022,123895,111505,49558,24779,0,309737,74337,0.240000387425461,0.10666683885576,0.0533334194278802
SDN,Janub aj jazirah,2019,664684,139502,16412,0,0,820598,16412,0.0200000487449397,0.00666668291497989,0.00222222763832663
SDN,Janub aj jazirah,2020,414402,372962,82880,41440,0,911684,124320,0.136363038070209,0.0606057946978705,0.0303028973489352
SDN,Janub aj jazirah,2021,603369,301684,86195,43097,0,1034345,129292,0.124998912355162,0.0555549647361374,0.0277774286572125
SDN,Janub aj jazirah,2022,446062,446062,89212,44606,0,1025942,133818,0.130434274062276,0.0579707884721229,0.0289853942360614
SDN,Jebel awlia,2019,599790,719748,179937,0,0,1499475,179937,0.12,0.04,0.0133333333333333
SDN,Jebel awlia,2020,764732,611785,229419,76473,0,1682409,305892,0.181817857607752,0.0757574406698966,0.0353534723126184
SDN,Jebel awlia,2021,874853,477192,238596,79532,0,1670173,318128,0.190476076430406,0.0793650318460024,0.0370370148614678
SDN,Jebel awlia,2022,823157,493894,329262,82315,0,1728628,411577,0.238094604507158,0.0952377646704014,0.0423278525576996
SDN,Jebel moon,2020,33259,19955,13303,6652,0,73169,19955,0.272724787819978,0.121212535363337,0.0606070269588973
SDN,Jebel moon,2021,23979,37682,10276,6851,0,78788,17127,0.217380819414124,0.101445228545802,0.053138379787108
SDN,Jebel moon,2022,17557,24579,21068,14045,0,77249,35113,0.454543100881565,0.212119250734637,0.111109672760956
SDN,Jubayt elma'aadin,2019,0,88331,20720,0,0,109051,20720,0.190002842706624,0.0633342809022078,0.0211114269674026
SDN,Jubayt elma'aadin,2020,27399,54798,38359,16439,0,136995,54798,0.4,0.173332360061803,0.0844434711729139
SDN,Jubayt elma'aadin,2021,38742,44276,27673,22138,0,132829,49811,0.375000941059558,0.180555450993382,0.097221908535703
SDN,Jubayt elma'aadin,2022,28115,56231,22492,22492,0,129330,44984,0.347823397510245,0.173911698755123,0.0966176104195125
SDN,Kadugli,2019,5846,233844,286459,58461,0,584610,344920,0.590000171054207,0.230000057018069,0.0988889078949119
SDN,Kadugli,2020,52206,67122,37290,7458,0,164076,44748,0.272727272727273,0.106060606060606,0.0454545454545455
SDN,Kadugli,2021,69136,61454,30727,7681,0,168998,38408,0.227268961762861,0.0909064012591865,0.0404021875341063
SDN,Kadugli,2022,71210,63298,31649,15824,0,181981,47473,0.260867892801996,0.115940675125425,0.0579700322805372
SDN,Karrari,2019,967994,116626,81638,0,0,1166258,81638,0.0699999485534076,0.0233333161844692,0.00777777206148973
SDN,Karrari,2020,654271,416354,118958,59479,0,1249062,178437,0.142856799742527,0.0634919109966786,0.0317459554983393
SDN,Karrari,2021,742299,371149,185574,61858,0,1360880,247432,0.181817647404621,0.0757573530852586,0.0353534314397873
SDN,Karrari,2022,704256,384140,256093,64023,0,1408512,320116,0.227272469102145,0.0909089403095844,0.0404039471757745
SDN,Kas,2019,0,152055,68084,6808,0,226947,74892,0.329997752779283,0.119998648730027,0.0466658147790747
SDN,Kas,2020,182466,125445,22808,0,0,330719,22808,0.0689648916451731,0.0229882972150577,0.00766276573835257
SDN,Kas,2021,164446,70477,35238,23492,0,293653,58730,0.199997956772109,0.093332379826984,0.0488883894331821
SDN,Kas,2022,108464,96412,60258,12051,0,277185,72309,0.260869094647979,0.101448491079965,0.0434775811581916
SDN,Kateila,2019,106911,11879,13199,0,0,131989,13199,0.100000757638894,0.0333335858796314,0.0111111952932105
SDN,Kateila,2020,53060,66325,19897,13265,0,152547,33162,0.217388739208244,0.101448515320961,0.0531399066080181
SDN,Kateila,2021,88808,54651,13662,6831,0,163952,20493,0.12499390065385,0.0555528447350444,0.0277764223675222
SDN,Kateila,2022,91117,42054,21027,7009,0,161207,28036,0.173913043478261,0.072463768115942,0.0338164251207729
SDN,Kebkabiya,2019,50513,75769,40410,1684,0,168376,42094,0.25,0.0866671417937632,0.0311115862382076
SDN,Kebkabiya,2020,71054,101505,40602,20301,0,233462,60903,0.260869006519262,0.115941780675228,0.0579708903376138
SDN,Kebkabiya,2021,51260,112772,41008,10252,0,215292,51260,0.238095238095238,0.0952380952380952,0.0423280423280423
SDN,Kebkabiya,2022,82590,92913,51618,10323,0,237444,61941,0.260865719917117,0.101447078047877,0.0434769180662949
SDN,Keilak,2019,45737,16967,7377,3689,0,73770,11066,0.150006777822963,0.0666711852153088,0.0333363456990948
SDN,Keilak,2020,55881,18627,3725,0,0,78233,3725,0.0476141781601115,0.0158713927200372,0.00529046424001239
SDN,Keilak,2021,56998,18999,15199,3799,0,94995,18998,0.199989473130165,0.0799936838780989,0.0355515787380622
SDN,Keilak,2022,42634,23255,15503,3875,0,85267,19378,0.227262598660678,0.0909026938909543,0.0403998941885815
SDN,Kelemando,2019,14841,30276,11873,2375,0,59365,14248,0.240006737976922,0.0933378253179483,0.04000299465641
SDN,Kelemando,2020,14315,42946,10736,10736,0,78733,21472,0.272719190174387,0.136359595087193,0.0757553306039964
SDN,Kelemando,2021,18073,43375,14458,3614,0,79520,18072,0.227263581488934,0.0909037558685446,0.0404007377598927
SDN,Kelemando,2022,29119,32759,25479,7279,0,94636,32758,0.346147343505643,0.141021034983164,0.0640994030930207
SDN,Kereneik,2020,378210,94552,141829,0,0,614591,141829,0.230769731414876,0.0769232438049586,0.0256410812683195
SDN,Kereneik,2021,146083,267819,97389,48694,0,559985,146083,0.26086948757556,0.115941796060014,0.0579707988210002
SDN,Kereneik,2022,124780,174692,149736,99824,0,549032,249560,0.454545454545455,0.212121212121212,0.111111111111111
SDN,Kernoi,2020,40928,40928,10232,10232,0,102320,20464,0.2,0.1,0.0555555555555556
SDN,Kernoi,2021,15501,62006,31003,5167,0,113677,36170,0.318182218038829,0.12121185464078,0.0505046950765962
SDN,Kernoi,2022,36423,46830,26016,5203,0,114472,31219,0.272721713606821,0.106057958860391,0.0454531336144307
SDN,Khartoum,2019,809717,109962,79972,0,0,999651,79972,0.0799999199720703,0.0266666399906901,0.00888887999689669
SDN,Khartoum,2020,611785,356874,152946,50982,0,1172587,203928,0.173912895162576,0.0724637063177402,0.0338163962816121
SDN,Khartoum,2021,636256,318128,159064,53021,0,1166469,212085,0.181817948012335,0.0757574068977973,0.0353534184506118
SDN,Khartoum,2022,658525,329262,164631,0,0,1152418,164631,0.142857018894186,0.047619006298062,0.015873002099354
SDN,Kosti,2019,239561,87459,34223,19013,0,380256,53236,0.140000420769166,0.0633336489102079,0.0322224442948376
SDN,Kosti,2020,172826,153623,38406,19203,0,384058,57609,0.150000781132017,0.0666670138364518,0.0333335069182259
SDN,Kosti,2021,0,0,0,0,0,0,0,,,
SDN,Kosti,2022,0,0,0,0,0,0,0,,,
SDN,Kubum,2019,74323,116793,14865,6371,0,212352,21236,0.100003767329717,0.0433352797870203,0.0211122203804166
SDN,Kubum,2020,85365,128048,32012,0,0,245425,32012,0.130434959763675,0.0434783199212251,0.014492773307075
SDN,Kubum,2021,153870,65944,32972,10990,0,263776,43962,0.166664139269683,0.0694427595131223,0.0324062841198593
SDN,Kubum,2022,124041,101488,45106,11276,0,281911,56382,0.199999290556239,0.0799992432599887,0.0355549564697133
SDN,Kulbus,2020,28834,14417,9611,4806,0,57668,14417,0.25,0.111113037848836,0.0555574822932803
SDN,Kulbus,2021,19799,27223,4949,4949,0,56920,9898,0.17389318341532,0.0869465917076599,0.048303662059811
SDN,Kulbus,2022,25367,17757,10147,2536,0,55807,12683,0.22726539681402,0.0909025749457953,0.0403991534315687
SDN,Kutum,2019,46857,97619,42952,7809,0,195237,50761,0.259996824372429,0.0999981219406841,0.042221049857922
SDN,Kutum,2020,70619,94159,70619,35310,0,270707,105929,0.391304990266229,0.173913739455081,0.0869570749514748
SDN,Kutum,2021,71325,106987,59437,11887,0,249636,71324,0.285711996667147,0.111109775833614,0.0476182210186921
SDN,Kutum,2022,59853,119707,71824,11970,0,263354,83794,0.318180092195296,0.121210740422904,0.0505040532683933
SDN,Madeinat al gedaref,2019,405249,91181,5066,5066,0,506562,10132,0.0200015003099324,0.0100007501549662,0.00555597230831457
SDN,Madeinat al gedaref,2020,229092,280002,76364,0,0,585458,76364,0.130434634081352,0.0434782113604506,0.0144927371201502
SDN,Madeinat al gedaref,2021,267274,240547,80182,26727,0,614730,106909,0.173912124021928,0.0724632494482673,0.0338161107767276
SDN,Madeinat al gedaref,2022,222372,250169,138983,27797,0,639321,166780,0.260870517314463,0.101449819417789,0.0434785933479078
SDN,Madeinat kassala,2019,352825,47914,34847,0,0,435586,34847,0.0800002754909478,0.0266667584969826,0.0088889194989942
SDN,Madeinat kassala,2020,372099,109441,43776,0,0,525316,43776,0.0833326987946303,0.0277775662648768,0.00925918875495892
SDN,Madeinat kassala,2021,295928,159346,45527,22763,0,523564,68290,0.130432955665401,0.0579699902972703,0.0289848890382923
SDN,Madeinat kassala,2022,211019,234466,46893,23446,0,515824,70339,0.136362402679984,0.0606052968971329,0.0303025407460253
SDN,Medani al kubra,2019,542015,80991,0,0,0,623006,0,0,0,0
SDN,Medani al kubra,2020,283156,283156,94385,0,0,660697,94385,0.142856710413397,0.0476189034711323,0.0158729678237108
SDN,Medani al kubra,2021,556244,261762,65440,32720,0,916166,98160,0.10714215546091,0.0476187357604044,0.0238093678802022
SDN,Medani al kubra,2022,304789,372519,101596,0,0,778904,101596,0.130434559329519,0.0434781864431731,0.0144927288143911
SDN,Melit,2019,16410,88886,27349,4102,0,136747,31451,0.229994076652504,0.086663692804961,0.0355538979932934
SDN,Melit,2020,49463,82438,32975,24731,0,189607,57706,0.304345303707142,0.144926083952597,0.0772937942398986
SDN,Melit,2021,41631,83262,41631,8326,0,174850,49957,0.285713468687446,0.111110475645792,0.047618593715248
SDN,Melit,2022,58691,83845,41922,8384,0,192842,50306,0.260866408769874,0.101447471678023,0.0434771586180512
SDN,Mershing,2019,53111,34071,13027,0,0,100209,13027,0.12999830354559,0.0433327678485299,0.01444425594951
SDN,Mershing,2020,80569,60427,20142,5036,0,166174,25178,0.151515880944071,0.0606071547494394,0.0269369589840903
SDN,Mershing,2021,51866,36306,20746,5186,0,114104,25932,0.227266353502068,0.0909053728762065,0.0404017387646358
SDN,Mershing,2022,53214,37250,31928,10642,0,133034,42570,0.319993385149661,0.133329324333128,0.0622196831887588
SDN,Merwoe,2019,183631,29893,0,0,0,213524,0,0,0,0
SDN,Merwoe,2020,139484,85836,10730,0,0,236050,10730,0.0454564710866342,0.0151521570288781,0.00505071900962602
SDN,Merwoe,2021,121565,88411,22102,11051,0,243129,33153,0.13635971027726,0.0606043156787823,0.0303021578393912
SDN,Merwoe,2022,147260,90622,11327,22655,0,271864,33982,0.124996321690257,0.0694428096401142,0.0416658492645015
SDN,Mukjar,2019,82549,36852,14741,13267,0,147409,28008,0.190001967315429,0.0933344187487422,0.0511117593453136
SDN,Mukjar,2020,118517,14815,22222,7407,0,162961,29629,0.181816508244304,0.0757563670653306,0.0353526985665964
SDN,Mukjar,2021,61036,76295,22888,15259,0,175478,38147,0.217389074413887,0.101448614641152,0.0531399314380657
SDN,Mukjar,2022,70382,54741,31281,15640,0,172044,46921,0.27272674432122,0.121211240535367,0.0606052973528736
SDN,Nitega,2019,5770,80774,28848,0,0,115392,28848,0.25,0.0833333333333333,0.0277777777777778
SDN,Nitega,2020,34790,63782,23194,5798,0,127564,28992,0.227274152582233,0.0909086158059223,0.040403248565426
SDN,Nitega,2021,77640,47778,23889,5972,0,155279,29861,0.1923054630697,0.0769217558931558,0.0341872085443335
SDN,Nitega,2022,85787,30638,18382,6127,0,140934,24509,0.173904096953184,0.0724594491038358,0.0338140942253506
SDN,Nyala janoub,2019,290380,43557,21779,7260,0,362976,29039,0.0800025346028388,0.0333346190014399,0.0155562779785869
SDN,Nyala janoub,2020,310072,200635,54719,0,0,565426,54719,0.0967748211083325,0.0322582737027775,0.0107527579009258
SDN,Nyala janoub,2021,281800,131506,37573,18786,0,469665,56359,0.119998296658256,0.0533323397173162,0.026666051571037
SDN,Nyala janoub,2022,269852,77100,57825,19275,0,424052,77100,0.181817324290417,0.0757572184543405,0.0353533686120256
SDN,Nyala shimal,2019,300708,30071,26312,18794,0,375885,45106,0.11999946792237,0.0566662676084441,0.0299997191812508
SDN,Nyala shimal,2020,321100,207771,56665,0,0,585536,56665,0.0967745791889824,0.0322581930629941,0.010752731020998
SDN,Nyala shimal,2021,272368,136184,77819,19454,0,505825,97273,0.19230563930213,0.0769218603271883,0.0341872738156038
SDN,Nyala shimal,2022,279450,79843,79843,19960,0,459096,99803,0.217390262603029,0.0869556694024779,0.0386467221573605
SDN,Port sudan,2019,136689,124262,31066,18639,0,310656,49705,0.160000128759786,0.0733329899739047,0.0377774058050634
SDN,Port sudan,2020,218546,109273,46831,0,0,374650,46831,0.12499933271053,0.0416664442368433,0.0138888147456144
SDN,Port sudan,2021,204965,126132,31533,0,0,362630,31533,0.086956401842098,0.0289854672806993,0.00966182242689978
SDN,Port sudan,2022,160188,176206,48056,0,0,384450,48056,0.12499934972038,0.0416664499067933,0.0138888166355978
SDN,Rabak,2019,213826,81967,35638,24946,0,356377,60584,0.16999974745845,0.0799995510372443,0.042221829379811
SDN,Rabak,2020,143976,161973,35994,17997,0,359940,53991,0.15,0.0666666666666667,0.0333333333333333
SDN,Rabak,2021,187169,168452,37433,18716,0,411770,56149,0.136360103941521,0.0606042208028754,0.0303019754825375
SDN,Rabak,2022,174348,193720,38744,19372,0,426184,58116,0.136363636363636,0.0606060606060606,0.0303030303030303
SDN,Rehaid albirdi,2019,0,174196,38459,13574,0,226229,52033,0.230001458698929,0.096667535992291,0.0455561007258623
SDN,Rehaid albirdi,2020,113680,125048,34104,11368,0,284200,45472,0.16,0.0666666666666667,0.0311111111111111
SDN,Rehaid albirdi,2021,163926,70254,46836,11709,0,292725,58545,0.2,0.08,0.0355555555555556
SDN,Rehaid albirdi,2022,156175,72081,36040,12013,0,276309,48053,0.173910368464292,0.0724623519320761,0.0338156033844557
SDN,Reifi aroma,2019,19492,92961,37484,0,0,149937,37484,0.249998332633039,0.0833327775443464,0.0277775925147821
SDN,Reifi aroma,2020,52740,82877,22603,7534,0,165754,30137,0.181817633360281,0.0757568444803745,0.0353529259558677
SDN,Reifi aroma,2021,62685,70520,23506,15671,0,172382,39177,0.227268508312933,0.106059023950683,0.0555549109922536
SDN,Reifi aroma,2022,56494,72636,32282,24212,0,185624,56494,0.304346420721458,0.144927380080162,0.0772948421420602
SDN,Reifi gharb kassala,2019,35904,66016,13898,0,0,115818,13898,0.119998618522164,0.039999539507388,0.013333179835796
SDN,Reifi gharb kassala,2020,40739,64018,17460,5820,0,128037,23280,0.181822441950374,0.0757593508126557,0.0353543637125727
SDN,Reifi gharb kassala,2021,72631,42368,12105,6052,0,133156,18157,0.136358857280183,0.0606031021258274,0.0303011338413423
SDN,Reifi gharb kassala,2022,56108,49874,24937,6234,0,137153,31171,0.227271733028078,0.0909082071360694,0.0404033775742743
SDN,Reifi hamashkureib,2019,18625,242120,111748,0,0,372493,111748,0.300000268461421,0.10000008948714,0.0333333631623801
SDN,Reifi hamashkureib,2020,56153,168460,131024,37436,0,393073,168460,0.4285717920081,0.174603699567256,0.0793655235654559
SDN,Reifi hamashkureib,2021,136265,175198,77865,38932,0,428260,116797,0.27272451314622,0.121210635283862,0.0606051879180353
SDN,Reifi hamashkureib,2022,120302,200504,80201,80201,0,481208,160402,0.33333194793104,0.16666597396552,0.0925922077586223
SDN,Reifi kassla,2019,38356,155679,31587,0,0,225622,31587,0.139999645424648,0.0466665484748828,0.0155555161582943
SDN,Reifi kassla,2020,79363,113375,56688,11338,0,260764,68026,0.260871899495329,0.101450609235426,0.0434790760142419
SDN,Reifi kassla,2021,106119,94328,35373,23582,0,259402,58955,0.227272727272727,0.106060606060606,0.0555555555555556
SDN,Reifi kassla,2022,85013,121447,48579,24289,0,279328,72868,0.260868942605109,0.115941354488869,0.0579704783543998
SDN,Reifi khashm elgirba,2019,21654,108272,14436,0,0,144362,14436,0.0999986145938682,0.0333328715312894,0.0111109571770965
SDN,Reifi khashm elgirba,2020,58034,65288,29017,7254,0,159593,36271,0.227271872826502,0.0909083314013355,0.0404034707732238
SDN,Reifi khashm elgirba,2021,67899,67899,22633,7544,0,165975,30177,0.181816538635337,0.0757563890144098,0.0353527137621128
SDN,Reifi khashm elgirba,2022,62165,69936,31082,7770,0,170953,38852,0.227267143600873,0.0909060774988837,0.0404022678098009
SDN,Reifi nahr atbara,2019,29965,139838,29965,0,0,199768,29965,0.149998998838653,0.049999666279551,0.016666555426517
SDN,Reifi nahr atbara,2020,90345,100383,30115,0,0,220843,30115,0.136363842186531,0.0454546140621769,0.0151515380207256
SDN,Reifi nahr atbara,2021,93959,93959,20880,20880,0,229678,41760,0.181819765062392,0.0909098825311959,0.0505054902951088
SDN,Reifi nahr atbara,2022,86024,96777,43012,10753,0,236566,53765,0.227272727272727,0.0909090909090909,0.0404040404040404
SDN,Reifi shamal ad delta,2019,14742,96494,22783,0,0,134019,22783,0.169998283825428,0.0566660946084759,0.0188886982028253
SDN,Reifi shamal ad delta,2020,40407,67345,33673,13469,0,154894,47142,0.304350071661911,0.130435437568057,0.0628020883098549
SDN,Reifi shamal ad delta,2021,49027,63035,21012,14008,0,147082,35020,0.238098475680233,0.111112621984109,0.0582018496107236
SDN,Reifi shamal ad delta,2022,50498,64926,21642,28856,0,165922,50498,0.304347826086957,0.159420289855072,0.0917874396135266
SDN,Reifi telkok,2019,32098,268819,100306,0,0,401223,100306,0.250000623094887,0.0833335410316291,0.027777847010543
SDN,Reifi telkok,2020,100807,221775,120968,20161,0,463711,141129,0.304346888471483,0.115941466416223,0.0483088245336715
SDN,Reifi telkok,2021,167743,188711,62904,41936,0,461294,104840,0.22727371264313,0.106061065900127,0.0555557964238762
SDN,Reifi telkok,2022,129581,194372,64790,86387,0,475130,151177,0.318180287500263,0.166665965104287,0.0959592345486732
SDN,Reifi wad elhilaiw,2019,30890,80313,12356,0,0,123559,12356,0.100000809329956,0.0333336031099852,0.0111112010366617
SDN,Reifi wad elhilaiw,2020,49671,62089,18627,6209,0,136596,24836,0.181820843948578,0.0757586849785743,0.0353540529900013
SDN,Reifi wad elhilaiw,2021,64572,58114,12914,6457,0,142057,19371,0.136360756597704,0.0606047807100906,0.0303023903550453
SDN,Reifi wad elhilaiw,2022,59858,59858,26603,6650,0,152969,33253,0.217383914387883,0.0869522583007015,0.0386447217700609
SDN,Saraf omra,2019,21144,80610,27751,2643,0,132148,30394,0.229999697309078,0.0833333333333333,0.0322222894868716
SDN,Saraf omra,2020,71699,71699,23900,7967,0,175265,31867,0.18182181268365,0.0757595640886657,0.0353547168256323
SDN,Saraf omra,2021,56323,88507,24138,8046,0,177014,32184,0.181816127537935,0.0757567198074729,0.035353135910154
SDN,Saraf omra,2022,64819,72922,48614,16204,0,202559,64818,0.319995655586767,0.133330700355617,0.0622205546696683
SDN,Sawakin,2019,31715,25372,24466,9062,0,90615,33528,0.370004966065221,0.156670161305156,0.0744468355128842
SDN,Sawakin,2020,50087,31873,18214,4553,0,104727,22767,0.217393795296342,0.0869562449670731,0.0386465126789971
SDN,Sawakin,2021,41390,45989,13796,4598,0,105773,18394,0.173900711901903,0.0724570542577028,0.0338124516128355
SDN,Sawakin,2022,42052,42052,14017,9345,0,107466,23362,0.217389686040236,0.101449140503353,0.0531403213833006
SDN,Sennar,2019,381536,37223,46529,0,0,465288,46529,0.100000429841303,0.0333334766137675,0.0111111588712558
SDN,Sennar,2020,352456,140982,70491,0,0,563929,70491,0.12499977834089,0.0416665927802968,0.0138888642600989
SDN,Sennar,2021,244369,219932,73310,0,0,537611,73310,0.136362537224871,0.0454541790749569,0.0151513930249856
SDN,Sennar,2022,227630,202338,151753,25292,0,607013,177045,0.291665911603211,0.111110745019739,0.0462960979968029
SDN,Shamal jabal marrah,2019,108131,32439,30637,9011,0,180218,39648,0.220000221953412,0.0900002589456473,0.041111320733778
SDN,Shamal jabal marrah,2020,54336,54336,45280,45280,0,199232,90560,0.454545454545455,0.227272727272727,0.126262626262626
SDN,Shamal jabal marrah,2021,55966,102604,27983,18655,0,205208,46638,0.227271841253752,0.10605986771146,0.0555550140995153
SDN,Shamal jabal marrah,2022,57365,86048,47804,19121,0,210338,66925,0.318178360543506,0.136361475339691,0.06565517299669
SDN,Sharg aj jabal,2019,3384,4466,2571,3113,0,13534,5684,0.419979311363972,0.216664203733806,0.123335467875146
SDN,Sharg aj jabal,2020,7481,6801,2720,0,0,17002,2720,0.159981178684861,0.0533270595616202,0.0177756865205401
SDN,Sharg aj jabal,2021,7005,4903,3502,1401,0,16811,4903,0.29165427398727,0.124997521464121,0.0601854605780607
SDN,Sharg aj jabal,2022,5749,6468,4312,718,0,17247,5030,0.291644923754856,0.11109178407839,0.0462818010217558
SDN,Sharg aj jazirah,2019,542150,61764,82352,0,0,686266,82352,0.120000116572874,0.0400000388576247,0.0133333462858749
SDN,Sharg aj jazirah,2020,381221,242595,138626,34656,0,797098,173282,0.217391086165064,0.0869562671925744,0.0386471369336713
SDN,Sharg aj jazirah,2021,396469,252298,108128,36042,0,792937,144170,0.181817723223913,0.0757571744875907,0.0353532359933877
SDN,Sharg aj jazirah,2022,298433,335737,149216,37304,0,820690,186520,0.227272173415053,0.0909088693660213,0.0404039419404539
SDN,Sharg an neel,2019,733076,466503,106629,26657,0,1332865,133286,0.099999624868235,0.0399997999297253,0.0177776610701175
SDN,Sharg an neel,2020,747738,475833,203928,67976,0,1495475,271904,0.181817817081529,0.0757574237839705,0.0353534644325196
SDN,Sharg an neel,2021,989732,282780,212085,70695,0,1555292,282780,0.181817948012335,0.0757574783384728,0.0353534898912873
SDN,Sharg an neel,2022,951204,439017,146339,0,0,1536560,146339,0.0952380642474098,0.0317460214158033,0.0105820071386011
SDN,Sharg sennar,2019,292739,24990,39270,0,0,356999,39270,0.110000308124112,0.0366667693747041,0.0122222564582347
SDN,Sharg sennar,2020,216341,162256,72114,18028,0,468739,90142,0.19230744614807,0.0769226940081083,0.0341877059752039
SDN,Sharg sennar,2021,318743,93748,37499,0,0,449990,37499,0.0833329629547323,0.0277776543182441,0.00925921810608137
SDN,Sharg sennar,2022,155246,174652,58217,19405,0,407520,77622,0.190474087161366,0.0793637940060202,0.0370362190812721
SDN,Shattaya,2019,18627,25014,9580,0,0,53221,9580,0.18000413370662,0.0600013779022065,0.0200004593007355
SDN,Shattaya,2020,21395,32092,10697,0,0,64184,10697,0.166661473264365,0.055553824421455,0.0185179414738183
SDN,Shattaya,2021,41319,19282,11018,5509,0,77128,16527,0.214280157659994,0.0952356256266639,0.047617812813332
SDN,Shattaya,2022,25435,22609,16957,5652,0,70653,22609,0.320000566147227,0.133332389754622,0.0622211528330165
SDN,Sheikan,2019,362922,156335,39084,0,0,558341,39084,0.0700002328326238,0.0233334109442079,0.00777780364806931
SDN,Sheikan,2020,310159,197373,140981,28196,0,676709,169177,0.249999630564984,0.0972219964563793,0.0416665229974939
SDN,Sheikan,2021,341738,170869,113912,28478,0,654997,142390,0.217390308657902,0.0869561234631609,0.0386471659836271
SDN,Sheikan,2022,229192,257841,114596,57298,0,658927,171894,0.260869565217391,0.115942028985507,0.0579710144927536
SDN,Shendi,2019,318237,37440,18720,0,0,374397,18720,0.0500004006442359,0.0166668002147453,0.00555560007158177
SDN,Shendi,2020,319828,94067,18813,0,0,432708,18813,0.0434773565545356,0.0144924521848452,0.0048308173949484
SDN,Shendi,2021,251911,135644,38755,0,0,426310,38755,0.0909080246768783,0.0303026748922928,0.0101008916307643
SDN,Shendi,2022,258209,119173,39724,19862,0,436968,59586,0.136362388092492,0.0606055058188853,0.0303027529094426
SDN,Shia'ria,2019,26136,44804,2240,1493,0,74673,3733,0.0499912953811954,0.0233283783964753,0.0122192016450986
SDN,Shia'ria,2020,33771,37524,18762,3752,0,93809,22514,0.23999829440672,0.0933314856072801,0.0399985312946756
SDN,Shia'ria,2021,50243,34784,19324,11594,0,115945,30918,0.266660916814007,0.122218868141504,0.0629608866272802
SDN,Shia'ria,2022,31692,35653,15846,3961,0,87152,19807,0.227269597943822,0.0909063092833976,0.0404019541847704
SDN,Sinja,2019,198527,19135,21527,0,0,239189,21527,0.0899999581920573,0.0299999860640191,0.00999999535467303
SDN,Sinja,2020,120791,108711,36237,12079,0,277818,48316,0.173912417481949,0.0724635072841453,0.0338163033992678
SDN,Sinja,2021,213557,62811,25124,0,0,301492,25124,0.0833322277208019,0.0277774092402673,0.00925913641342243
SDN,Sinja,2022,104015,130019,39005,13001,0,286040,52006,0.181813732345127,0.0757551391413788,0.0353520875091285
SDN,Sinkat,2019,91599,20992,51525,26716,0,190832,78241,0.409999371174646,0.183332285291076,0.0922213139189328
SDN,Sinkat,2020,76715,86304,47947,19179,0,230145,67126,0.291668296074214,0.125000905226415,0.0601857283210343
SDN,Sinkat,2021,67796,96852,38741,9685,0,213074,48426,0.227273153927743,0.0909089486907522,0.0404038033734759
SDN,Sinkat,2022,59041,88561,49201,29520,0,226323,78721,0.347825894849397,0.159419649497989,0.0821250061981229
SDN,Sirba,2020,133169,38048,38048,9512,0,218777,47560,0.217390310681653,0.0869561242726612,0.038647166343405
SDN,Sirba,2021,68582,117569,29392,19594,0,235137,48986,0.208329612098479,0.0972199186006456,0.0509244492454281
SDN,Sirba,2022,70296,100424,40169,20084,0,230973,60253,0.260865988665342,0.11593995835011,0.0579697386467009
SDN,Soudari,2019,193352,72857,14011,0,0,280220,14011,0.05,0.0166666666666667,0.00555555555555556
SDN,Soudari,2020,127360,141511,56604,14151,0,339626,70755,0.208332106493614,0.0833328425974454,0.037036818932198
SDN,Soudari,2021,142926,71463,71463,28585,0,314437,100048,0.318181384506276,0.136363299060437,0.0656563247257091
SDN,Soudari,2022,71891,115026,86270,43135,0,316322,129405,0.409092633455782,0.18181894820257,0.090909474101285
SDN,Talawdi,2019,60038,43432,14051,10219,0,127740,24270,0.189995302959136,0.0899979124262826,0.0477767339909191
SDN,Talawdi,2020,14829,19066,8474,2118,0,44487,10592,0.238092026884258,0.0952338136234555,0.0423244743158426
SDN,Talawdi,2021,21820,15273,8728,4364,0,50185,13092,0.260874763375511,0.115944339278005,0.0579721696390024
SDN,Talawdi,2022,26969,20227,6742,2247,0,56185,8989,0.159989320993148,0.066660733885082,0.0311075514421603
SDN,Tawila,2019,5832,82813,23328,4666,0,116639,27994,0.240005487015492,0.0933364197795477,0.0400018671094383
SDN,Tawila,2020,21095,84378,35158,7032,0,147663,42190,0.285718155529821,0.111113368503507,0.0476204450524355
SDN,Tawila,2021,35509,71018,49712,7101,0,163340,56813,0.347820497122566,0.130431410962818,0.0531379671578031
SDN,Tawila,2022,42909,57212,57212,14303,0,171636,71515,0.416666666666667,0.166666666666667,0.0740740740740741
SDN,Tawkar,2019,65015,48761,48761,18060,0,180597,66821,0.370000609090959,0.156667423416041,0.0744450658402717
SDN,Tawkar,2020,90751,99825,45375,18150,0,254101,63525,0.249999016139252,0.107142435488251,0.051587098568417
SDN,Tawkar,2021,73326,91658,36663,18331,0,219978,54994,0.249997727045432,0.111109595808066,0.0555545453535253
SDN,Tawkar,2022,65187,93124,37249,9312,0,204872,46561,0.227268733648327,0.0909071680528981,0.0404030050199366
SDN,Tendalti,2019,108557,60541,20876,18789,0,208763,39665,0.190000143703626,0.0933339081478359,0.0511116539914747
SDN,Tendalti,2020,84340,84340,31628,21085,0,221393,52713,0.238096958801769,0.111111612983849,0.0582011776945673
SDN,Tendalti,2021,109642,76749,32892,10964,0,230247,43856,0.190473708669386,0.0793640452789106,0.0370365544634916
SDN,Tendalti,2022,102131,102131,45391,22695,0,272348,68086,0.249996328227121,0.11110907123729,0.0555543316312626
SDN,Tulus,2019,182029,75845,45507,0,0,303381,45507,0.149999505572201,0.0499998351907338,0.0166666117302446
SDN,Tulus,2020,259163,137204,30490,15245,0,442102,45735,0.103448977837694,0.0459773234834194,0.0229886617417097
SDN,Tulus,2021,219831,109915,47106,15702,0,392554,62808,0.159998369651054,0.066665987354606,0.0311107940988161
SDN,Tulus,2022,273878,96663,32221,0,0,402762,32221,0.0800000993142352,0.0266666997714117,0.00888889992380391
SDN,Um algura,2019,208634,52158,65198,0,0,325990,65198,0.2,0.0666666666666667,0.0222222222222222
SDN,Um algura,2020,148163,148162,49388,16463,0,362176,65851,0.181820440890617,0.0757587471284679,0.0353542047083309
SDN,Um algura,2021,188331,136968,51363,17121,0,393783,68484,0.173913043478261,0.072463768115942,0.033816425120773
SDN,Um algura,2022,194922,141762,53160,17720,0,407564,70880,0.173911336624432,0.0724630569268467,0.0338160932325284
SDN,Um bada,2019,712250,664767,158278,47483,0,1582778,205761,0.129999911547924,0.0533332322452464,0.0244443630123744
SDN,Um bada,2020,807217,645773,242165,80722,0,1775877,322887,0.181818335391471,0.0757576866716182,0.0353536121401801
SDN,Um bada,2021,1091357,503703,251851,83950,0,1930861,335801,0.173912570609692,0.0724635279287323,0.0338162900154675
SDN,Um bada,2022,955776,434444,347555,86888,0,1824663,434443,0.238094924925863,0.0952378603610639,0.0423278770442055
SDN,Um baru,2020,23272,63999,23272,17454,0,127997,40726,0.318179332328101,0.151513967775286,0.0808074494801528
SDN,Um baru,2021,29381,58763,35257,5876,0,129277,41133,0.318177247306172,0.121210011577208,0.0505039566202805
SDN,Um baru,2022,35504,65091,29587,5917,0,136099,35504,0.260868926296299,0.101448210493832,0.043477337983543
SDN,Um dafoug,2019,58066,12339,2177,0,0,72582,2177,0.0299936623405252,0.00999788744684173,0.00333262914894724
SDN,Um dafoug,2020,36473,32825,10942,3647,0,83887,14589,0.173912525182686,0.0724625587596012,0.0338153309412265
SDN,Um dafoug,2021,48837,30053,11270,3756,0,93916,15026,0.159994037224754,0.066662407541491,0.0311081770471012
SDN,Um dafoug,2022,50106,23126,11563,3854,0,88649,15417,0.173910591208023,0.0724618062997515,0.0338150082535242
SDN,Um dam haj ahmed,2019,98717,32455,4057,0,0,135229,4057,0.0300009613322586,0.0100003204440862,0.00333344014802873
SDN,Um dam haj ahmed,2020,61461,54632,34145,6829,0,157067,40974,0.260869565217391,0.101449275362319,0.0434782608695652
SDN,Um dam haj ahmed,2021,75870,27589,34486,6897,0,144842,41383,0.285711326825092,0.11110957687227,0.0476181709111384
SDN,Um dam haj ahmed,2022,41632,62448,34693,13877,0,152650,48570,0.318178840484769,0.136362048258544,0.0656556392619282
SDN,Um dukhun,2019,71390,32053,29139,13112,0,145694,42251,0.289998215437835,0.126665019378515,0.0622209715034402
SDN,Um dukhun,2020,102496,29285,36606,7321,0,175708,43927,0.25,0.0972219060410833,0.0416663504855278
SDN,Um dukhun,2021,75408,75408,22622,15081,0,188519,37703,0.199995756395907,0.0933309993510822,0.0488874979297695
SDN,Um dukhun,2022,69563,54105,30917,15458,0,170043,46375,0.272725134230753,0.121210517339732,0.0606049319551199
SDN,Um durein,2020,30319,42446,48510,18191,0,139466,66701,0.47825993432091,0.202897719396364,0.0966177339917176
SDN,Um durein,2021,56210,49965,24982,6245,0,137402,31227,0.227267434244043,0.0909060033090251,0.0404021290325711
SDN,Um durein,2022,64330,45031,32165,12866,0,154392,45031,0.291666666666667,0.125,0.0601851851851852
SDN,Um durman,2019,649772,116626,66643,0,0,833041,66643,0.0799996638820898,0.0266665546273633,0.00888885154245443
SDN,Um durman,2020,467336,382365,127455,42485,0,1019641,169940,0.166666503210444,0.0694443763376849,0.0324073756242529
SDN,Um durman,2021,486029,220922,132553,44184,0,883688,176737,0.199999321027331,0.083332956126295,0.0388886625646659
SDN,Um durman,2022,548771,274385,137192,0,0,960348,137192,0.142856547834743,0.0476188492782478,0.0158729497594159
SDN,Um kadadah,2019,7750,77504,22144,3322,0,110720,25466,0.230003612716763,0.0866690751445087,0.0355571612074502
SDN,Um kadadah,2020,33374,66748,26699,20024,0,146845,46723,0.318179032312983,0.151513500629916,0.0808070490048086
SDN,Um kadadah,2021,33707,74156,33707,6741,0,148311,40448,0.27272420791445,0.106058665012485,0.0454532854759406
SDN,Um kadadah,2022,33943,61098,47520,6788,0,149349,54308,0.363631494017369,0.13636069430216,0.0555536956316339
SDN,Um rawaba,2019,239210,96398,21422,0,0,357030,21422,0.0600005601770159,0.020000186725672,0.00666672890855733
SDN,Um rawaba,2020,216360,126209,54090,0,0,396659,54090,0.136363980144154,0.0454546600480514,0.0151515533493504
SDN,Um rawaba,2021,218523,109261,54630,18210,0,400624,72840,0.181816366468309,0.0757568193617956,0.035353182368838
SDN,Um rawaba,2022,146556,164875,73278,36639,0,421348,109917,0.26086987478284,0.115942166570151,0.0579710832850755
SDN,Um rimta,2019,104507,41803,17418,10451,0,174179,27869,0.160002066839286,0.0733345198521827,0.037778504999008
SDN,Um rimta,2020,79164,70368,26388,17592,0,193512,43980,0.227272727272727,0.106060606060606,0.0555555555555556
SDN,Um rimta,2021,91479,91479,27443,18295,0,228696,45738,0.199994752859691,0.0933305931600611,0.0488873147467963
SDN,Um rimta,2022,75744,85212,37872,9468,0,208296,47340,0.227272727272727,0.0909090909090909,0.0404040404040404
SDN,Wad al mahi,2020,35420,55660,20240,5060,0,116380,25300,0.217391304347826,0.0869565217391304,0.0386473429951691
SDN,Wad al mahi,2021,52118,46906,15635,10423,0,125082,26058,0.208327337266753,0.097218891074122,0.0509239272370658
SDN,Wad al mahi,2022,37394,58763,21368,10684,0,128209,32052,0.249998050058888,0.111110244470617,0.0555551222353085
SDN,Wad bandah,2019,78443,46764,16594,9051,0,150852,25645,0.170001060642219,0.0766667550535183,0.0388887415774696
SDN,Wad bandah,2020,91416,60944,22854,15236,0,190450,38090,0.2,0.0933333333333333,0.0488888888888889
SDN,Wad bandah,2021,108784,31081,15540,15540,0,170945,31080,0.181812863786598,0.090906431893299,0.050503573274055
SDN,Wad bandah,2022,63406,55480,31703,15851,0,166440,47554,0.285712569093968,0.126982696467195,0.0634910144463137
SDN,Wadi salih,2019,191804,79918,31967,15984,0,319673,47951,0.150000156409831,0.0666670837595501,0.0333337156684765
SDN,Wadi salih,2020,257018,64254,64254,32127,0,417653,96381,0.23076812569286,0.102563611419049,0.0512818057095244
SDN,Wadi salih,2021,148909,165455,49636,33091,0,397091,82727,0.208332598824954,0.0972220473392749,0.0509259142670628
SDN,Wadi salih,2022,169591,118714,84795,50877,0,423977,135672,0.319998490484154,0.146665974805237,0.0755551991420918
SDN,Wasat al gedaref,2019,153246,25191,27290,4199,0,209926,31489,0.150000476358336,0.0566675876261159,0.0233341484353746
SDN,Wasat al gedaref,2020,126586,84390,31646,0,0,242622,31646,0.130433348995557,0.043477782998519,0.0144925943328397
SDN,Wasat al gedaref,2021,110762,88610,44305,22152,0,265829,66457,0.249999059545798,0.111110275151821,0.0555549285860877
SDN,Wasat al gedaref,2022,92154,103674,57597,11519,0,264944,69116,0.260870221631741,0.101449111258731,0.0434779508961223
SDN,Wasat jabal marrah,2019,90410,27123,25616,7534,0,150683,33150,0.219998274523337,0.0899990930186772,0.0411105875690467
SDN,Wasat jabal marrah,2020,75719,30288,53003,22716,0,181726,75719,0.416665749535014,0.180555708410831,0.0879633196252722
SDN,Wasat jabal marrah,2021,62392,85789,23397,15598,0,187176,38995,0.208333333333333,0.0972222222222222,0.0509259259259259
SDN,Wasat jabal marrah,2022,79940,55958,39970,15988,0,191856,55958,0.291666666666667,0.125,0.0601851851851852
SDN,Yassin,2019,20319,43347,4064,0,0,67730,4064,0.0600029529012255,0.0200009843004085,0.00666699476680283
SDN,Yassin,2020,30630,30630,17017,0,0,78277,17017,0.217394636994264,0.072464878998088,0.0241549596660293
SDN,Yassin,2021,38559,31549,17527,7010,0,94645,24537,0.259252998045327,0.111106415200662,0.0534946378572561
SDN,Yassin,2022,28744,28744,17965,7186,0,82639,25151,0.304347826086957,0.130434782608696,0.0628019323671498
SDN,Zalingi,2019,173866,62951,35972,26979,0,299768,62951,0.20999906594433,0.0999995552115858,0.0533330961128458
SDN,Zalingi,2020,210888,60254,45190,15063,0,331395,60253,0.181816261560977,0.0757565241881541,0.035352910507937
SDN,Zalingi,2021,155153,170668,46545,31030,0,403396,77575,0.192304831976519,0.0897422549223757,0.0470078478164825
SDN,Zalingi,2022,95419,143128,79516,31806,0,349869,111322,0.318181948100575,0.136363419832375,0.0656563202544698
SEN,Bakel,2020,143990,28443,5333,0,0,177766,5333,0.0300001125074536,0.0100000375024845,0.00333334583416151
SEN,Bakel,2021,164277,39109,12444,0,0,215830,12444,0.0576564889033035,0.0192188296344345,0.0064062765448115
SEN,Bakel,2022,164277,36294,9551,0,0,210122,9551,0.0454545454545455,0.0151515151515152,0.00505050505050505
SEN,Bambey,2020,314715,57570,11514,0,0,383799,11514,0.030000078165915,0.010000026055305,0.003333342018435
SEN,Bambey,2021,303200,76760,19190,0,0,399150,19190,0.0480771639734436,0.0160257213244812,0.0053419071081604
SEN,Bambey,2022,301069,107463,80598,0,0,489130,80598,0.164778279802915,0.0549260932676385,0.0183086977558795
SEN,Bignona,2020,214462,90984,19497,0,0,324943,19497,0.060001292534383,0.0200004308447943,0.00666681028159811
SEN,Bignona,2021,234993,113730,29245,0,0,377968,29245,0.0773742750709055,0.0257914250236352,0.00859714167454505
SEN,Bignona,2022,298777,93997,20142,3357,0,416273,23499,0.0564509348432399,0.02150511803552,0.00896046584813332
SEN,Birkelane,2020,89789,32532,7808,0,0,130129,7808,0.060001998017352,0.020000666005784,0.00666688866859467
SEN,Birkelane,2021,114589,58558,11712,0,0,184859,11712,0.0633563959558366,0.0211187986519455,0.00703959955064851
SEN,Birkelane,2022,117304,33703,11172,0,0,162179,11172,0.0688868472490273,0.0229622824163424,0.00765409413878081
SEN,Bounkiling,2020,161693,28534,0,0,0,190227,0,0,0,0
SEN,Bounkiling,2021,171280,30436,1969,0,0,203685,1969,0.00966688759604291,0.00322229586534764,0.00107409862178255
SEN,Bounkiling,2022,171280,39375,5906,0,0,216561,5906,0.0272717617668925,0.00909058725563082,0.00303019575187694
SEN,Dagana,2020,265196,29797,2980,0,0,297973,2980,0.0100009061223668,0.00333363537412226,0.00111121179137409
SEN,Dagana,2021,253823,45872,6116,0,0,305811,6116,0.0199992806014172,0.00666642686713907,0.00222214228904636
SEN,Dagana,2022,269114,48930,6116,0,0,324160,6116,0.0188672260612043,0.00628907535373478,0.00209635845124493
SEN,Dakar,2020,1008701,322224,70049,0,0,1400974,70049,0.0500002141367363,0.0166667380455788,0.00555557934852626
SEN,Dakar,2021,1299469,364253,70049,0,0,1733771,70049,0.0404026829379428,0.0134675609793143,0.00448918699310475
SEN,Dakar,2022,1122268,383934,73833,0,0,1580035,73833,0.0467287117057534,0.0155762372352511,0.00519207907841704
SEN,Diourbel,2020,250927,75622,17187,0,0,343736,17187,0.0500005818418787,0.0166668606139596,0.00555562020465318
SEN,Diourbel,2021,244807,85934,24836,0,0,355577,24836,0.0698470373505598,0.0232823457835199,0.00776078192783998
SEN,Diourbel,2022,241259,113534,74507,7096,0,436396,81603,0.186993006352029,0.0677511556781761,0.0261971542666141
SEN,Fatick,2020,318867,97432,26572,0,0,442871,26572,0.0599994129215957,0.0199998043071986,0.00666660143573285
SEN,Fatick,2021,380700,124004,31001,0,0,535705,31001,0.0578695364052977,0.0192898454684326,0.00642994848947752
SEN,Fatick,2022,380700,114669,36694,0,0,532063,36694,0.0689655172413793,0.0229885057471264,0.00766283524904215
SEN,Foundiougne,2020,317376,47424,0,0,0,364800,0,0,0,0
SEN,Foundiougne,2021,336259,54720,3778,0,0,394757,3778,0.00957044460262896,0.00319014820087632,0.00106338273362544
SEN,Foundiougne,2022,324924,109568,15113,0,0,449605,15113,0.0336139500227978,0.0112046500075993,0.00373488333586642
SEN,Gossas,2020,101214,21242,2499,0,0,124955,2499,0.0199991997118963,0.00666639990396543,0.00222213330132181
SEN,Gossas,2021,106119,26241,3749,0,0,136109,3749,0.0275441006840106,0.0091813668946702,0.00306045563155673
SEN,Gossas,2022,107414,36236,4400,0,0,148050,4400,0.0297196892941574,0.00990656309805246,0.00330218769935082
SEN,Goudiry,2020,136727,10291,0,0,0,147018,0,0,0,0
SEN,Goudiry,2021,113204,39495,7899,0,0,160598,7899,0.0491849213564303,0.0163949737854768,0.00546499126182559
SEN,Goudiry,2022,99527,56872,34755,0,0,191154,34755,0.181816755077058,0.0606055850256861,0.0202018616752287
SEN,Goudomp,2020,144829,46916,12239,0,0,203984,12239,0.0599998039061887,0.0199999346353962,0.00666664487846541
SEN,Goudomp,2021,187888,59155,18359,0,0,265402,18359,0.069174309161197,0.0230581030537323,0.00768603435124411
SEN,Goudomp,2022,179444,33778,6333,0,0,219555,6333,0.0288447086151534,0.00961490287171779,0.00320496762390593
SEN,Guediawaye,2020,351767,49661,12415,0,0,413843,12415,0.0299992992511653,0.0099997664170551,0.0033332554723517
SEN,Guediawaye,2021,382283,57938,16554,0,0,456775,16554,0.0362410377100323,0.0120803459033441,0.00402678196778137
SEN,Guediawaye,2022,365293,118933,25486,0,0,509712,25486,0.0500007847568823,0.0166669282522941,0.0055556427507647
SEN,Guinguineo,2020,123728,22094,1473,0,0,147295,1473,0.0100003394548355,0.00333344648494518,0.00111114882831506
SEN,Guinguineo,2021,127581,27986,4419,0,0,159986,4419,0.0276211668520996,0.00920705561736652,0.00306901853912217
SEN,Guinguineo,2022,127581,51640,7594,0,0,186815,7594,0.0406498407515456,0.0135499469171819,0.00451664897239396
SEN,Kaffrine,2020,218938,42720,5340,0,0,266998,5340,0.0200001498138563,0.00666671660461876,0.00222223886820625
SEN,Kaffrine,2021,232088,53399,10680,0,0,296167,10680,0.0360607360036736,0.0120202453345579,0.00400674844485262
SEN,Kaffrine,2022,243549,85958,14326,0,0,343833,14326,0.0416655760209171,0.0138885253403057,0.00462950844676857
SEN,Kanel,2020,200018,90331,32261,0,0,322610,32261,0.1,0.0333333333333333,0.0111111111111111
SEN,Kanel,2021,204199,119365,38713,0,0,362277,38713,0.106860220218231,0.0356200734060769,0.0118733578020256
SEN,Kanel,2022,184114,150639,73646,6695,0,415094,80341,0.193548931085489,0.0698926026394022,0.026881729064849
SEN,Kaolack,2020,575020,50002,0,0,0,625022,0,0,0,0
SEN,Kaolack,2021,562520,77339,19335,0,0,659194,19335,0.029331274253103,0.00977709141770101,0.003259030472567
SEN,Kaolack,2022,509146,109563,25780,0,0,644489,25780,0.0400006827114194,0.0133335609038065,0.00444452030126883
SEN,Kebemer,2020,239117,53487,22024,0,0,314628,22024,0.0700001271342665,0.0233333757114222,0.00777779190380739
SEN,Kebemer,2021,229364,79779,28316,0,0,337459,28316,0.083909452703884,0.0279698175679613,0.00932327252265378
SEN,Kebemer,2022,242661,93075,29917,0,0,365653,29917,0.0818180077833356,0.0272726692611119,0.00909088975370395
SEN,Kedougou,2020,82034,14825,1977,0,0,98836,1977,0.0200028329758388,0.00666761099194626,0.00222253699731542
SEN,Kedougou,2021,88779,22732,6919,0,0,118430,6919,0.0584226969517859,0.019474232317262,0.00649141077242065
SEN,Kedougou,2022,85608,33820,7398,0,0,126826,7398,0.0583318877832621,0.0194439625944207,0.0064813208648069
SEN,Kolda,2020,255165,50403,9451,0,0,315019,9451,0.0300013649970319,0.0100004549990106,0.00333348499967021
SEN,Kolda,2021,217362,81905,15751,0,0,315018,15751,0.0500003174421779,0.016666772480726,0.00555559082690866
SEN,Kolda,2022,263380,97548,13006,0,0,373934,13006,0.0347815389881637,0.0115938463293879,0.0038646154431293
SEN,Koumpentoum,2020,102251,47717,20450,0,0,170418,20450,0.11999906113204,0.0399996870440133,0.0133332290146711
SEN,Koumpentoum,2021,143100,56238,28971,0,0,228309,28971,0.126893814961302,0.0422979383204342,0.0140993127734781
SEN,Koumpentoum,2022,148400,44167,5300,0,0,197867,5300,0.0267856691616086,0.00892855638720285,0.00297618546240095
SEN,Koungheul,2020,180706,23114,6304,0,0,210124,6304,0.0300013325464964,0.0100004441821655,0.00333348139405515
SEN,Koungheul,2021,187207,27316,8405,0,0,222928,8405,0.0377027560467954,0.0125675853489318,0.0041891951163106
SEN,Koungheul,2022,184905,54119,9020,0,0,248044,9020,0.0363645159729725,0.0121215053243242,0.00404050177477473
SEN,Linguere,2020,246756,44064,2938,0,0,293758,2938,0.0100014297482962,0.00333380991609874,0.00111126997203291
SEN,Linguere,2021,257601,55814,8813,0,0,322228,8813,0.0273501992378068,0.00911673307926892,0.00303891102642297
SEN,Linguere,2022,235876,83798,21725,0,0,341399,21725,0.0636352186151688,0.0212117395383896,0.00707057984612986
SEN,Louga,2020,371643,72516,9064,0,0,453223,9064,0.019998985047096,0.00666632834903201,0.00222210944967734
SEN,Louga,2021,416594,90645,18129,0,0,525368,18129,0.0345072406389426,0.0115024135463142,0.0038341378487714
SEN,Louga,2022,407017,110134,14365,0,0,531516,14365,0.0270264676886491,0.00900882256288302,0.00300294085429434
SEN,Malem hodar,2020,102229,19472,0,0,0,121701,0,0,0,0
SEN,Malem hodar,2021,105789,24340,3918,0,0,134047,3918,0.0292285541638381,0.00974285138794602,0.00324761712931534
SEN,Malem hodar,2022,108401,44405,13060,0,0,165866,13060,0.078738258594287,0.0262460861980957,0.00874869539936522
SEN,Matam,2020,147440,129010,81092,11058,0,368600,92150,0.25,0.0933333333333333,0.0377777777777778
SEN,Matam,2021,114266,129010,106894,18430,0,368600,125324,0.34,0.13,0.0544444444444445
SEN,Matam,2022,141516,164465,91794,1179,0,398954,92973,0.233041904580478,0.0786657108338305,0.0268786209270576
SEN,Mbacke,2020,1036654,154902,0,0,0,1191556,0,0,0,0
SEN,Mbacke,2021,922413,270574,59578,0,0,1252565,59578,0.0475647970364812,0.0158549323454937,0.0052849774484979
SEN,Mbacke,2022,910114,368965,61494,0,0,1340573,61494,0.0458714296051017,0.0152904765350339,0.00509682551167797
SEN,Mbour,2020,764055,66440,0,0,0,830495,0,0,0,0
SEN,Mbour,2021,775949,107964,0,0,0,883913,0,0,0,0
SEN,Mbour,2022,716260,136431,17054,0,0,869745,17054,0.019608046036482,0.00653601534549399,0.00217867178183133
SEN,Medina yoroufoula,2020,148539,22988,5305,0,0,176832,5305,0.0300002262034021,0.010000075401134,0.00333335846704468
SEN,Medina yoroufoula,2021,167923,26525,7073,0,0,201521,7073,0.0350980791083808,0.0116993597027936,0.00389978656759786
SEN,Medina yoroufoula,2022,153321,51107,9126,0,0,213554,9126,0.0427339220993285,0.0142446406997762,0.00474821356659206
SEN,Nioro du rip,2020,392530,63900,0,0,0,456430,0,0,0,0
SEN,Nioro du rip,2021,404756,73029,4706,0,0,482491,4706,0.00975354980714666,0.00325118326904889,0.00108372775634963
SEN,Nioro du rip,2022,547815,109563,14119,0,0,671497,14119,0.021026154993991,0.00700871833133035,0.00233623944377678
SEN,Oussouye,2020,52235,8084,1866,0,0,62185,1866,0.030007236471818,0.0100024121572727,0.00333413738575755
SEN,Oussouye,2021,55251,10571,3109,0,0,68931,3109,0.0451030740885813,0.0150343580295271,0.00501145267650904
SEN,Oussouye,2022,57178,10279,1285,0,0,68742,1285,0.0186930842861715,0.00623102809539049,0.00207700936513016
SEN,Pikine,2020,1245158,143122,42936,0,0,1431216,42936,0.0299996646208539,0.00999988820695129,0.00333329606898376
SEN,Pikine,2021,1312434,357804,85873,0,0,1756111,85873,0.0488995285605523,0.0162998428535174,0.00543328095117248
SEN,Pikine,2022,1312434,211196,60342,0,0,1583972,60342,0.0380953703727086,0.0126984567909029,0.00423281893030096
SEN,Podor,2020,361092,77703,18283,0,0,457078,18283,0.0399997374627525,0.0133332458209175,0.00444441527363917
SEN,Podor,2021,328371,126658,27425,0,0,482454,27425,0.0568447976387386,0.0189482658795795,0.00631608862652651
SEN,Podor,2022,347135,154804,32837,0,0,534776,32837,0.0614032791299535,0.0204677597099845,0.00682258656999483
SEN,Ranerou,2020,31914,24282,11794,1388,0,69378,13182,0.190002594482401,0.0700029788501638,0.027780180076297
SEN,Ranerou,2021,43194,27751,13182,2775,0,86902,15957,0.183620630135095,0.0718510506087317,0.0310464661342662
SEN,Ranerou,2022,41034,26636,15838,2160,0,85668,17998,0.210090115328944,0.0784345768937448,0.0317478845984239
SEN,Rufisque,2020,509867,89976,0,0,0,599843,0,0,0,0
SEN,Rufisque,2021,531092,131965,17995,0,0,681052,17995,0.0264223583514915,0.0088074527838305,0.00293581759461017
SEN,Rufisque,2022,550059,107483,12645,0,0,670187,12645,0.0188678682218545,0.00628928940728483,0.00209642980242828
SEN,Saint louis,2020,321670,43864,0,0,0,365534,0,0,0,0
SEN,Saint louis,2021,326380,54830,3751,0,0,384961,3751,0.0097438441816184,0.00324794806053947,0.00108264935351316
SEN,Saint louis,2022,333883,56272,11254,0,0,401409,11254,0.0280362423363701,0.00934541411212338,0.00311513803737446
SEN,Salemata,2020,15827,8921,3741,288,0,28777,4029,0.140007644994266,0.0500052124960906,0.0188924024973648
SEN,Salemata,2021,20535,10072,5468,576,0,36651,6044,0.164906823824725,0.0602075432230135,0.0235615823730746
SEN,Salemata,2022,20237,8928,2976,0,0,32141,2976,0.0925920164276158,0.0308640054758719,0.0102880018252906
SEN,Saraya,2020,43571,14524,7262,660,0,66017,7922,0.11999939409546,0.0433322730003888,0.0166657409791754
SEN,Saraya,2021,51205,19145,12543,1320,0,84213,13863,0.164618289337751,0.060097609632717,0.0235157675576613
SEN,Saraya,2022,56667,18434,3414,0,0,78515,3414,0.0434821371712412,0.0144940457237471,0.00483134857458235
SEN,Sedhiou,2020,162162,31641,3955,0,0,197758,3955,0.019999190930329,0.00666639697677633,0.00222213232559211
SEN,Sedhiou,2021,173967,51417,7910,0,0,233294,7910,0.0339057155349045,0.0113019051783015,0.0037673017261005
SEN,Sedhiou,2022,165780,47073,4093,0,0,216946,4093,0.0188664460280438,0.00628881534268128,0.00209627178089376
SEN,Tambacounda,2020,341386,43666,11909,0,0,396961,11909,0.0300004282536572,0.0100001427512191,0.00333338091707302
SEN,Tambacounda,2021,337416,59544,23818,0,0,420778,23818,0.056604670396266,0.018868223465422,0.00628940782180733
SEN,Tambacounda,2022,325507,123455,20576,0,0,469538,20576,0.0438217993005891,0.0146072664335297,0.00486908881117657
SEN,Thies,2020,704798,124376,0,0,0,829174,0,0,0,0
SEN,Thies,2021,715121,140960,8513,0,0,864594,8513,0.00984623996928038,0.00328207998976013,0.00109402666325338
SEN,Thies,2022,698095,229860,51080,0,0,979035,51080,0.0521738242248745,0.0173912747416248,0.00579709158054161
SEN,Tivaoune,2020,505285,56143,0,0,0,561428,0,0,0,0
SEN,Tivaoune,2021,494057,80700,5764,0,0,580521,5764,0.00992901204263067,0.00330967068087689,0.0011032235602923
SEN,Tivaoune,2022,501496,92229,11529,0,0,605254,11529,0.019048201251045,0.00634940041701501,0.00211646680567167
SEN,Velingara,2020,267374,78430,10695,0,0,356499,10695,0.0300000841517087,0.0100000280505696,0.00333334268352319
SEN,Velingara,2021,316460,89125,14260,0,0,419845,14260,0.033964915623623,0.0113216385412077,0.00377387951373589
SEN,Velingara,2022,320140,55197,14719,0,0,390056,14719,0.0377356071948643,0.0125785357316214,0.00419284524387381
SEN,Ziguinchor,2020,284470,24737,0,0,0,309207,0,0,0,0
SEN,Ziguinchor,2021,277203,49500,3300,0,0,330003,3300,0.00999990909173553,0.00333330303057851,0.00111110101019284
SEN,Ziguinchor,2022,287103,62701,13200,0,0,363004,13200,0.0363632356668246,0.0121210785556082,0.00404035951853607
SLE,Bo,2020,534362,92359,32985,0,0,659706,32985,0.0499995452519759,0.016666515083992,0.00555550502799732
SLE,Bo,2021,395123,217999,85762,0,0,698884,85762,0.122712782092593,0.0409042606975311,0.0136347535658437
SLE,Bo,2022,388311,258874,81750,0,0,728935,81750,0.112149917345168,0.0373833057817227,0.0124611019272409
SLE,Bombali,2020,415706,207853,69284,0,0,692843,69284,0.0999995670014708,0.0333331890004903,0.0111110630001634
SLE,Bombali,2021,354162,242495,173211,0,0,769868,173211,0.224987920007066,0.0749959733356887,0.0249986577785629
SLE,Bombali,2022,340541,279243,143027,0,0,762811,143027,0.187499918066205,0.062499972688735,0.0208333242295783
SLE,Bonthe,2020,184003,33659,6732,0,0,224394,6732,0.0300008021604856,0.0100002673868285,0.00333342246227618
SLE,Bonthe,2021,145856,92528,23132,0,0,261516,23132,0.0884534789458389,0.0294844929819463,0.00982816432731543
SLE,Bonthe,2022,94842,104094,64770,4626,0,268332,69396,0.258619918608291,0.0919532519416246,0.0344821589175598
SLE,Falaba,2021,119116,99263,29779,0,0,248158,29779,0.12000016118763,0.0400000537292102,0.0133333512430701
SLE,Falaba,2022,106708,124079,57076,0,0,287863,57076,0.198274873811501,0.0660916246038335,0.0220305415346112
SLE,Kailahun,2020,275220,250200,93825,6255,0,625500,100080,0.16,0.0566666666666667,0.0211111111111111
SLE,Kailahun,2021,355436,281475,156375,18765,0,812051,175140,0.215676109012858,0.0795947545166498,0.0316667302915704
SLE,Kailahun,2022,342511,303737,161562,0,0,807810,161562,0.2,0.0666666666666667,0.0222222222222222
SLE,Kambia,2020,217047,118389,51302,7893,0,394631,59195,0.150000886904475,0.0566672832764448,0.023333752853228
SLE,Kambia,2021,207799,197316,59195,11839,0,476149,71034,0.149184393960714,0.0580161532069443,0.024864065660119
SLE,Kambia,2022,207799,183352,73341,0,0,464492,73341,0.157895076772043,0.0526316922573478,0.0175438974191159
SLE,Karene,2021,184773,104588,59267,0,0,348628,59267,0.170000688412864,0.0566668961376214,0.0188889653792071
SLE,Karene,2022,146424,163855,104588,10459,0,425326,115047,0.270491340759794,0.0983606300422108,0.0382514432067011
SLE,Kenema,2020,315438,240007,116575,13714,0,685734,130289,0.189999329185953,0.0699994458492652,0.0277773726968313
SLE,Kenema,2021,388605,274294,171434,27429,0,861762,198863,0.230763250178123,0.0875307412796882,0.036250019017883
SLE,Kenema,2022,409801,282622,120114,0,0,812537,120114,0.1478258836213,0.0492752945404332,0.0164250981801444
SLE,Koinadugu,2020,341028,102775,23358,0,0,467161,23358,0.0499998929705177,0.0166666309901726,0.00555554366339085
SLE,Koinadugu,2021,266282,163506,37373,0,0,467161,37373,0.0800002568707576,0.0266667522902525,0.00888891743008418
SLE,Koinadugu,2022,112474,112474,43075,0,0,268023,43075,0.1607138193364,0.0535712731121334,0.0178570910373778
SLE,Kono,2020,330164,170775,56925,11385,0,569249,68310,0.120000210804059,0.0466667486460231,0.0200000351340099
SLE,Kono,2021,364381,227700,85387,17077,0,694545,102464,0.147526798119632,0.0573713726252439,0.02458763970977
SLE,Kono,2022,352627,211576,88157,0,0,652360,88157,0.135135508001717,0.0450451693339056,0.0150150564446352
SLE,Moyamba,2020,182607,146085,36521,0,0,365213,36521,0.0999991785615518,0.0333330595205173,0.0111110198401724
SLE,Moyamba,2021,184800,182607,60343,0,0,427750,60343,0.141070718877849,0.0470235729592831,0.015674524319761
SLE,Moyamba,2022,132000,169714,139543,11314,0,452571,150857,0.333333333333333,0.119444241897956,0.0453701678238823
SLE,Port loko,2020,316321,316321,70294,0,0,702936,70294,0.100000569041847,0.0333335230139491,0.011111174337983
SLE,Port loko,2021,343516,386614,105440,0,0,835570,105440,0.126189307897603,0.0420631026325343,0.0140210342108448
SLE,Port loko,2022,324072,285183,103703,0,0,712958,103703,0.145454570956494,0.048484856985498,0.016161618995166
SLE,Pujehun,2020,218444,158868,19859,0,0,397171,19859,0.0500011330132361,0.0166670443377454,0.00555568144591512
SLE,Pujehun,2021,194613,184562,41014,0,0,420189,41014,0.0976084571466649,0.0325361523822217,0.0108453841274072
SLE,Pujehun,2022,205069,205069,69723,0,0,479861,69723,0.145298325973563,0.0484327753245211,0.016144258441507
SLE,Tonkolili,2020,443149,133552,30353,0,0,607054,30353,0.0500004941899732,0.0166668313966577,0.00555561046555258
SLE,Tonkolili,2021,413666,212469,62677,0,0,688812,62677,0.0909928979169933,0.0303309659723311,0.010110321990777
SLE,Tonkolili,2022,382328,250707,81480,0,0,714515,81480,0.114035394638321,0.0380117982127737,0.0126705994042579
SLE,Western area rural,2020,259658,188379,61096,0,0,509133,61096,0.120000078564933,0.040000026188311,0.0133333420627703
SLE,Western area rural,2021,267157,203653,91644,0,0,562454,91644,0.162935991209948,0.0543119970699826,0.0181039990233275
SLE,Western area rural,2022,288111,235727,89052,0,0,612890,89052,0.145298503809819,0.048432834603273,0.016144278201091
SLE,Western area urban,2020,696133,360069,144028,0,0,1200230,144028,0.120000333269457,0.0400001110898189,0.013333370363273
SLE,Western area urban,2021,708004,480092,180035,0,0,1368131,180035,0.131591930889659,0.0438639769632197,0.0146213256544066
SLE,Western area urban,2022,633478,521687,223580,0,0,1378745,223580,0.16216196613587,0.0540539887119567,0.0180179962373189
SLV,Ahuachapan,2017,308952,54521,0,0,0,363473,0,0,0,0
SLV,Ahuachapan,2018,312587,54521,0,0,0,367108,0,0,0,0
SLV,Ahuachapàn,2020,151958,140561,75979,11397,0,379895,87376,0.230000394845944,0.0866669298972962,0.0355557310426419
SLV,Ahuachapàn,2021,132963,170953,94974,11397,0,410287,106371,0.259259981427635,0.0956793659072795,0.0380660367011385
SLV,Ahuachapán,2021,148699,159580,72536,7254,0,388069,79790,0.205607765629308,0.0747667725756674,0.0290761579913767
SLV,Ahuachapán,2022,108804,181341,65283,7254,0,362682,72537,0.20000165434182,0.0733342156489707,0.0288894035730107
SLV,Cabañas,2020,113161,52228,8705,0,0,174094,8705,0.0500017232070031,0.016667241069001,0.00555574702300035
SLV,Cabañas,2021,104456,73119,26115,3072,0,206762,29187,0.141162302550759,0.0520066549946315,0.0206372544277962
SLV,Cabañas,2022,53766,72200,24579,3072,0,153617,27651,0.179999609418228,0.0666657987071743,0.0266658855031236
SLV,Chalatenango,2017,188547,16395,0,0,0,204942,0,0,0,0
SLV,Chalatenango,2018,125015,14346,0,0,0,139361,0,0,0,0
SLV,Chalatenango,2020,126507,73796,10542,0,0,210845,10542,0.0499988142948612,0.0166662714316204,0.00555542381054013
SLV,Chalatenango,2021,115965,90290,21085,0,0,227340,21085,0.0927465470220815,0.0309155156740272,0.0103051718913424
SLV,Chalatenango,2022,72232,81261,27087,0,0,180580,27087,0.15,0.05,0.0166666666666667
SLV,Cuscatlàn,2020,165602,96601,13800,0,0,276003,13800,0.0499994565276464,0.0166664855092155,0.00555549516973849
SLV,Cuscatlàn,2021,151802,110402,27600,0,0,289804,27600,0.095236780720763,0.0317455935735877,0.0105818645245292
SLV,Cuscatlán,2021,111002,129503,26429,2643,0,269577,29072,0.107843028151511,0.0392157590101035,0.0152506416431009
SLV,Cuscatlán,2022,105716,129503,26429,2643,0,264291,29072,0.109999962162919,0.0400001008988829,0.0155556648626787
SLV,La Libertad,2020,415488,315771,83098,16620,0,830977,99718,0.120000914586084,0.0466671560504483,0.0200002861424297
SLV,La Libertad,2021,332390,478526,108027,16620,0,935563,124647,0.133232075231705,0.0503322598264361,0.0207251319971682
SLV,La Libertad,2022,199386,478526,119631,0,0,797543,119631,0.1499994357671,0.0499998119223666,0.0166666039741222
SLV,La Paz,2020,281593,75091,18773,0,0,375457,18773,0.0500003995131267,0.0166667998377089,0.00555559994590296
SLV,La Paz,2021,244047,170853,56319,3559,0,474778,59878,0.126117890887952,0.0445380086412316,0.0165118106661312
SLV,La Paz,2022,135259,163734,53392,3559,0,355944,56951,0.159999887622772,0.0566662171577552,0.0211106865749169
SLV,La Unión,2017,246956,21474,0,0,0,268430,0,0,0,0
SLV,La Unión,2018,249640,21474,0,0,0,271114,0,0,0,0
SLV,La Unión,2019,187990,81431,35287,13572,0,318280,48859,0.153509488500691,0.0653837292111767,0.0312705095443565
SLV,La Unión,2020,166639,83319,27773,0,0,277731,27773,0.0999996399393658,0.0333332133131219,0.011111071104374
SLV,La Unión,2021,111092,115909,55546,13887,0,296434,69433,0.234227517761121,0.0936914568954078,0.0416408973929366
SLV,La Unión,2022,69545,118227,39409,4636,0,231817,44045,0.189999007838079,0.0699991803879785,0.0277771786461831
SLV,Morazan,2017,179305,22413,0,0,0,201718,0,0,0,0
SLV,Morazan,2018,183380,24451,0,0,0,207831,0,0,0,0
SLV,Morazan,2019,101839,112091,22418,11209,0,247557,33627,0.135835383366255,0.0603712814961134,0.0301856407480567
SLV,Morazán,2020,137281,63360,10560,0,0,211201,10560,0.0499997632586967,0.0166665877528989,0.0055555292509663
SLV,Morazán,2021,105601,96685,32873,5801,0,240960,38674,0.160499667994688,0.0615247343957503,0.0258581415080419
SLV,Morazán,2022,52210,100552,34806,5801,0,193369,40607,0.209997465984724,0.0799990346608471,0.0333329311086863
SLV,San Miguel,2020,335557,129060,51624,0,0,516241,51624,0.0999998062920225,0.0333332687640075,0.0111110895880025
SLV,San Miguel,2021,283933,251313,103248,10325,0,648819,113573,0.175045736946668,0.0636530886631454,0.0247540360083304
SLV,San Miguel,2022,139618,242005,74463,9308,0,465394,83771,0.18000017189736,0.0666668099144667,0.0266667717150534
SLV,San Salvador,2020,1004944,639510,127902,54815,0,1827171,182717,0.099999945270585,0.0433332913741151,0.0211110813139852
SLV,San Salvador,2021,913585,866788,182717,54815,0,2017905,237532,0.11771218169339,0.0482921643982249,0.0221339017996938
SLV,San Salvador,2022,606752,953467,173358,0,0,1733577,173358,0.100000173052596,0.033333391017532,0.0111111303391773
SLV,San Vicente,2020,142570,38019,9505,0,0,190094,9505,0.0500015781665913,0.0166671927221971,0.00555573090739903
SLV,San Vicente,2021,138768,88757,17403,3481,0,248409,20884,0.0840710280223341,0.0326947359663566,0.0140122852947268
SLV,San Vicente,2022,60912,92237,17403,3481,0,174033,20884,0.120000229841467,0.0466673944979784,0.0200006767554302
SLV,San miguel,2017,489919,9998,0,0,0,499917,0,0,0,0
SLV,San miguel,2018,494918,9998,0,0,0,504916,0,0,0,0
SLV,San miguel,2019,310038,126325,85901,0,0,522264,85901,0.164478118346277,0.054826039448759,0.0182753464829197
SLV,Santa Ana,2020,259133,271186,60264,12053,0,602636,72317,0.120001128376001,0.0466671976671379,0.0200002802502487
SLV,Santa Ana,2021,269051,289265,90395,12053,0,660764,102448,0.155044766361364,0.0577619240757668,0.0233075315510194
SLV,Santa Ana,2022,207393,280261,67263,5605,0,560522,72868,0.130000249767181,0.0466666190919655,0.0177776746992585
SLV,Santa ana,2017,536232,53034,0,0,0,589266,0,0,0,0
SLV,Santa ana,2018,536232,53034,0,0,0,589266,0,0,0,0
SLV,Sonsonate,2020,281220,187480,52078,0,0,520778,52078,0.100000384040801,0.0333334613469335,0.0111111537823112
SLV,Sonsonate,2021,260389,234350,78117,5027,0,577883,83144,0.143876874730698,0.0508586224777911,0.018885983648747
SLV,Sonsonate,2022,191036,236282,70382,5027,0,502727,75409,0.149999900542442,0.0533331211572086,0.0199998099255549
SLV,Usulutan,2017,329925,44990,0,0,0,374915,0,0,0,0
SLV,Usulutan,2018,326176,52488,0,0,0,378664,0,0,0,0
SLV,Usulutan,2019,170400,152995,95622,38249,0,457266,133871,0.292763949211181,0.125470368086263,0.0604117127060009
SLV,Usulután,2020,270425,77264,38632,0,0,386321,38632,0.0999997411479055,0.0333332470493018,0.0111110823497673
SLV,Usulután,2021,251109,157380,57948,10492,0,476929,68440,0.143501443611104,0.0551668417451375,0.0232776320537811
SLV,Usulután,2022,129401,157380,52460,10492,0,349733,62952,0.180000171559447,0.0700000667175626,0.0300000285932411
SOM,Adan yabaal,2017,32937,10201,6801,0,0,49939,6801,0.136186147099461,0.0453953823664871,0.0151317941221624
SOM,Adan yabaal,2018,32985,11334,0,0,0,44319,0,0,0,0
SOM,Adan yabaal,2019,28394,10222,1514,0,0,40130,1514,0.0377273859955146,0.0125757953318382,0.0041919317772794
SOM,Adan yabaal,2020,32649,5694,711,0,0,39054,711,0.018205561530189,0.00606852051006299,0.002022840170021
SOM,Adan yabaal,2021,26179,7200,4600,0,0,37979,4600,0.121119566075989,0.0403731886919964,0.0134577295639988
SOM,Afgooye,2017,231296,57277,26252,0,0,314825,26252,0.0833860080997379,0.027795336033246,0.00926511201108199
SOM,Afgooye,2018,232338,90510,7160,0,0,330008,7160,0.0216964437225764,0.00723214790752547,0.00241071596917516
SOM,Afgooye,2019,239181,131418,23655,7885,0,402139,31540,0.078430592407103,0.0326794135029596,0.0152503929680478
SOM,Afgooye,2020,147402,47003,22043,4603,0,221051,26646,0.12054231828854,0.0471218557406813,0.0203346738987835
SOM,Afgooye,2021,127731,47300,30800,2800,0,208631,33600,0.161049891914433,0.0581569054135451,0.0223680405436712
SOM,Afmadow,2017,162680,41396,22423,0,0,226499,22423,0.0989982295727575,0.0329994098575858,0.0109998032858619
SOM,Afmadow,2018,161909,31047,9789,160,0,202905,9949,0.0490327986003302,0.0166071149881307,0.00571093752139069
SOM,Afmadow,2019,151835,25306,18076,3615,0,198832,21691,0.109092097851452,0.0424244253104799,0.018181736899046
SOM,Afmadow,2020,130496,34458,17970,3680,0,186604,21650,0.116021092795438,0.0452473330332326,0.0194648679675796
SOM,Afmadow,2021,120286,28600,27000,1500,0,177386,28500,0.160666568951327,0.0563742347197637,0.02067055273058
SOM,Awdal,2021,366849,125840,54090,25410,0,572189,79500,0.138940105454666,0.0611161696572286,0.0302405906673028
SOM,Awdal,2022,372789,152600,115580,19010,0,659979,134590,0.203930731129324,0.0775782259738567,0.0322602857228959
SOM,Baardheere,2017,127716,42572,30155,7095,0,207538,37250,0.179485202709865,0.071223904377351,0.0313383037751587
SOM,Baardheere,2018,150776,40798,10643,0,0,202217,10643,0.0526315789473684,0.0175438596491228,0.00584795321637427
SOM,Baardheere,2019,100274,62365,13451,3669,0,179759,17120,0.0952386250479809,0.0385497619961541,0.0173856230966028
SOM,Baardheere,2020,72816,35397,10992,1365,0,120570,12357,0.102488181139587,0.0379364684415692,0.0151613170772166
SOM,Baardheere,2021,64333,25800,15800,1500,0,107433,17300,0.161030595813205,0.0583309287338776,0.0225463518864988
SOM,Badhaadhe,2017,38201,14606,10112,0,0,62919,10112,0.160714569525898,0.0535715231752995,0.0178571743917665
SOM,Badhaadhe,2018,44381,7865,8427,0,0,60673,8427,0.138892093682528,0.0462973645608425,0.0154324548536142
SOM,Badhaadhe,2019,35513,6194,7433,1652,0,50792,9085,0.178866750669397,0.0704638525752087,0.0307156857597872
SOM,Badhaadhe,2020,37175,7812,4327,100,0,49414,4427,0.0895899947383333,0.0305379042376654,0.0106290165180358
SOM,Badhaadhe,2021,34256,8400,6100,700,0,49456,6800,0.137495956001294,0.0505499838240052,0.0199953269348287
SOM,Baki,2017,72664,27793,21315,993,0,122765,22308,0.181713028957765,0.0632672178552519,0.0228865447535264
SOM,Baki,2018,67820,28019,15502,1938,0,113279,17440,0.15395616133617,0.0570214544031403,0.0228089741062137
SOM,Baki,2019,35734,58565,17867,2978,0,115144,20845,0.181034183283541,0.0689658167164594,0.0287359982090059
SOM,Baki,2020,70222,28756,7715,5208,0,111901,12923,0.115486009955228,0.054009049665925,0.0283454918980964
SOM,Baki,2021,63957,25781,11899,4958,0,106595,16857,0.158140625732914,0.0682177087730819,0.033075347499101
SOM,Bakool,2021,339297,91340,63640,17580,0,511857,81220,0.15867713052669,0.0643408868753057,0.029079302313819
SOM,Bakool,2022,248147,118670,151910,114670,13430,646827,280010,0.432897822756317,0.217234799000866,0.12564925912699
SOM,Balcad,2017,181833,44575,33962,0,0,260370,33962,0.130437454391827,0.0434791514639423,0.0144930504879808
SOM,Balcad,2018,186790,50943,5367,0,0,243100,5367,0.0220773344302756,0.00735911147675854,0.00245303715891951
SOM,Balcad,2019,173376,80345,21143,6343,0,281207,27486,0.0977429438100759,0.0400997604374476,0.0183791062574308
SOM,Balcad,2020,144755,43467,16186,2779,0,207187,18965,0.0915356658477607,0.0349828898531279,0.0146416307758477
SOM,Balcad,2021,117933,43600,32300,3600,0,197433,35900,0.181833837301768,0.0666892903753003,0.0262817709749074
SOM,Banadir,2017,1188164,511571,181525,33005,0,1914265,214530,0.112069123136034,0.0431035758720275,0.0181993262862422
SOM,Banadir,2018,1468703,455888,188667,29820,4970,2148048,223457,0.104027936061019,0.0408459215064095,0.0182427642833556
SOM,Banadir,2019,1353187,544575,148521,49507,0,2095790,198028,0.0944884745131907,0.0393701977138295,0.0183727589331204
SOM,Banadir,2020,1627659,495393,322246,49700,0,2494998,371946,0.149076672606551,0.0563321760845767,0.0232040266164542
SOM,Banadir,2021,1965842,538100,449130,90400,0,3043472,539530,0.17727450753613,0.068992475260711,0.0295981402526822
SOM,Banadir,2022,1920642,716030,672260,269770,45200,3623902,987230,0.27242182597653,0.123936390480022,0.0661699277003996
SOM,Bandarbeyla,2017,9443,4180,3715,2167,0,19505,5882,0.301563701614971,0.137554473211997,0.070540317297559
SOM,Bandarbeyla,2018,9908,4190,3870,1393,0,19361,5263,0.271835132482826,0.114594631819982,0.0541868246015759
SOM,Bandarbeyla,2019,9858,6858,1572,0,0,18288,1572,0.0859580052493438,0.0286526684164479,0.00955088947214931
SOM,Bandarbeyla,2020,10216,3856,1956,808,0,16836,2764,0.164172012354479,0.0707214698661598,0.0342388004540535
SOM,Bandarbeyla,2021,8223,3700,3900,1100,0,16923,5000,0.295455888435857,0.120152061297248,0.0544951972003913
SOM,Baraawe,2017,59304,12592,17777,4444,0,94117,22221,0.236099748185769,0.0944391909361044,0.0419725802281557
SOM,Baraawe,2018,59048,24954,21481,4444,0,109927,25925,0.23583832907293,0.0920883859288437,0.0396798683570814
SOM,Baraawe,2019,66449,30009,715,0,0,97173,715,0.00735801097012545,0.00245267032337515,0.000817556774458383
SOM,Baraawe,2020,46530,9513,5232,1300,0,62575,6532,0.1043867359169,0.0417206019443335,0.0185235495183558
SOM,Baraawe,2021,45143,10900,5100,400,0,61543,5500,0.0893684090798304,0.0319559765800606,0.012096330117876
SOM,Bari,2021,669261,226410,180960,15930,0,1092561,196890,0.18020961758657,0.0649300130610556,0.0248834313751513
SOM,Bari,2022,690111,279880,247750,70460,0,1288201,318210,0.247018904658512,0.100571779300487,0.0456786893763732
SOM,Bay,2021,623833,262830,286110,83670,0,1256443,369780,0.294307023876133,0.120299926061111,0.0548983651997478
SOM,Bay,2022,626683,250140,385280,308440,96250,1666793,789970,0.473946074887524,0.258162431287708,0.1656734419531
SOM,Baydhaba,2017,176780,188987,89994,59979,0,515740,149973,0.290791871873425,0.135696281071858,0.0710758650999858
SOM,Baydhaba,2018,227289,186859,104861,7380,0,526389,112241,0.213228239951823,0.0757494299209647,0.0283653765983374
SOM,Baydhaba,2019,265482,130491,130491,31498,0,557962,161989,0.29032263845925,0.115591503841958,0.0510753619621249
SOM,Baydhaba,2020,329203,149592,114201,28139,0,621135,142340,0.229161132443028,0.0914878944727528,0.0405631983743022
SOM,Baydhaba,2021,320437,118300,124100,32400,0,595237,156500,0.26292048377369,0.105784194642918,0.047357420470987
SOM,Belet weyne,2017,162043,56586,77621,35282,0,331532,112903,0.340549328571601,0.14899014273132,0.0733125141598532
SOM,Belet weyne,2018,161228,56002,49395,21169,1921,289715,72485,0.250194156326045,0.112174608379499,0.0580493856989724
SOM,Belet weyne,2019,164615,77163,61731,7716,0,311225,69447,0.223140814523255,0.0826443891075588,0.0330575414357244
SOM,Belet weyne,2020,164156,57963,38078,10676,0,270873,48754,0.17998840785165,0.0731339040805101,0.0331364801134767
SOM,Belet weyne,2021,155351,51600,43400,7500,0,257851,50900,0.197400824507177,0.0754957966681016,0.0316289467776179
SOM,Belet xaawo,2017,65013,25766,18286,831,0,109896,19117,0.173955375991847,0.0605056902283371,0.0218489400079267
SOM,Belet xaawo,2018,73142,19948,2399,0,0,95489,2399,0.0251233126328687,0.00837443754428957,0.00279147918142986
SOM,Belet xaawo,2019,77052,56184,1605,803,0,135644,2408,0.0177523517442718,0.00789075324624262,0.00394578619196
SOM,Belet xaawo,2020,47171,29131,8655,2132,0,87089,10787,0.123861796552952,0.0494475000669813,0.0219226563885476
SOM,Belet xaawo,2021,41852,20300,11400,1200,0,74752,12600,0.168557363013699,0.0615368150684932,0.0240796232876712
SOM,Berbera,2017,114405,59007,24641,8941,0,206994,33582,0.162236586567727,0.0684770250989562,0.032424450306128
SOM,Berbera,2018,100325,59152,39686,17601,0,216764,57287,0.264282814489491,0.115160574019056,0.0564310596880581
SOM,Berbera,2019,78676,80465,30398,10729,0,200268,41127,0.205359817844089,0.0863110099133827,0.0406754948369185
SOM,Berbera,2020,120598,49823,25269,9605,0,205295,34874,0.169872622323973,0.0722196513959587,0.0344701797684091
SOM,Berbera,2021,119497,45000,28700,10400,0,203597,39100,0.192046051759112,0.0810424515095999,0.038365551118686
SOM,Borama,2017,322873,83708,55686,0,0,462267,55686,0.120462849392234,0.0401542831307448,0.0133847610435816
SOM,Borama,2018,358748,83708,65412,3986,0,511854,69398,0.135581630699379,0.0477896691895215,0.0176604179229928
SOM,Borama,2019,250589,159104,87507,3978,0,501178,91485,0.182539935910994,0.0634924118776163,0.0229279816751733
SOM,Borama,2020,321938,114922,44570,23172,0,504602,67742,0.134248377929537,0.0600565726387661,0.0302235997655358
SOM,Borama,2021,305534,116800,67300,5500,0,495134,72800,0.147030904765175,0.0527130029446574,0.0200394685523964
SOM,Bossaso,2017,300522,164348,156679,33235,0,654784,189914,0.290040685172515,0.113599293812922,0.0491458082190293
SOM,Bossaso,2018,328696,164348,155011,32103,1396,681554,188510,0.276588502158303,0.109262557821293,0.0482536151859492
SOM,Bossaso,2019,308610,170923,80713,9496,0,569742,90209,0.158333070056271,0.0583334210923541,0.0231482944131827
SOM,Bossaso,2020,303563,126095,90726,23360,0,543744,114086,0.20981564854049,0.0842590140458255,0.0376333143701611
SOM,Bossaso,2021,260720,116800,149100,20700,0,547320,169800,0.310238982679237,0.116019878681576,0.0470778825306341
SOM,Bu'aale,2017,76290,26581,19617,0,0,122488,19617,0.16015446411077,0.0533848213702567,0.0177949404567522
SOM,Bu'aale,2018,94818,26929,9353,0,0,131100,9353,0.0713424866514111,0.0237808288838037,0.0079269429612679
SOM,Bu'aale,2019,82809,27603,18402,1022,0,129836,19424,0.149604115961675,0.0524918615278762,0.0192465024252818
SOM,Bu'aale,2020,52267,19503,10141,3428,0,85339,13569,0.159001160079214,0.0663901225309257,0.0310565314022116
SOM,Bu'aale,2021,54311,16800,11600,0,0,82711,11600,0.14024736733929,0.0467491224464299,0.0155830408154766
SOM,Bulo burto,2017,85889,32840,38719,17977,0,175425,56696,0.323192247399173,0.141889696451475,0.0700691970294365
SOM,Bulo burto,2018,88501,32833,29039,9680,0,160053,38719,0.241913616114662,0.10079786070864,0.0470392793498265
SOM,Bulo burto,2019,99783,34103,25262,2526,0,161674,27788,0.171876739611811,0.0625002577202683,0.0243054266954214
SOM,Bulo burto,2020,71812,17052,12300,1291,0,102455,13591,0.132653360011712,0.0484180046524491,0.0189394802054018
SOM,Bulo burto,2021,63980,18300,13000,700,0,95980,13700,0.14273807043134,0.0500104188372578,0.0182908476302933
SOM,Burco,2017,294627,161124,92071,13811,0,561633,105882,0.18852524691391,0.071038679469808,0.0291441801556058
SOM,Burco,2018,280816,156520,55242,9207,2590,504375,67039,0.132914993804213,0.0538131350681537,0.0254175960346964
SOM,Burco,2019,246942,149929,74964,8819,0,480654,83783,0.174310418721159,0.0642194454500188,0.0254837968453168
SOM,Burco,2020,383910,114597,79720,14947,0,593174,94667,0.159593980855533,0.0615974402114725,0.0261321111324652
SOM,Burco,2021,283649,124300,109800,25400,0,543149,135200,0.248918804968802,0.0985610455571737,0.0432457555641065
SOM,Burtinle,2017,40927,20876,18190,7796,0,87789,25986,0.296005194272631,0.128269676914724,0.0624907448541389
SOM,Burtinle,2018,48073,20737,11693,2599,0,83102,14292,0.171981420423095,0.0677520797734511,0.0295339863460968
SOM,Burtinle,2019,43595,23946,3070,1228,0,71839,4298,0.0598282270076143,0.025640668717549,0.0123455071603014
SOM,Burtinle,2020,41364,17835,9114,1529,0,69842,10643,0.152386815956015,0.0580930290274238,0.0242292921483094
SOM,Burtinle,2021,33592,14700,11000,3300,0,62592,14300,0.228463701431493,0.0937286980231766,0.0429589865939559
SOM,Buuhoodle,2017,68807,41284,23449,7537,0,141077,30986,0.219638920589465,0.091021215364659,0.0422125663447778
SOM,Buuhoodle,2018,69092,46750,15912,5025,0,136779,20937,0.153071743469392,0.0632699464099021,0.0292540034167038
SOM,Buuhoodle,2019,52752,61927,20642,0,0,135321,20642,0.152540995115318,0.0508469983717728,0.0169489994572576
SOM,Buuhoodle,2020,73651,25681,12841,2572,0,114745,15413,0.134323935683472,0.052246285241187,0.022396521755971
SOM,Buuhoodle,2021,60473,24700,22400,2600,0,110173,25000,0.226915850525991,0.0835050329935647,0.0330792884322333
SOM,Buur hakaba,2017,112403,45356,49300,35496,0,242555,84796,0.349594937230731,0.165312334659493,0.0876245708304417
SOM,Buur hakaba,2018,141983,35496,49300,0,0,226779,49300,0.217392262952037,0.072464087650679,0.0241546958835597
SOM,Buur hakaba,2019,94872,26923,28205,15385,0,165385,43590,0.263566828914351,0.118864064657214,0.0602936582318026
SOM,Buur hakaba,2020,108998,34041,18343,2523,0,163905,20866,0.127305451328513,0.0475661714611106,0.0192760711658854
SOM,Buur hakaba,2021,98859,24000,18400,2500,0,143759,20900,0.145382202157778,0.05425747257563,0.0219503165405683
SOM,Cabudwaaq,2017,76469,68518,26509,10196,0,181692,36705,0.202017700283997,0.086044881814646,0.0411520595293133
SOM,Cabudwaaq,2018,72391,68758,27515,3057,0,171721,30572,0.178032972088446,0.0652783682057912,0.0257154855194699
SOM,Cabudwaaq,2019,84903,101287,5958,1490,0,193638,7448,0.0384635247213873,0.0153860984586359,0.0068386485205498
SOM,Cabudwaaq,2020,69356,39008,21176,3344,0,132884,24520,0.184521838596069,0.0698955479967491,0.0288906949754004
SOM,Cabudwaaq,2021,72149,27800,21000,2700,0,123649,23700,0.191671586506967,0.0711691966776925,0.0285755107872553
SOM,Cadaado,2017,99783,31337,29805,12959,0,173884,42764,0.245934070989855,0.10682025564936,0.0521682398738367
SOM,Cadaado,2018,92007,31866,29805,6479,0,160157,36284,0.226552695167867,0.0890022498756429,0.0386572065050059
SOM,Cadaado,2019,63755,49708,8645,1081,0,123189,9726,0.0789518544675255,0.0292423295369987,0.0116974729886597
SOM,Cadaado,2020,51273,24002,9992,1549,0,86816,11541,0.132936325101364,0.0502595527706106,0.0207181471925298
SOM,Cadaado,2021,50126,20200,11600,1300,0,83226,12900,0.154999639535722,0.0568732527495414,0.0224288884082699
SOM,Cadale,2017,72818,21724,14772,0,0,109314,14772,0.13513365168231,0.0450445505607699,0.0150148501869233
SOM,Cadale,2018,72674,25200,0,0,0,97874,0,0,0,0
SOM,Cadale,2019,62774,23436,3348,0,0,89558,3348,0.0373835949887224,0.0124611983295741,0.00415373277652471
SOM,Cadale,2020,55899,9857,1429,0,0,67185,1429,0.0212696286373446,0.00708987621244822,0.00236329207081607
SOM,Cadale,2021,44228,12600,8100,0,0,64928,8100,0.124753573188763,0.0415845243962543,0.0138615081320848
SOM,Caluula,2017,30861,21448,15186,3429,0,70924,18615,0.262464046021093,0.103603857650443,0.0452785140901998
SOM,Caluula,2018,31831,21619,11757,6858,0,72065,18615,0.258308471518768,0.1178241864983,0.060422303938574
SOM,Caluula,2019,27433,22944,4489,1496,0,56362,5985,0.106188566764842,0.0442437576144684,0.0206462983333925
SOM,Caluula,2020,32613,15147,8315,3263,0,59338,11578,0.195119484984327,0.0833698473153797,0.040009961763307
SOM,Caluula,2021,31566,12900,10900,700,0,56066,11600,0.206899011878857,0.0731280990261478,0.0271505408308462
SOM,Caynabo,2017,29540,16542,17133,8271,0,71486,25404,0.355370282293036,0.157023752902666,0.0780525790597693
SOM,Caynabo,2018,28949,14179,17133,8271,0,68532,25404,0.370688145683768,0.163792097122512,0.0814169536372303
SOM,Caynabo,2019,11665,19442,17109,2333,0,50549,19442,0.384616906368079,0.143590047940282,0.0581196243029316
SOM,Caynabo,2020,35645,11693,5873,3451,0,56662,9324,0.164554728036427,0.0751532479145341,0.038585530573106
SOM,Caynabo,2021,29201,11600,12400,3200,0,56401,15600,0.276590840587933,0.111109141090879,0.0496445098491162
SOM,Ceel afweyn,2017,69130,30989,22989,14993,0,138101,37982,0.275030593551097,0.127865354583481,0.0667474449054597
SOM,Ceel afweyn,2018,76213,31419,26987,13993,0,148612,40980,0.275751621672543,0.123303187719251,0.062025049569797
SOM,Ceel afweyn,2019,63171,65555,25030,9535,0,163291,34565,0.211677312282979,0.0900233325780355,0.0429839298484845
SOM,Ceel afweyn,2020,79652,33807,16375,8450,0,138284,24825,0.179521853576697,0.0802093276638416,0.0403155824245755
SOM,Ceel afweyn,2021,64289,28500,32800,12200,0,137789,45000,0.326586302244737,0.138375825839992,0.0658010920078284
SOM,Ceel barde,2017,56606,13008,20695,9461,0,99770,30156,0.302255186929939,0.132361097190204,0.06519327787244
SOM,Ceel barde,2018,56510,17223,591,0,0,74324,591,0.00795167106183736,0.00265055702061245,0.000883519006870818
SOM,Ceel barde,2019,54740,24260,0,0,0,79000,0,0,0,0
SOM,Ceel barde,2020,43203,7184,4328,967,0,55682,5295,0.0950935670414137,0.0374866803156017,0.0163547765286209
SOM,Ceel barde,2021,41227,7300,4800,600,0,53927,5400,0.100135368182914,0.0370871734010792,0.0148348693604317
SOM,Ceel buur,2017,62708,29361,17558,10033,0,119660,27591,0.230578305198061,0.1048080673018,0.0535684439244526
SOM,Ceel buur,2018,62708,29386,15886,6689,0,114669,22575,0.196870993904194,0.0850680364062359,0.0413189266497484
SOM,Ceel buur,2019,42160,39148,8281,0,0,89589,8281,0.0924332228286955,0.0308110742762318,0.0102703580920773
SOM,Ceel buur,2020,45090,21142,9910,1321,0,77463,11231,0.144985347843487,0.0540128835702206,0.0217939173827792
SOM,Ceel buur,2021,42370,16800,10600,2400,0,72170,13000,0.180130248025495,0.0711283543485289,0.0310994103428633
SOM,Ceel dheer,2017,73613,36051,28566,13184,0,151414,41750,0.275734080071856,0.12093553656421,0.0596612965482423
SOM,Ceel dheer,2018,74712,36073,29665,4395,0,144845,34060,0.235147916738583,0.0884968989839714,0.0362418063753975
SOM,Ceel dheer,2019,73133,39142,12360,0,0,124635,12360,0.0991695751594656,0.0330565250531552,0.0110188416843851
SOM,Ceel dheer,2020,52505,19309,9228,729,0,81771,9957,0.121766885570679,0.0435606755451199,0.0165013676405246
SOM,Ceel dheer,2021,42823,18300,14200,3100,0,78423,17300,0.220598548895095,0.0867092562131007,0.0376873564586353
SOM,Ceel waaq,2017,42633,17413,8406,0,0,68452,8406,0.122801379068544,0.0409337930228481,0.0136445976742827
SOM,Ceel waaq,2018,54642,13210,2835,0,0,70687,2835,0.0401063844837099,0.0133687948279033,0.00445626494263443
SOM,Ceel waaq,2019,39842,26561,1714,857,0,68974,2571,0.0372749151854322,0.0165666289713032,0.0082833144856516
SOM,Ceel waaq,2020,30239,18300,3860,398,0,52797,4258,0.0806485216963085,0.0293956095990303,0.0114737158887395
SOM,Ceel waaq,2021,24882,10600,5000,1400,0,41882,6400,0.152810276491094,0.062079174824507,0.0281213356042638
SOM,Ceerigaabo,2017,133457,65702,41064,28745,0,268968,69809,0.259543886261563,0.122138445217771,0.0644620260485345
SOM,Ceerigaabo,2018,114846,52173,55436,24638,0,247093,80074,0.324064218735456,0.141258554471393,0.0692442836412921
SOM,Ceerigaabo,2019,104280,93108,37243,11173,0,245804,48416,0.196969943532245,0.080808286276871,0.0370371877141498
SOM,Ceerigaabo,2020,146836,50756,29545,16066,0,243203,45611,0.187542916822572,0.0845343190667878,0.0428581153284385
SOM,Ceerigaabo,2021,109681,48900,57000,15800,0,231381,72800,0.314632575708464,0.127639405713232,0.0577210555557957
SOM,Dhuusamarreeb,2017,106861,37557,34658,18773,0,197849,53431,0.270059489812938,0.121648327765114,0.0616351078066831
SOM,Dhuusamarreeb,2018,96753,37025,32091,12997,307,179173,45395,0.25335848593259,0.109774724242306,0.0538536002138219
SOM,Dhuusamarreeb,2019,77797,65725,25485,1341,0,170348,26826,0.157477634019771,0.0551165848733182,0.0201215550911467
SOM,Dhuusamarreeb,2020,66683,36978,19988,4997,0,128646,24985,0.194215133000637,0.077686053200255,0.0345271347556689
SOM,Dhuusamarreeb,2021,65341,26500,21100,5600,0,118541,26700,0.225238525067276,0.0908265213442325,0.0407735157737267
SOM,Diinsoor,2017,108484,41984,48981,34986,0,234435,83967,0.358167509117666,0.169134301618786,0.0895415218148598
SOM,Diinsoor,2018,122452,36736,47232,0,0,206420,47232,0.228815037302587,0.0762716791008623,0.0254238930336208
SOM,Diinsoor,2019,112823,40501,28929,14465,0,196718,43394,0.220589879929645,0.0980405114597207,0.0490205381420217
SOM,Diinsoor,2020,110256,39517,22113,4375,0,176261,26488,0.150277145823523,0.0583660972459402,0.024971175951824
SOM,Diinsoor,2021,100564,27100,24200,3700,0,155564,27900,0.179347406855056,0.0677106099954574,0.0278556306943337
SOM,Doolow,2017,29284,22517,23221,4926,0,79948,28147,0.35206634312303,0.13789379763513,0.0596568324966784
SOM,Doolow,2018,36296,23807,24574,5170,0,89847,29744,0.331051676739346,0.129531314345498,0.0559642750700883
SOM,Doolow,2019,27443,42924,21110,4926,0,96403,26036,0.270074582741201,0.107057525872293,0.0470409519298039
SOM,Doolow,2020,31795,28719,12786,7320,0,80620,20106,0.249392210369635,0.113396179608038,0.0579756884147854
SOM,Doolow,2021,33010,16100,12300,2300,0,63710,14600,0.22916339664103,0.0884214932245069,0.0374962939709447
SOM,Eyl,2017,56335,27706,22689,6483,0,113213,29172,0.257673588722143,0.10497911017286,0.0477183126790504
SOM,Eyl,2018,60765,27286,21879,7293,0,117223,29172,0.248859012309871,0.103691255129113,0.048389252393586
SOM,Eyl,2019,60029,35094,11082,1847,0,108052,12929,0.119655351127235,0.0455829909056133,0.0189929128773389
SOM,Eyl,2020,46643,21661,9986,2364,0,80654,12350,0.153123217695341,0.0608112017589539,0.0267838200488782
SOM,Eyl,2021,35692,17800,17000,3700,0,74192,20700,0.279005822730214,0.109625476241823,0.0476241823017756
SOM,Gaalkacyo,2017,201741,142900,97719,8572,0,450932,106291,0.235714032270941,0.0849078501119164,0.0325269540517072
SOM,Gaalkacyo,2018,203372,142156,80851,5143,0,431522,85994,0.199280685573389,0.070399655174012,0.0261150583799255
SOM,Gaalkacyo,2019,247973,142900,58841,12609,0,462323,71450,0.154545631517359,0.0606062572415101,0.0262627835709858
SOM,Gaalkacyo,2020,229795,128341,72346,15099,0,445581,87445,0.196249391244241,0.076711828676118,0.0331008528440645
SOM,Gaalkacyo,2021,209773,111300,94900,27200,0,443173,122100,0.275513174313417,0.112296251501483,0.0510711016540568
SOM,Galdogob,2017,63511,28869,27062,8755,0,128197,35817,0.279390313345866,0.115894547714325,0.0538078114152437
SOM,Galdogob,2018,63127,28751,20695,3184,0,115757,23879,0.206285581001581,0.0779304923244383,0.0320892521018647
SOM,Galdogob,2019,58700,37529,5774,2887,0,104890,8661,0.0825722185146344,0.036698763784282,0.018349381892141
SOM,Galdogob,2020,43779,23225,11060,1452,0,79516,12512,0.157351979475829,0.058537485118299,0.0235703785681149
SOM,Galdogob,2021,41180,18100,15300,4100,0,78680,19400,0.246568378240976,0.0995593967124216,0.0447664237699825
SOM,Galgaduud,2021,381323,234300,143780,19910,0,779313,163690,0.210043974628936,0.0785307058909578,0.0318542670845276
SOM,Galgaduud,2022,386303,166220,229670,116930,22480,921603,369080,0.40047612692233,0.192045815823082,0.108471627997932
SOM,Garbahaarey,2017,115843,33098,16160,1539,0,166640,17699,0.106210993759001,0.0384821571451432,0.0148797140875873
SOM,Garbahaarey,2018,115248,35967,3433,0,0,154648,3433,0.0221987998551549,0.00739959995171831,0.00246653331723944
SOM,Garbahaarey,2019,142923,127878,3009,1504,0,275314,4513,0.0163921921878292,0.00728501517055677,0.00364230579548362
SOM,Garbahaarey,2020,68101,53675,19518,7319,0,148613,26837,0.180583125298594,0.0766106150426499,0.0364810316429623
SOM,Garbahaarey,2021,70988,34900,26200,4400,0,136488,30600,0.22419553367329,0.0854775999843698,0.0356563702791943
SOM,Garoowe,2017,165290,57347,44406,19736,0,286779,64142,0.223663517900544,0.0974943539566472,0.0477913499787486
SOM,Garoowe,2018,189961,57355,41939,17269,0,306524,59208,0.19315942634182,0.0831658641193947,0.0402415471545458
SOM,Garoowe,2019,176819,71683,28673,2389,0,279564,31062,0.111108726445465,0.0398847252626709,0.0151938971636787
SOM,Garoowe,2020,146933,57513,32674,10347,0,247467,43021,0.173845401609103,0.0718856790332987,0.0332533675646091
SOM,Garoowe,2021,119504,52500,48700,15000,0,235704,63700,0.270254217153718,0.111297785923588,0.0512412932227615
SOM,Gebiley,2017,74840,32074,16037,0,0,122951,16037,0.130434075363356,0.0434780251211187,0.0144926750403729
SOM,Gebiley,2018,69494,25465,23521,0,0,118480,23521,0.198522957461175,0.066174319153725,0.022058106384575
SOM,Gebiley,2019,57931,49656,17586,3103,0,128276,20689,0.161285041628988,0.0618250231272153,0.0259839027652181
SOM,Gebiley,2020,66260,27086,9529,5022,0,107897,14551,0.13486009805648,0.0604681625377289,0.0304992518585112
SOM,Gebiley,2021,62341,26800,14500,800,0,104441,15300,0.146494192893595,0.051384673324333,0.0188304082368674
SOM,Gedo,2021,392674,241280,140940,16760,0,791654,157700,0.199203187250996,0.0734580174335421,0.0291906424888763
SOM,Gedo,2022,433884,228590,233350,132490,0,1028314,365840,0.355766818306471,0.161536262270085,0.0824769693130914
SOM,Hargeysa,2017,661766,345269,115169,19182,0,1141386,134351,0.11770864545386,0.0448381762757443,0.0186806995082197
SOM,Hargeysa,2018,556267,316125,203820,19182,5947,1101341,228949,0.20788202745562,0.0786995126849904,0.0337034578754446
SOM,Hargeysa,2019,489469,431885,143962,9597,0,1074913,153559,0.142857142857143,0.0505951024253436,0.0188490706793118
SOM,Hargeysa,2020,707597,261022,125290,51963,0,1145872,177253,0.154688307245486,0.0666787680764809,0.032303588688595
SOM,Hargeysa,2021,702886,263700,175400,16800,0,1158786,192200,0.165863239631822,0.0601203903625576,0.0232618926665972
SOM,Hiraan,2021,275894,88350,96250,26470,0,486964,122720,0.252010415554333,0.102122538832439,0.0461202242648099
SOM,Hiraan,2022,270534,105190,122850,77530,1910,578014,202290,0.349974222077666,0.163571585924678,0.0865338517367707
SOM,Hobyo,2017,74894,24322,43784,24197,0,167197,67981,0.406592223544681,0.183771239914592,0.0934174124602183
SOM,Hobyo,2018,67981,24045,31110,13827,0,136963,44937,0.32809590911414,0.143016727145287,0.0701065251199229
SOM,Hobyo,2019,57651,37834,18016,0,0,113501,18016,0.158729879031903,0.0529099596773009,0.017636653225767
SOM,Hobyo,2020,47573,18860,10599,1397,0,78429,11996,0.152953626847212,0.0569219718896497,0.0229322770347136
SOM,Hobyo,2021,37051,19200,16300,4700,0,77251,21000,0.271841141215,0.110893925860722,0.0504847833685001
SOM,Iskushuban,2017,40442,15694,14020,5257,0,75413,19277,0.255619057722143,0.108442841419914,0.0516386063705491
SOM,Iskushuban,2018,40726,15468,14604,3505,0,74303,18109,0.243718288628992,0.0969633348137581,0.0428037151184265
SOM,Iskushuban,2019,42856,24748,9658,1811,0,79073,11469,0.145043187940258,0.0559820250485838,0.0237502055063043
SOM,Iskushuban,2020,40472,17285,9021,3333,0,70111,12354,0.176206301436294,0.074581734677868,0.035424778803136
SOM,Iskushuban,2021,35764,15600,14500,2300,0,68164,16800,0.246464409365648,0.0934021868826164,0.0386323181346948
SOM,Jalalaqsi,2017,106990,35325,39741,11775,0,193831,51516,0.265777919940567,0.108842238857561,0.0497804788707689
SOM,Jalalaqsi,2018,106513,25558,19135,7359,0,158565,26494,0.167086053038186,0.0711653475441197,0.0340351135356338
SOM,Jalalaqsi,2019,112477,34292,20575,2743,0,170087,23318,0.137094545732478,0.051073862199933,0.0206084075927156
SOM,Jalalaqsi,2020,83218,16734,11532,511,0,111995,12043,0.107531586231528,0.0373647633078858,0.0134688552564351
SOM,Jalalaqsi,2021,75163,18000,12100,600,0,105863,12700,0.119966371631259,0.0418780247426706,0.0152188310468352
SOM,Jamaame,2017,61684,21540,27415,0,0,110639,27415,0.247787850577102,0.0825959501923674,0.0275319833974558
SOM,Jamaame,2018,56788,21484,24478,4896,0,107646,29374,0.272875908069041,0.106119440883389,0.0454803502013802
SOM,Jamaame,2019,57819,15178,23128,2168,0,98293,25296,0.257353015982827,0.0931365068383981,0.0359469477311033
SOM,Jamaame,2020,43146,17760,8656,2469,0,72031,11125,0.154447390706779,0.0629080997533469,0.0285864573740627
SOM,Jamaame,2021,33542,15300,14700,2500,0,66042,17200,0.260440325853245,0.0994316747928086,0.0415560468254209
SOM,Jariiban,2017,53229,20835,30299,9827,0,114190,40126,0.351396794815658,0.145818372887293,0.0677301962615913
SOM,Jariiban,2018,50107,20775,20473,8189,0,99544,28662,0.287932974363096,0.123399367783761,0.0594142623697393
SOM,Jariiban,2019,49386,28551,7717,772,0,86426,8489,0.0982227570407053,0.0357184180686368,0.0138911387262578
SOM,Jariiban,2020,48351,22312,11641,744,0,83048,12385,0.149130623254022,0.0526964325851716,0.0195562940842779
SOM,Jariiban,2021,40473,20500,15000,3200,0,79173,18200,0.229876346734367,0.0900980553134696,0.0390144227058327
SOM,Jilib,2017,129476,45453,34964,0,0,209893,34964,0.166580114629835,0.0555267048766117,0.0185089016255372
SOM,Jilib,2018,134611,44102,15734,3496,0,197943,19230,0.0971491793091951,0.0382702764600584,0.0166815699469039
SOM,Jilib,2019,145438,37246,35473,0,0,218157,35473,0.162603079433619,0.054201026477873,0.0180670088259577
SOM,Jilib,2020,109237,35661,16257,4489,0,165644,20746,0.125244500253556,0.0507815958722723,0.0229494847048154
SOM,Jilib,2021,112988,26700,18800,0,0,158488,18800,0.118620968149008,0.039540322716336,0.013180107572112
SOM,Jowhar,2017,155587,32237,19701,0,0,207525,19701,0.0949331405854716,0.0316443801951572,0.0105481267317191
SOM,Jowhar,2018,159396,40341,5757,0,0,205494,5757,0.0280154165085112,0.00933847216950373,0.00311282405650124
SOM,Jowhar,2019,170230,78708,12813,3661,0,265412,16474,0.0620695371723961,0.0252877287638338,0.0114944982810791
SOM,Jowhar,2020,120289,35341,19083,4208,0,178921,23291,0.130174769870502,0.0512311765155199,0.0223034498776307
SOM,Jowhar,2021,104220,35700,29500,4200,0,173620,33700,0.194102061974427,0.0727642744691472,0.0296304829192745
SOM,Juba dhexe,2021,635157,262400,187180,33520,0,1118257,220700,0.197360714039796,0.0757786448016869,0.0319207083483989
SOM,Juba dhexe,2022,324978,271550,357090,168210,0,1121828,525300,0.468253600373676,0.206065457449805,0.102009101811211
SOM,Juba hoose,2021,981234,238660,140560,23820,0,1384274,164380,0.118748166909152,0.0453185809553118,0.0189300994199446
SOM,Juba hoose,2022,724074,362050,331950,110730,2790,1531594,445470,0.29085384246739,0.12226477774136,0.0580353975444319
SOM,Kismaayo,2017,110658,53702,66294,24410,0,255064,90704,0.355612708967161,0.150438059990172,0.0714130135530255
SOM,Kismaayo,2018,100894,50090,66401,11310,0,228695,77711,0.339801919587223,0.129752144413593,0.0542406067275435
SOM,Kismaayo,2019,115040,79943,42896,25348,0,263227,68244,0.259259118555467,0.118518743644586,0.0609056061878151
SOM,Kismaayo,2020,255437,94413,71754,15106,0,436710,86860,0.198896292734309,0.0778289177409875,0.0336297415778078
SOM,Kismaayo,2021,219453,89500,103300,5200,0,417453,108500,0.259909498793876,0.0907886636339899,0.0330309972353508
SOM,Kurtunwaarey,2017,234123,60332,57709,2623,0,354787,60332,0.17005132657059,0.0591481649553112,0.0213589812729578
SOM,Kurtunwaarey,2018,234776,57740,57709,2623,0,352848,60332,0.170985806919693,0.0594732009250442,0.0214763549428901
SOM,Kurtunwaarey,2019,223832,84902,28301,10291,0,347326,38592,0.111111750919885,0.0469136584457637,0.0222221582413448
SOM,Kurtunwaarey,2020,153841,43366,10480,500,0,208187,10980,0.0527410453102259,0.018380910751712,0.00666067846055069
SOM,Kurtunwaarey,2021,126948,48200,23500,100,0,198748,23600,0.118743333266247,0.0397488276611589,0.0133614202686596
SOM,Laas caanood,2017,86041,52989,83899,17208,0,240137,101107,0.421038823671488,0.164232639423884,0.0706684563857761
SOM,Laas caanood,2018,89208,53594,90327,14079,0,247208,104406,0.422340700948189,0.159764247111744,0.0659107580121463
SOM,Laas caanood,2019,105978,99355,59613,22079,0,287025,81692,0.284616322619981,0.120513311848561,0.0572652401552323
SOM,Laas caanood,2020,158859,62988,29586,15906,0,267339,45492,0.170165969050531,0.0765544869996521,0.0387398272106452
SOM,Laas caanood,2021,140540,56700,62900,15700,0,275840,78600,0.284947795823666,0.113954949729312,0.0506332173240526
SOM,Laasqoray,2017,298030,68466,60411,33440,0,460347,93851,0.203870124058591,0.0921703265869732,0.046865854573953
SOM,Laasqoray,2018,158502,55964,71657,40605,0,326728,112262,0.343594672020763,0.155957452886397,0.0796030813262272
SOM,Laasqoray,2019,136070,136070,54905,23872,0,350917,78777,0.224488981725023,0.0975054880023861,0.0476190476190476
SOM,Laasqoray,2020,176748,63762,36854,18726,0,296090,55580,0.187713195312236,0.0836524930482849,0.0419384496455657
SOM,Laasqoray,2021,147497,63100,73400,25900,0,309897,99300,0.320429045779727,0.134668400576105,0.0634619459583883
SOM,Lower Juba,2022,766254,339750,298050,83930,0,1487984,381980,0.2567097495672,0.104371641988982,0.0473250309740487
SOM,Lower Shabelle,2022,968744,263030,202030,39890,0,1473694,241920,0.164158909515815,0.0637423146641478,0.0272625569939666
SOM,Lughaye,2017,51418,28838,36295,12098,0,128649,48393,0.376163048294196,0.15673395569858,0.0731421671887591
SOM,Lughaye,2018,52426,28703,40670,36295,0,158094,76965,0.486830619757866,0.23880307496384,0.130618492795426
SOM,Lughaye,2019,43754,42760,30827,15911,0,133252,46738,0.350748956863687,0.156718098039804,0.0787738854034294
SOM,Lughaye,2020,60486,32971,26500,5949,0,125906,32449,0.257724016329643,0.101657850565766,0.0443858469369565
SOM,Lughaye,2021,64457,24900,19800,12800,0,121957,32600,0.267307329632575,0.124087451588128,0.0646858227808891
SOM,Luuq,2017,50155,18808,13235,1393,0,83591,14628,0.174994915720592,0.0638864630562301,0.0249987040072097
SOM,Luuq,2018,61301,14629,2583,0,0,78513,2583,0.0328990103549731,0.010966336784991,0.00365544559499701
SOM,Luuq,2019,36715,21523,2532,844,0,61614,3376,0.0547927419093063,0.0228303091288776,0.0106541442601429
SOM,Luuq,2020,30507,15864,4171,313,0,50855,4484,0.0881722544489234,0.0314423360534854,0.0118485017315024
SOM,Luuq,2021,25576,10800,6000,800,0,43176,6800,0.157494904576617,0.0586745722932493,0.0236757046095567
SOM,Marka,2017,172188,41643,33711,1983,0,249525,35694,0.143047790802525,0.0503316300971847,0.018543232141068
SOM,Marka,2018,172130,72581,9915,1983,0,256609,11898,0.0463662615107031,0.018031323920829,0.00772771025178384
SOM,Marka,2019,180104,100938,15833,5938,0,302813,21771,0.0718958565187096,0.0305017728212902,0.0145249158171325
SOM,Marka,2020,135150,39674,17182,4200,0,196206,21382,0.108977299369031,0.0434611241926003,0.019243946555038
SOM,Marka,2021,123336,45200,25300,2000,0,195836,27300,0.139402357074287,0.0498716613220586,0.0188933597499949
SOM,Middle Juba,2022,333768,258800,313720,149940,0,1056228,463660,0.438977190530832,0.19364505895823,0.0960945721736006
SOM,Middle Shabelle,2022,598755,174010,170850,85370,2030,1031015,258250,0.250481321804241,0.112407029319004,0.0571820541462108
SOM,Mudug,2021,236160,91250,76160,15980,0,419550,92140,0.219616255511858,0.0859015611965201,0.0370979488605517
SOM,Mudug,2022,560536,429400,409360,60010,0,1459306,469370,0.321639190135585,0.120920492343621,0.0494451167579353
SOM,Nugaal,2021,590525,141850,182220,47960,0,962555,230180,0.23913438712593,0.0963200371234198,0.0431790622065464
SOM,Nugaal,2022,418945,227420,239990,94380,0,980735,334370,0.34093817392058,0.145724040303106,0.0699600016540882
SOM,Owdweyne,2017,66896,31921,34462,16217,0,149496,50679,0.338999036763525,0.149158951856014,0.0738258325752306
SOM,Owdweyne,2018,62513,33246,25340,11149,0,132248,36489,0.275913435363862,0.120072389248483,0.0587582925009578
SOM,Owdweyne,2019,45886,55861,18953,0,0,120700,18953,0.157025683512842,0.0523418945042806,0.0174472981680935
SOM,Owdweyne,2020,65838,23594,9612,2757,0,101801,12369,0.12150175342089,0.0495280007072622,0.0225276110581756
SOM,Owdweyne,2021,54686,21400,16100,1600,0,93786,17700,0.188727528629006,0.0685958814037632,0.0266564305973173
SOM,Qandala,2017,33236,16618,16154,3648,0,69656,19802,0.284282760996899,0.112218138662379,0.0490441917741791
SOM,Qandala,2018,33737,16508,13549,7817,0,71611,21366,0.298361983494156,0.135840396959499,0.0695377339607975
SOM,Qandala,2019,32733,19136,7050,2014,0,60933,9064,0.148753548980027,0.0606020820682826,0.0275457378504988
SOM,Qandala,2020,34135,15282,7913,3364,0,60694,11277,0.185800902889907,0.0804088267923243,0.039119737261234
SOM,Qandala,2021,32715,13200,10200,800,0,56915,11000,0.1932706667838,0.0691089050923892,0.0261598680293225
SOM,Qansax dheere,2017,57405,25050,28181,22962,0,133598,51143,0.382812616955344,0.184895482467302,0.0998260120327816
SOM,Qansax dheere,2018,73061,20875,30268,0,0,124204,30268,0.243695855205952,0.0812319517353172,0.0270773172451057
SOM,Qansax dheere,2019,50635,17341,17341,7630,0,92947,24971,0.268658482791268,0.116916091966389,0.0572142069016632
SOM,Qansax dheere,2020,51409,17879,9291,1002,0,79581,10293,0.12933991781958,0.0473102876314698,0.0185680836715631
SOM,Qansax dheere,2021,48439,10100,9300,1000,0,68839,10300,0.149624486119787,0.0547170450858767,0.0214671592814797
SOM,Qardho,2017,54776,27388,10271,5135,0,97570,15406,0.157896894537255,0.0701752587885621,0.0350870600025053
SOM,Qardho,2018,60767,26532,8185,3424,0,98908,11609,0.117371698952562,0.0506632426092935,0.0245806428420575
SOM,Qardho,2019,55530,31386,11267,805,0,98988,12072,0.12195417626379,0.0433621583760995,0.0162612303174796
SOM,Qardho,2020,44399,17137,9881,4333,0,75750,14214,0.187643564356436,0.0816149614961496,0.0399163916391639
SOM,Qardho,2021,35446,16000,17400,6400,0,75246,23800,0.316295882837626,0.1337834126288,0.0634954386648829
SOM,Qoryooley,2017,259695,67251,46783,0,0,373729,46783,0.12517893982003,0.0417263132733433,0.0139087710911144
SOM,Qoryooley,2018,260271,66019,43859,0,0,370149,43859,0.118490121545648,0.0394967071818826,0.0131655690606275
SOM,Qoryooley,2019,248404,101620,31050,11291,0,392365,42341,0.107912275559747,0.0455630174284998,0.0215825117485561
SOM,Qoryooley,2020,163033,47788,14701,1000,0,226522,15701,0.0693133558771334,0.0245759793750717,0.00917301140237544
SOM,Qoryooley,2021,140073,53800,26800,300,0,220973,27100,0.122639417485394,0.0413323498044256,0.0140791459187824
SOM,Rab dhuure,2020,30347,3608,2268,0,0,36223,2268,0.062612152499793,0.020870717499931,0.00695690583331033
SOM,Rab dhuure,2021,26186,5700,4600,100,0,36586,4700,0.128464439949708,0.0437325753020281,0.0151849219798709
SOM,Saakow,2017,58328,23331,15032,0,0,96691,15032,0.155464314155402,0.0518214380518008,0.0172738126839336
SOM,Saakow,2018,68831,23885,4362,0,0,97078,4362,0.0449329405220544,0.0149776468406848,0.00499254894689494
SOM,Saakow,2019,63327,25831,14165,833,0,104156,14998,0.143995545143823,0.0506643880333346,0.018665378001374
SOM,Saakow,2020,41173,14985,8631,1516,0,66305,10147,0.153035216047055,0.058633084483322,0.0246252586950875
SOM,Saakow,2021,41740,12600,10400,0,0,64740,10400,0.160642570281125,0.0535475234270415,0.0178491744756805
SOM,Sablaale,2017,22458,5862,3517,0,0,31837,3517,0.110468951220278,0.0368229837400928,0.0122743279133643
SOM,Sablaale,2018,22443,7382,4220,0,0,34045,4220,0.123953590835659,0.0413178636118862,0.0137726212039621
SOM,Sablaale,2019,22707,10730,2246,749,0,36432,2995,0.0822079490557751,0.0342555994729908,0.0159871663494852
SOM,Sablaale,2020,15469,4447,1713,300,0,21929,2013,0.0917962515390579,0.0351589219754663,0.0147597549667868
SOM,Sablaale,2021,14213,5200,2500,100,0,22013,2600,0.11811202471267,0.0408849316313088,0.0146378150284933
SOM,Sanaag,2021,734116,363620,234980,21090,0,1353806,256070,0.189148223600723,0.068242175516039,0.0262092369381006
SOM,Sanaag,2022,348336,405290,466730,229110,29220,1478686,725060,0.490340748475336,0.228267980265362,0.123694655630442
SOM,Shabelle dhexe,2021,300893,153050,95460,7640,0,557043,103100,0.185084454880503,0.0662665778644258,0.0251366990020918
SOM,Shabelle dhexe,2022,171983,156000,185560,99330,2340,615213,287230,0.466878950867423,0.211980782807472,0.109075140552044
SOM,Shabelle hoose,2021,223943,84270,94640,22570,0,425423,117210,0.275514017812859,0.109522365582804,0.0482970282910578
SOM,Shabelle hoose,2022,159713,79060,121190,47450,0,407413,168640,0.413928863340149,0.176798482129927,0.0848142902765608
SOM,Sheikh,2017,48579,26566,18217,1518,0,94880,19735,0.20799957841484,0.0746662450815065,0.0284441165448754
SOM,Sheikh,2018,44783,26566,11386,759,0,83494,12145,0.145459553979927,0.0515166758489632,0.0191923305200906
SOM,Sheikh,2019,26386,32983,9895,1319,0,70583,11214,0.158876783361433,0.0591880008878436,0.0238820490297475
SOM,Sheikh,2020,52725,17847,7852,2231,0,80655,10083,0.125013948298308,0.0508916578844048,0.0231107804847809
SOM,Sheikh,2021,43387,17600,11200,3300,0,75487,14500,0.192086054552439,0.0786007303685844,0.0359149404680423
SOM,Sool,2021,263517,119340,81690,22260,0,486807,103950,0.213534316474496,0.086420285657355,0.0389682153296892
SOM,Sool,2022,283997,104740,169330,76210,0,634277,245540,0.387117931124729,0.169090160923382,0.0830639540067755
SOM,Taleex,2017,33823,19853,21323,13235,0,88234,34558,0.39166307772514,0.180553981458395,0.0935177419639192
SOM,Taleex,2018,33823,18382,22794,13235,0,88234,36029,0.408334655574948,0.186111174074998,0.0953701395027868
SOM,Taleex,2019,11557,20031,16950,2697,0,51235,19647,0.383468332194789,0.14536937640285,0.0601541914706743
SOM,Taleex,2020,39558,12391,6939,4036,0,62924,10975,0.174416756722395,0.0795192083571716,0.0407599290855282
SOM,Taleex,2021,33457,13300,14100,4500,0,65357,18600,0.284590785990789,0.11781446516823,0.0545720682813879
SOM,Tayeeglow,2017,49633,14735,17682,12525,0,94575,30207,0.319397303727201,0.150610626486915,0.0796334478808706
SOM,Tayeeglow,2018,51573,16209,12525,0,0,80307,12525,0.155963988195301,0.0519879960651002,0.0173293320217001
SOM,Tayeeglow,2019,49005,16963,8168,5654,0,79790,13822,0.173229728036095,0.0813635793959143,0.0428680842767821
SOM,Tayeeglow,2020,45527,9616,5882,990,0,62015,6872,0.11081190034669,0.042258593351071,0.017633726607362
SOM,Tayeeglow,2021,37534,11700,7800,1000,0,58034,8800,0.151635248302719,0.0562888421729791,0.0225921203279304
SOM,Togdheer,2021,327484,180600,175600,87430,0,771114,263030,0.341103909408985,0.1514951096725,0.0756942409149476
SOM,Togdheer,2022,477824,188470,223020,67090,0,956404,290110,0.303334155858821,0.124494111972207,0.0570865217813579
SOM,Waajid,2017,84437,29370,42677,27615,0,184099,70292,0.381816305357444,0.177272373378816,0.0924243055216064
SOM,Waajid,2018,90375,31988,22594,0,0,144957,22594,0.155866912256738,0.0519556374189127,0.0173185458063042
SOM,Waajid,2019,95451,40383,13461,8566,0,157861,22027,0.139534147129437,0.0645990248805384,0.0335914366295524
SOM,Waajid,2020,57746,13481,8059,2110,0,81396,10169,0.124932429111996,0.0502850262912182,0.0225222642663303
SOM,Waajid,2021,50175,14900,11600,1800,0,78475,13400,0.170755017521504,0.0645640862270362,0.0266185267778132
SOM,Wanla weyn,2017,98122,25998,6782,0,0,130902,6782,0.0518097508059464,0.0172699169353155,0.00575663897843849
SOM,Wanla weyn,2018,98340,22353,3391,0,0,124084,3391,0.027328261500274,0.00910942050009134,0.00303647350003045
SOM,Wanla weyn,2019,96012,33763,7386,2110,0,139271,9496,0.0681836132432452,0.0277779772290474,0.012626063174993
SOM,Wanla weyn,2020,57155,13689,6072,0,0,76916,6072,0.0789432627801758,0.0263144209267253,0.00877147364224175
SOM,Wanla weyn,2021,49259,14400,7800,300,0,71759,8100,0.112877827171505,0.039019495812372,0.0139355342187043
SOM,Woqooyi galbeed,2021,835855,269410,141570,62330,0,1309165,203900,0.155748129532947,0.0677862097851175,0.0331755143333516
SOM,Woqooyi galbeed,2022,833545,342370,404730,65910,0,1646555,470640,0.285833148604207,0.108620726304314,0.0451022488367126
SOM,Xarardheere,2017,36892,11593,10912,2078,0,61475,12990,0.211305408702725,0.081702589128372,0.0347458316388776
SOM,Xarardheere,2018,37932,11427,8833,520,0,58712,9353,0.159303038561112,0.0560532770132171,0.0206526017774144
SOM,Xarardheere,2019,29323,6137,2046,0,0,37506,2046,0.0545512717965126,0.0181837572655042,0.00606125242183473
SOM,Xarardheere,2020,27427,8203,4859,114,0,40603,4973,0.122478634583651,0.0417621029644772,0.0145446286125546
SOM,Xarardheere,2021,18048,8400,6800,3100,0,36348,9900,0.27236711786068,0.119217930376729,0.0586919041854664
SOM,Xudun,2017,17655,11130,15786,6141,0,50712,21927,0.432382867960246,0.184492822211705,0.0884077404427617
SOM,Xudun,2018,17655,9595,15932,6141,0,49323,22073,0.447519412849989,0.190675073833033,0.091226315421924
SOM,Xudun,2019,6139,14617,15786,1169,0,37711,16955,0.449603563946859,0.160200825576976,0.0602889224776738
SOM,Xudun,2020,25512,8427,4480,3233,0,41652,7713,0.185177182368194,0.087598834789846,0.0464483498191363
SOM,Xudun,2021,20633,8300,9500,2500,0,40933,12000,0.293161996433196,0.118079137452259,0.0529320271337715
SOM,Xudur,2017,75488,33550,40294,23958,0,173290,64252,0.370777309712043,0.169677034643276,0.0872820769294888
SOM,Xudur,2018,75660,34167,25047,0,0,134874,25047,0.185706659548912,0.0619022198496374,0.0206340732832125
SOM,Xudur,2019,91065,41938,15577,10784,0,159364,26361,0.165413769734695,0.0776942513156464,0.0409356358190474
SOM,Xudur,2020,63385,17159,10316,3101,0,93961,13417,0.142793286576346,0.0585987803450368,0.0268669388836267
SOM,Xudur,2021,54232,18200,14800,2900,0,90132,17700,0.196378644654507,0.0761845589431796,0.032544860131067
SOM,Zeylac,2017,36167,20736,30011,15360,0,102274,45371,0.443622034925788,0.197935610875361,0.0993529364474082
SOM,Zeylac,2018,35066,20454,30853,30011,0,116384,60864,0.522958482265604,0.260273462560719,0.144060466501696
SOM,Zeylac,2019,37632,32256,22272,13824,0,105984,36096,0.340579710144928,0.157004830917874,0.0813204508856683
SOM,Zeylac,2020,44423,24433,19717,5098,0,93671,24815,0.264916569696064,0.106447032699555,0.0475766838782073
SOM,Zeylac,2021,47425,18200,14200,9900,0,89725,24100,0.268598495402619,0.126311878889198,0.0666233243552831
SSD,Abiemnhom,2017,11026,13093,6902,3944,0,34965,10846,0.31019591019591,0.140998140998141,0.072065716510161
SSD,Abiemnhom,2018,8958,24050,13039,2898,0,48945,15937,0.325610378996833,0.128273231858889,0.055915369859593
SSD,Abiemnhom,2019,8136,24407,21695,5424,0,59662,27119,0.454543930810231,0.181818689729923,0.0808089273276495
SSD,Abiemnhom,2020,8136,18983,28000,11000,0,66119,39000,0.589845581451625,0.252070761304113,0.120993965425974
SSD,Abiemnhom,2021,6000,14000,31000,11000,0,62000,42000,0.67741935483871,0.28494623655914,0.134408602150538
SSD,Abiemnhom,2022,8547,17094,22792,11396,0,59829,34188,0.571428571428571,0.253968253968254,0.126984126984127
SSD,Akobo,2017,35908,107724,80793,41515,0,265940,122308,0.459908249981199,0.205338296858941,0.103136463529785
SSD,Akobo,2018,20148,73267,111732,54950,0,260097,166682,0.640845530705852,0.284037621861588,0.141627503926954
SSD,Akobo,2019,22544,78904,123991,45088,0,270527,169079,0.624998613816736,0.263888632188284,0.125000051340121
SSD,Akobo,2020,22544,56360,112720,88000,22544,302168,223264,0.738873739112017,0.393105821926875,0.245491102815505
SSD,Akobo,2021,11000,22000,111000,77000,11000,232000,199000,0.857758620689655,0.42816091954023,0.248084291187739
SSD,Akobo,2022,33982,56637,90619,67964,0,249202,158583,0.636363271562829,0.303029938229495,0.1616158778822
SSD,Aweil centre,2017,28091,61800,50563,59552,0,200006,110115,0.550558483245503,0.282769850237826,0.160423520627715
SSD,Aweil centre,2018,38484,54977,50579,21991,0,166031,72570,0.437087050008733,0.189846072922125,0.0927156173646287
SSD,Aweil centre,2019,28525,39935,57050,11859,0,137369,68909,0.501634284299951,0.195987935172176,0.084513649772187
SSD,Aweil centre,2020,15812,35577,35577,11859,0,98825,47436,0.48,0.2,0.0933333333333333
SSD,Aweil centre,2021,11000,19000,41000,11000,0,82000,52000,0.634146341463415,0.25609756097561,0.115176151761518
SSD,Aweil centre,2022,15194,26590,34187,11395,0,87366,45582,0.52173614449557,0.217388152523102,0.101446787079642
SSD,Aweil east,2017,83715,187218,273469,195335,0,739737,468804,0.633744155017256,0.299268073202593,0.158436038754314
SSD,Aweil east,2018,137739,198344,275478,165287,0,776848,440765,0.567376114761189,0.260047439567758,0.133963858509716
SSD,Aweil east,2019,67040,171518,228691,171518,0,638767,400209,0.626533618674728,0.298349267677677,0.159119574638849
SSD,Aweil east,2020,67040,135000,167601,67040,0,436681,234641,0.537328164037364,0.230283280777807,0.110877022102837
SSD,Aweil east,2021,34000,118000,168000,67000,0,387000,235000,0.607235142118863,0.260120585701981,0.1251794430089
SSD,Aweil east,2022,51732,86221,155198,86221,0,379372,241419,0.63636483451599,0.287879267139729,0.146464859469509
SSD,Aweil north,2017,56372,98651,136060,84558,0,375641,220618,0.587310756813021,0.270804660123185,0.14029115860918
SSD,Aweil north,2018,56057,126128,149666,56057,0,387908,205723,0.530339668168741,0.224950245934603,0.10709698634155
SSD,Aweil north,2019,43628,101798,130883,58170,0,334479,189053,0.565216351400237,0.246376204983472,0.120772571338975
SSD,Aweil north,2020,23832,66000,71496,39720,0,201048,111216,0.553181329831682,0.250248696828618,0.127319512421578
SSD,Aweil north,2021,16000,49000,74000,41000,0,180000,115000,0.638888888888889,0.288888888888889,0.146913580246914
SSD,Aweil north,2022,33698,42123,67397,33698,0,176916,101095,0.571429378914287,0.253967984806349,0.126983678380952
SSD,Aweil south,2017,22885,53398,80016,45770,0,202069,125786,0.622490337458987,0.282999041581506,0.144667855479509
SSD,Aweil south,2018,29970,59939,82416,29970,0,202295,112386,0.555555006302677,0.234568328431251,0.11111166036399
SSD,Aweil south,2019,27692,54424,85524,31099,0,198739,116623,0.586814867741108,0.247765494777908,0.11736219083544
SSD,Aweil south,2020,20769,48461,62307,35000,0,166537,97307,0.584296582741373,0.264820029983327,0.134976344929689
SSD,Aweil south,2021,14000,21000,62000,42000,7000,146000,111000,0.76027397260274,0.381278538812785,0.222983257229833
SSD,Aweil south,2022,21292,35487,70974,28389,0,156142,99363,0.636363054143024,0.272726108286047,0.131312096254264
SSD,Aweil west,2017,46983,93967,166025,75173,0,382148,241198,0.631163842281001,0.275958529156243,0.135699897538243
SSD,Aweil west,2018,77730,93276,171005,62184,0,404195,233189,0.576922030208192,0.243589521559313,0.115384625957493
SSD,Aweil west,2019,48396,96792,161320,64528,0,371036,225848,0.608695652173913,0.260869565217391,0.1256038647343
SSD,Aweil west,2020,35296,94122,105887,47061,0,282366,152948,0.541665781290949,0.236110815985872,0.115740642365661
SSD,Aweil west,2021,20000,60000,89000,40000,0,209000,129000,0.617224880382775,0.269537480063796,0.13237639553429
SSD,Aweil west,2022,30578,61157,91735,40771,0,224241,132506,0.590908888205101,0.257575554871767,0.126262468603967
SSD,Awerial,2017,48595,48595,36446,24297,0,157933,60743,0.384612462246649,0.179485393595174,0.0940159575403635
SSD,Awerial,2018,44060,54669,73433,44060,0,216222,117493,0.543390589301736,0.249054212799808,0.128300748510533
SSD,Awerial,2019,33219,46506,68581,38101,0,186407,106682,0.572306833970827,0.258901221520651,0.131721925082689
SSD,Awerial,2020,19931,46506,61000,26575,0,154012,87575,0.56862452276446,0.247058670752928,0.12069766569416
SSD,Awerial,2021,27000,75000,61000,7000,0,170000,68000,0.4,0.147058823529412,0.0581699346405229
SSD,Awerial,2022,20945,55855,55855,13963,0,146618,69818,0.476189826624289,0.190474566560722,0.0846546050886582
SSD,Ayod,2017,26732,62374,98017,83167,17821,288111,199005,0.690723367035622,0.367698560624204,0.22794995293095
SSD,Ayod,2018,25699,68530,94228,68530,25699,282686,188457,0.666665487502034,0.363636685226718,0.235691033710745
SSD,Ayod,2019,36374,62224,106670,27280,0,232548,133950,0.576010114040972,0.231106409572791,0.10310416200813
SSD,Ayod,2020,28000,54560,81841,72747,9093,246241,163681,0.664718710531552,0.344667757738692,0.205158541609417
SSD,Ayod,2021,19000,28000,76000,76000,0,199000,152000,0.763819095477387,0.381909547738693,0.212171970965941
SSD,Ayod,2022,9701,19403,87313,87313,9701,213431,184327,0.86363742848977,0.454545028604092,0.272726184210458
SSD,Baliet,2017,10196,35047,29312,10196,0,84751,39508,0.466165590966478,0.195490318698304,0.0918979651501982
SSD,Baliet,2018,4929,16760,25139,6901,0,53729,32040,0.596326006439725,0.241588961888986,0.109072071569047
SSD,Baliet,2019,13515,18920,28133,8184,0,68752,36317,0.528231905980917,0.215756147699946,0.0983712797041864
SSD,Baliet,2020,10812,18920,25000,10812,0,65544,35812,0.546381056999878,0.237112982627446,0.115694969960807
SSD,Baliet,2021,8000,17000,28000,11000,0,64000,39000,0.609375,0.260416666666667,0.125
SSD,Baliet,2022,8663,14439,23102,17327,0,63531,40429,0.636366498244951,0.303033164911618,0.161618387523851
SSD,Bor south,2017,59535,162645,151814,59535,0,433529,211349,0.487508332775893,0.208278262046291,0.0999430769849819
SSD,Bor south,2018,59830,143592,119660,47864,0,370946,167524,0.451612903225806,0.193548387096774,0.0931899641577061
SSD,Bor south,2019,32758,131033,163792,62086,0,389669,225878,0.57966633219476,0.246332143434556,0.117517402946832
SSD,Bor south,2020,65517,114654,180171,116000,0,476342,296171,0.621761255568478,0.288427922235145,0.150258754331039
SSD,Bor south,2021,17000,33000,149000,149000,0,348000,298000,0.85632183908046,0.42816091954023,0.23786717752235
SSD,Bor south,2022,50942,67923,169808,67923,0,356596,237731,0.666667601431312,0.285714552789899,0.137566196916274
SSD,Budi,2017,41538,56715,40860,18160,0,157273,59020,0.375271025541574,0.163579677800173,0.0801861165687124
SSD,Budi,2018,28057,51438,37410,18705,0,135610,56115,0.413796917631443,0.18390974116953,0.0919548705847651
SSD,Budi,2019,24263,38820,54583,34735,0,152401,89318,0.586072269866996,0.271330240615219,0.141091958422553
SSD,Budi,2020,29773,41000,59545,19848,0,150166,79393,0.528701570262243,0.220291766001181,0.102802528165127
SSD,Budi,2021,26000,46000,26000,20000,0,118000,46000,0.389830508474576,0.186440677966102,0.0998116760828625
SSD,Budi,2022,26196,36675,36675,15718,0,115264,52393,0.454547820655192,0.196971011475106,0.0959603846628416
SSD,Canal/pigi,2017,12632,37895,69473,37895,0,157895,107368,0.679996200006333,0.30666582222363,0.155555555555556
SSD,Canal/pigi,2018,9864,44386,54250,34523,4932,147955,93705,0.633334459801967,0.311112613069289,0.177779279735956
SSD,Canal/pigi,2019,14967,46060,49891,56295,10236,177449,116422,0.656087101082565,0.362900514138335,0.229922087159941
SSD,Canal/pigi,2020,10000,24945,49891,31000,0,115836,80891,0.698323491833282,0.321981076694637,0.166798078509464
SSD,Canal/pigi,2021,10000,16000,47000,36000,0,109000,83000,0.761467889908257,0.363914373088685,0.194699286442406
SSD,Canal/pigi,2022,5321,10642,42570,47891,10642,117066,101103,0.86364102301266,0.484849002556962,0.313130105144866
SSD,Cueibet,2017,73611,82812,53368,36378,0,246169,89746,0.364570681117444,0.17078240287499,0.0897666959600022
SSD,Cueibet,2018,54567,74939,103041,46837,0,279384,149878,0.536458780746213,0.234700865714095,0.115487803326047
SSD,Cueibet,2019,34743,52115,116647,58323,9721,271549,184691,0.680138759487238,0.322171443582312,0.178984680890414
SSD,Cueibet,2020,26057,60800,104229,36000,0,227086,140229,0.617514950283153,0.25868173291176,0.121456188404393
SSD,Cueibet,2021,27000,54000,80000,36000,0,197000,116000,0.588832487309645,0.257191201353638,0.12633953750705
SSD,Cueibet,2022,27498,36665,73330,54997,9166,201656,137493,0.681819534256357,0.348484547943032,0.207069905625862
SSD,Duk,2017,18482,61607,67767,61607,0,209463,129374,0.617646075917943,0.303921615432479,0.166666931895158
SSD,Duk,2018,11579,46317,69476,40528,0,167900,110004,0.655175699821322,0.298852491562438,0.153257891602144
SSD,Duk,2019,18996,42056,104477,47490,0,213019,151967,0.713396457592985,0.312111439198694,0.15357889306692
SSD,Duk,2020,19000,37992,104477,68000,9498,238967,181975,0.761506818933158,0.375185695095976,0.214794418383198
SSD,Duk,2021,10000,29000,97000,78000,0,214000,175000,0.817757009345795,0.394080996884735,0.212357217030114
SSD,Duk,2022,29855,49759,99519,39807,0,218940,139326,0.636366127706221,0.272727687951037,0.13131299290521
SSD,Ezo,2017,41969,53807,46752,5118,0,147646,51870,0.351313276350189,0.128659089985506,0.0505894730187972
SSD,Ezo,2018,36897,70632,52711,5271,0,165511,57982,0.350321126692486,0.127389317527737,0.0495401782627405
SSD,Ezo,2019,54698,71694,43758,5470,0,175620,49228,0.280309759708461,0.103818851307748,0.0415277935947564
SSD,Ezo,2020,65720,77669,23898,0,0,167287,23898,0.142856288892741,0.0476187629642471,0.0158729209880824
SSD,Ezo,2021,78000,52000,6000,0,0,136000,6000,0.0441176470588235,0.0147058823529412,0.00490196078431373
SSD,Ezo,2022,53098,46461,26549,19912,0,146020,46461,0.31818244076154,0.151515774094873,0.0808085650367529
SSD,Fangak,2017,24908,64760,126110,42037,0,257815,168147,0.652200221088765,0.271750415349508,0.126817032885338
SSD,Fangak,2018,17241,60342,115601,77583,8620,279387,201804,0.722309914205027,0.353902173926012,0.200245139855787
SSD,Fangak,2019,48263,67569,107344,53672,0,276848,161016,0.581604346067156,0.258490820474292,0.129245410237146
SSD,Fangak,2020,28958,57916,86874,58000,0,231748,144874,0.625135923503115,0.291802590169782,0.152883496057979
SSD,Fangak,2021,19000,38000,86000,67000,0,210000,153000,0.728571428571429,0.349206349206349,0.187301587301587
SSD,Fangak,2022,0,29486,68802,94356,23589,216233,186747,0.863637835113049,0.506060592046542,0.338383441318701
SSD,Fashoda,2017,12782,22038,25564,10578,0,70962,36142,0.509314844564697,0.219460180566125,0.106279103996192
SSD,Fashoda,2018,5204,18923,18923,8989,0,52039,27912,0.536366955552566,0.236367596097798,0.117174939308339
SSD,Fashoda,2019,11021,22043,28656,14695,0,76415,43351,0.567310083098868,0.253205086261423,0.127136178906119
SSD,Fashoda,2020,15000,25717,33064,14695,0,88476,47759,0.539796102897961,0.235295447352954,0.115340757820074
SSD,Fashoda,2021,11000,26000,30000,19000,0,86000,49000,0.569767441860465,0.263565891472868,0.136950904392765
SSD,Fashoda,2022,19160,19160,26824,19160,0,84304,45984,0.545454545454545,0.257575757575758,0.136363636363636
SSD,Gogrial East,2018,13716,102866,48004,27431,0,192017,75435,0.392855840889088,0.178570994582077,0.0912696966067241
SSD,Gogrial East,2019,25396,92512,71163,28465,0,217536,99628,0.457983965872315,0.196278623614789,0.0945044089764964
SSD,Gogrial East,2020,50791,63489,45000,26000,0,185280,71000,0.383203799654577,0.17451065054692,0.0893542506236807
SSD,Gogrial East,2021,26000,38000,45000,26000,0,135000,71000,0.525925925925926,0.239506172839506,0.122633744855967
SSD,Gogrial East,2022,26176,32720,58896,26176,0,143968,85072,0.590909090909091,0.257575757575758,0.126262626262626
SSD,Gogrial West,2018,34095,255714,136381,68190,0,494380,204571,0.413793033698774,0.183907790228839,0.0919537827402223
SSD,Gogrial West,2019,106142,212284,141522,70761,0,530709,212283,0.399998869436923,0.177777275305299,0.0888886376526496
SSD,Gogrial West,2020,94309,141463,111000,64000,0,410772,175000,0.426027090454072,0.193943761178139,0.0992710744105679
SSD,Gogrial West,2021,64000,95000,127000,64000,0,350000,191000,0.545714285714286,0.242857142857143,0.121587301587302
SSD,Gogrial West,2022,48888,97777,114073,97777,0,358515,211850,0.590909724837176,0.287879168235639,0.1565658960496
SSD,Gogrial east,2017,44995,82491,65993,29270,0,222749,95263,0.427669708954922,0.186357738979749,0.0913200258786546
SSD,Gogrial east,2018,24688,56234,61720,27431,0,170073,89151,0.524192552609762,0.228494038834304,0.112006804921024
SSD,Gogrial west,2017,118245,168921,148650,104962,0,540778,253612,0.468976178764669,0.221023537693225,0.116806609078854
SSD,Gogrial west,2018,52481,174937,153428,68190,0,449036,221618,0.493541720485663,0.215133456263343,0.105457518377641
SSD,Guit,2017,4943,14829,35004,11863,0,66639,46867,0.703296868200303,0.293771915344868,0.137483722411467
SSD,Guit,2018,8089,13867,31220,1892,0,55068,33112,0.601292946902012,0.211883489503886,0.0782628346367723
SSD,Guit,2019,7296,19897,29846,9993,0,67032,39839,0.594328082110037,0.247802044794526,0.115729137658962
SSD,Guit,2020,7000,23213,33162,14000,0,77375,47162,0.609525040387722,0.263487345180398,0.128037336205349
SSD,Guit,2021,10000,24000,31000,10000,0,75000,41000,0.546666666666667,0.226666666666667,0.105185185185185
SSD,Guit,2022,10482,20965,34942,17471,0,83860,52413,0.625005962318149,0.277780427696955,0.138890213848478
SSD,Ibba,2017,38996,17869,3872,0,0,60737,3872,0.0637502675469648,0.0212500891823216,0.00708336306077386
SSD,Ibba,2018,29178,20109,26024,0,0,75311,26024,0.345553770365551,0.11518459012185,0.0383948633739501
SSD,Ibba,2019,15720,37727,18863,3144,0,75454,22007,0.291661144538394,0.111109638543572,0.0462960508683731
SSD,Ibba,2020,22007,34583,13000,3000,0,72590,16000,0.220416035266566,0.0872480139596822,0.0382666727893343
SSD,Ibba,2021,26000,36000,6000,0,0,68000,6000,0.0882352941176471,0.0294117647058824,0.00980392156862745
SSD,Ibba,2022,29889,29889,13284,0,0,73062,13284,0.181818181818182,0.0606060606060606,0.0202020202020202
SSD,Ikotos,2017,38920,53682,53977,23990,0,170569,77967,0.45709947294057,0.199248788857686,0.0976711282042262
SSD,Ikotos,2018,43241,74128,47980,12355,0,177704,60335,0.339525277990366,0.136350335389187,0.0609002736135496
SSD,Ikotos,2019,51282,57692,70513,12821,0,192308,83334,0.433336106662229,0.166668399997227,0.0703714874056202
SSD,Ikotos,2020,50991,40793,26000,5099,0,122883,31099,0.25307813123052,0.0981909621347135,0.0419513774168202
SSD,Ikotos,2021,21000,47000,36000,5000,0,109000,41000,0.376146788990826,0.140672782874618,0.0570846075433231
SSD,Ikotos,2022,26710,32052,42737,16026,0,117525,58763,0.500004254413955,0.212122243494292,0.101010186957858
SSD,Juba,2017,207453,152437,266081,57164,0,683135,323245,0.473178800676294,0.185619240706449,0.080468396111717
SSD,Juba,2018,76218,215889,176636,76218,0,544961,252854,0.463985496209821,0.201281681930756,0.0981737938841291
SSD,Juba,2019,199815,244394,183295,40732,0,668236,224027,0.335251318396495,0.132068610490904,0.0575683175139056
SSD,Juba,2020,224792,204000,224792,51000,0,704584,275792,0.3914252949258,0.154602810547311,0.0676194116749111
SSD,Juba,2021,153000,204000,204000,51000,0,612000,255000,0.416666666666667,0.166666666666667,0.0740740740740741
SSD,Juba,2022,104541,156812,235218,78406,0,574977,313624,0.545454861672728,0.227272859030303,0.106060667547475
SSD,Jur River,2018,39563,102864,39563,7913,0,189903,47476,0.250001316461562,0.0972233192735238,0.0416674711709545
SSD,Jur River,2019,73899,136559,163871,27312,0,401641,191183,0.476004690756173,0.181335238849287,0.0755564186812491
SSD,Jur River,2020,109247,150215,95591,14000,0,369053,109591,0.296951928313819,0.111628953023008,0.0456396356199366
SSD,Jur River,2021,83000,152000,97000,14000,0,346000,111000,0.320809248554913,0.120423892100193,0.0491329479768786
SSD,Jur River,2022,70807,127452,70807,42484,0,311550,113291,0.363636655432515,0.166666666666667,0.0858585210149967
SSD,Jur river,2017,62759,115057,92186,15364,0,285366,107550,0.376884422110553,0.143574684206715,0.0598225904043696
SSD,Jur river,2018,113942,63301,69139,23046,0,269428,92185,0.342150778686699,0.142562515155564,0.0665290087807421
SSD,Kajo-keji,2017,145935,83980,111973,55986,0,397874,167959,0.422141180373686,0.187618023126249,0.0938088719320969
SSD,Kajo-keji,2018,5504,47602,63470,38529,0,155105,101999,0.657612585023049,0.30200616786478,0.155870037859658
SSD,Kajo-keji,2019,44380,144236,54886,16466,0,259968,71352,0.274464549483013,0.112601038076481,0.0516089159691449
SSD,Kajo-keji,2020,45000,133141,110951,45000,0,334092,155951,0.466790584629384,0.200494674121699,0.0967634330929471
SSD,Kajo-keji,2021,68000,91000,91000,45000,0,295000,136000,0.461016949152542,0.204519774011299,0.102071563088512
SSD,Kajo-keji,2022,34899,58164,116329,34899,0,244291,151228,0.6190485936854,0.253968968702627,0.116402614550315
SSD,Kapoeta east,2017,42415,59381,105443,47588,7931,262758,160962,0.612586486424771,0.284687811598505,0.155264962859784
SSD,Kapoeta east,2018,32677,40847,79314,65354,0,218192,144668,0.663030725232822,0.320851971352448,0.173511810189599
SSD,Kapoeta east,2019,32203,50864,84773,42386,0,210226,127159,0.604868094336571,0.268829735617859,0.134414603543065
SSD,Kapoeta east,2020,33000,56355,80507,24152,0,194014,104659,0.539440452750832,0.221308771531951,0.1014331153651
SSD,Kapoeta east,2021,25000,41000,83000,25000,0,174000,108000,0.620689655172414,0.254789272030651,0.116858237547893
SSD,Kapoeta east,2022,33931,42414,67862,42414,0,186621,110276,0.590908847343011,0.27272743510466,0.141414357917324
SSD,Kapoeta north,2017,42801,42801,45222,30148,0,160972,75370,0.468218075193201,0.218501768423494,0.114453307269449
SSD,Kapoeta north,2018,20702,25877,51754,31052,0,129385,82806,0.639996908451521,0.293331272301014,0.151109737089565
SSD,Kapoeta north,2019,22853,53323,68558,45706,0,190440,114264,0.6,0.280000700133025,0.146667366799692
SSD,Kapoeta north,2020,38088,45706,69000,38000,0,190794,107000,0.560814281371532,0.253327323360972,0.128701927500632
SSD,Kapoeta north,2021,15000,38000,77000,38000,0,168000,115000,0.68452380952381,0.303571428571429,0.151455026455026
SSD,Kapoeta north,2022,31427,39284,54998,47141,0,172850,102139,0.590911194677466,0.287879664448944,0.15656606563173
SSD,Kapoeta south,2017,23077,33654,33654,14203,0,104588,47857,0.457576394997514,0.197791971035555,0.0961083277027745
SSD,Kapoeta south,2018,14218,16927,31822,13147,0,76114,44969,0.590811151693512,0.254512967391019,0.123221600348016
SSD,Kapoeta south,2019,19207,35130,52818,9603,0,116758,62421,0.534618612857363,0.205621884581785,0.0868177483912594
SSD,Kapoeta south,2020,20000,33612,48017,19207,0,120836,67224,0.556324274222914,0.23842508303265,0.11479746653867
SSD,Kapoeta south,2021,30000,25000,40000,20000,0,115000,60000,0.521739130434783,0.231884057971015,0.115942028985507
SSD,Kapoeta south,2022,20446,35781,40893,15335,0,112455,56228,0.500004446222934,0.212123367865665,0.101011268705013
SSD,Koch,2017,20189,40377,74025,56023,35014,225628,165062,0.731567004095236,0.430078122691628,0.301993152938071
SSD,Koch,2018,13459,43065,79978,49217,12304,198023,141499,0.71455840988168,0.362456212998827,0.217473054476837
SSD,Koch,2019,15831,42217,76609,31663,0,166320,108272,0.650986050986051,0.280453342953343,0.135789776067554
SSD,Koch,2020,10554,31663,52772,21109,0,116098,73881,0.636367551551276,0.272729360827347,0.131314349371508
SSD,Koch,2021,14000,24000,53000,14000,0,105000,67000,0.638095238095238,0.257142857142857,0.115343915343915
SSD,Koch,2022,4933,14799,44398,39465,0,103595,83863,0.809527486847821,0.396827388709236,0.216932391631943
SSD,Lafon,2017,34534,48010,67687,20721,0,170952,88408,0.51715101314989,0.2127868251517,0.0978643777850573
SSD,Lafon,2018,35880,56383,61508,10251,0,164022,71759,0.43749618953555,0.16666463441896,0.0694432589666156
SSD,Lafon,2019,44936,59915,59915,10638,0,175404,70553,0.402231420036031,0.154293326644014,0.0649085666360073
SSD,Lafon,2020,74894,52426,67405,14979,0,209704,82384,0.392858505321787,0.154762585994227,0.0674606959227186
SSD,Lafon,2021,61000,54000,38000,15000,0,168000,53000,0.31547619047619,0.134920634920635,0.0648148148148148
SSD,Lafon,2022,39213,47056,70584,23528,0,180381,94112,0.521740094577589,0.217391706073995,0.101449462834531
SSD,Lainya,2017,59051,56427,58901,37757,0,212136,96658,0.455641663838292,0.211208847154656,0.109955144079479
SSD,Lainya,2018,5013,35092,65171,32391,0,137667,97562,0.708681092781858,0.314655412456628,0.157170725171771
SSD,Lainya,2019,22056,60655,52022,10404,0,145137,62426,0.430117750814747,0.167267248645533,0.0716855262422554
SSD,Lainya,2020,22056,60655,44113,17000,0,143824,61113,0.42491517410168,0.181038398783699,0.0866128045388809
SSD,Lainya,2021,33000,44000,39000,17000,0,133000,56000,0.421052631578947,0.182957393483709,0.089390142021721
SSD,Lainya,2022,17056,45484,56856,5685,0,125081,62541,0.500003997409679,0.181818181818182,0.0707061823938088
SSD,Leer,2017,6736,26943,80828,47981,41984,204472,170793,0.83528796118784,0.493534567080089,0.353543652812012
SSD,Leer,2018,6736,26501,80828,47701,21200,182966,149729,0.81834329875496,0.436929994279447,0.280824488338453
SSD,Leer,2019,5912,27500,71499,32999,5500,143410,109998,0.767017641726518,0.357941101271413,0.19601530964058
SSD,Leer,2020,11000,26604,38000,11000,0,86604,49000,0.565793727772389,0.230936215417302,0.105204275912326
SSD,Leer,2021,11000,27000,42000,11000,0,91000,53000,0.582417582417583,0.234432234432234,0.105006105006105
SSD,Leer,2022,3883,11649,23299,42715,3883,85429,69897,0.818188203069215,0.469699984782685,0.297981039485681
SSD,Longochuk,2017,33619,46226,28922,13738,0,122505,42660,0.348230684461859,0.153457681999374,0.0760730854522945
SSD,Longochuk,2018,10846,21691,44684,37237,3724,118182,85645,0.724687346634851,0.367596870363789,0.213557620167764
SSD,Longochuk,2019,7728,23184,54097,19320,0,104329,73417,0.703706543722263,0.296296651298616,0.139917419360336
SSD,Longochuk,2020,11000,25000,33000,14325,0,83325,47325,0.567956795679568,0.246624662466247,0.12041204120412
SSD,Longochuk,2021,7000,29000,29000,15000,0,80000,44000,0.55,0.245833333333333,0.123611111111111
SSD,Longochuk,2022,14889,22334,26057,18612,0,81892,44669,0.545462316221365,0.257579087904394,0.136365239855202
SSD,Luakpiny/nasir,2017,104684,143941,130855,57741,0,437221,188596,0.431351650538286,0.187805099328105,0.0919491769862635
SSD,Luakpiny/nasir,2018,44605,89210,184366,89210,0,407391,273576,0.671531771688624,0.296836863520958,0.147607580923486
SSD,Luakpiny/nasir,2019,30858,108002,154288,92573,0,385721,246861,0.639998859279116,0.293332918525739,0.151110949797047
SSD,Luakpiny/nasir,2020,39105,65176,158000,65176,0,327457,223176,0.681542920139133,0.293526580080234,0.142072597827094
SSD,Luakpiny/nasir,2021,14000,43000,158000,86000,0,301000,244000,0.810631229235881,0.365448504983389,0.18530823181986
SSD,Luakpiny/nasir,2022,29379,73448,117517,102827,0,323171,220344,0.681818603773235,0.333333333333333,0.181818088050392
SSD,Maban,2017,49055,79147,69253,29680,0,227135,98933,0.435569154907874,0.188746780549013,0.0919536350139296
SSD,Maban,2018,69253,98934,91711,40761,0,300659,132472,0.440605469984268,0.192059221022266,0.0941468943590949
SSD,Maban,2019,7725,18291,37192,8277,0,71485,45469,0.636063509827237,0.25061667948987,0.109269232861595
SSD,Maban,2020,11035,22000,28140,11035,0,72210,39175,0.542514887134746,0.231777685454462,0.11121882164674
SSD,Maban,2021,8000,22000,24000,5000,0,59000,29000,0.491525423728814,0.192090395480226,0.0828625235404896
SSD,Maban,2022,20420,24504,32672,12252,0,89848,44924,0.5,0.212121212121212,0.101010101010101
SSD,Magwi,2017,73702,71855,84826,31810,0,262193,116636,0.444847879233999,0.1887235738559,0.089868489581678
SSD,Magwi,2018,83263,101765,35928,9251,0,230207,45179,0.196253806356888,0.0788131261574728,0.0352011691892755
SSD,Magwi,2019,99243,111648,76801,28800,0,316492,105601,0.333660882423568,0.141552814394466,0.067405951633673
SSD,Magwi,2020,161270,116000,74432,13000,0,364702,87432,0.239735455248395,0.0917936653304159,0.0385191197196615
SSD,Magwi,2021,90000,129000,65000,13000,0,297000,78000,0.262626262626263,0.102132435465769,0.0437710437710438
SSD,Magwi,2022,119187,92701,66215,0,0,278103,66215,0.238095238095238,0.0793650793650794,0.0264550264550265
SSD,Maiwut,2017,47567,57081,15856,15856,0,136360,31712,0.232560868289821,0.116280434144911,0.064600241191617
SSD,Maiwut,2018,4150,12035,22826,12035,0,51046,34861,0.682933040786741,0.306233593229636,0.154470695277027
SSD,Maiwut,2019,24397,30497,42695,36596,0,134185,79291,0.590908074673026,0.28787867496367,0.156565769480775
SSD,Maiwut,2020,24397,30497,58000,30497,0,143391,88497,0.617172625897023,0.276618941681603,0.139469469260042
SSD,Maiwut,2021,13000,26000,64000,39000,0,142000,103000,0.725352112676056,0.333333333333333,0.172143974960876
SSD,Maiwut,2022,13214,26427,59461,46248,0,145350,105709,0.727272101823186,0.34848526545121,0.186869242823835
SSD,Malakal,2017,30983,69712,109990,23237,0,233922,133227,0.569535999179214,0.222957510053209,0.09639395468005
SSD,Malakal,2018,11117,22234,40762,14823,0,88936,55585,0.625,0.26389013822674,0.125001249337851
SSD,Malakal,2019,36695,64217,82564,27521,0,210997,110085,0.521737275885439,0.21739013666861,0.101448519805179
SSD,Malakal,2020,27521,57000,91738,36695,0,212954,128433,0.603102078383125,0.258472095695158,0.124449411610019
SSD,Malakal,2021,29000,57000,86000,29000,0,201000,115000,0.572139303482587,0.238805970149254,0.111663902708679
SSD,Malakal,2022,39031,48789,87821,58547,0,234188,146368,0.625002135036808,0.291667378345603,0.15277801500409
SSD,Manyo,2017,17214,35751,32441,19862,0,105268,52303,0.496855644640347,0.228511988448531,0.118099622972899
SSD,Manyo,2018,6111,11112,13890,6008,0,37121,19898,0.536030818135287,0.232626635417509,0.113508675831889
SSD,Manyo,2019,19071,19071,26699,19071,0,83912,45770,0.545452378682429,0.257575396447072,0.136363756739865
SSD,Manyo,2020,22885,27000,38142,19071,0,107098,57213,0.534211656613569,0.237427402939364,0.118713701469682
SSD,Manyo,2021,8000,31000,35000,15000,0,89000,50000,0.561797752808989,0.243445692883895,0.118601747815231
SSD,Manyo,2022,19734,27627,27627,11840,0,86828,39467,0.454542313539411,0.19696795196634,0.0959585489575815
SSD,Maridi,2017,84598,37169,19328,0,0,141095,19328,0.136985718841915,0.0456619062806383,0.0152206354268795
SSD,Maridi,2018,27564,45941,19142,0,0,92647,19142,0.206612194674409,0.0688707315581365,0.0229569105193788
SSD,Maridi,2019,68330,46103,27809,3973,0,146215,31782,0.217364839448757,0.0815123847302488,0.0332090870749695
SSD,Maridi,2020,59933,54000,16000,0,0,129933,16000,0.123140387738296,0.0410467959127653,0.0136822653042551
SSD,Maridi,2021,43000,59000,11000,5000,0,118000,16000,0.135593220338983,0.0593220338983051,0.0291902071563089
SSD,Maridi,2022,55152,49637,16546,0,0,121335,16546,0.136366258705238,0.0454554195684125,0.0151518065228042
SSD,Mayendit,2017,8334,20835,62463,31232,16668,139532,110363,0.790951179657713,0.417899358808971,0.268678311944373
SSD,Mayendit,2018,4315,25027,67668,35383,8630,141023,111681,0.791934648957971,0.388409455667988,0.226023020673539
SSD,Mayendit,2019,7262,19805,62686,35821,3582,129156,102089,0.79043172597479,0.374415435597262,0.204927030533274
SSD,Mayendit,2020,7000,26406,36308,14000,0,83714,50308,0.600950856487565,0.256062307379889,0.122517672604874
SSD,Mayendit,2021,7000,17000,38000,14000,0,76000,52000,0.68421052631579,0.289473684210526,0.137426900584795
SSD,Mayendit,2022,3540,7080,28320,35401,3540,77881,67261,0.863638114559392,0.469699498808011,0.28788079819782
SSD,Mayom,2017,37304,93944,83934,37304,0,252486,121238,0.480177118731336,0.209307974831608,0.102601948446867
SSD,Mayom,2018,37577,122127,85464,42732,0,287900,128196,0.445279610976033,0.197902049322682,0.0989510246613407
SSD,Mayom,2019,22754,68261,106423,26606,0,224044,133029,0.593762832300798,0.237505430480917,0.105558134414073
SSD,Mayom,2020,15169,53092,92000,31000,0,191261,123000,0.643100266128484,0.268394149007552,0.125482978756777
SSD,Mayom,2021,15000,38000,92000,23000,0,168000,115000,0.68452380952381,0.273809523809524,0.121693121693122
SSD,Mayom,2022,7835,47010,78351,39175,0,172371,117526,0.681820027730883,0.303030478831513,0.151514917113539
SSD,Melut,2017,53706,29242,32897,10966,0,126811,43863,0.345892706468682,0.144122618174554,0.0672575722926245
SSD,Melut,2018,18825,45179,37649,11295,0,112948,48944,0.433332152849099,0.17777797452515,0.0814819405586838
SSD,Melut,2019,31383,50213,43937,25107,0,150640,69044,0.45833775889538,0.208335546114357,0.106482710804272
SSD,Melut,2020,25107,43937,56490,19000,0,144534,75490,0.522299251387217,0.217918736537193,0.101852236228923
SSD,Melut,2021,32000,38000,57000,25000,0,152000,82000,0.539473684210526,0.234649122807018,0.114766081871345
SSD,Melut,2022,32464,32464,51943,25971,0,142842,77914,0.545455818316742,0.242424030280543,0.121211626210156
SSD,Morobo,2017,77669,75943,59594,39729,0,252935,99323,0.392681914325815,0.183251296446386,0.0959886488184272
SSD,Morobo,2018,6893,62041,75828,6893,0,151655,82721,0.545455144901256,0.196968997615201,0.0757567431926998
SSD,Morobo,2019,31232,62464,64380,21460,0,179536,85840,0.478121379556189,0.199217241481746,0.0929680460248146
SSD,Morobo,2020,23000,57258,34000,28000,0,142258,62000,0.435827862053452,0.210884449380703,0.114033813368824
SSD,Morobo,2021,28000,40000,34000,34000,0,136000,68000,0.5,0.25,0.138888888888889
SSD,Morobo,2022,29004,46406,46406,5801,0,127617,52207,0.409091265270301,0.151515863873935,0.0606066938138684
SSD,Mundri east,2017,29136,30224,22996,9856,0,92212,32852,0.356265995748926,0.154383377434607,0.075213156157068
SSD,Mundri east,2018,14776,30224,30143,3285,0,78428,33428,0.426225327689091,0.156036959589262,0.0613202201027978
SSD,Mundri east,2019,38349,43143,28762,14381,0,124635,43143,0.346154771934047,0.153846565304021,0.0769232826520105
SSD,Mundri east,2020,38349,47937,24000,0,0,110286,24000,0.217616016538817,0.0725386721796058,0.0241795573932019
SSD,Mundri east,2021,34000,49000,20000,5000,0,108000,25000,0.231481481481482,0.0925925925925926,0.0411522633744856
SSD,Mundri east,2022,25021,35030,30026,20017,0,110094,50043,0.454547931767399,0.212121762614978,0.111111111111111
SSD,Mundri west,2017,32889,30507,17931,7911,0,89238,25842,0.289585154306461,0.126078576391223,0.0617263198786765
SSD,Mundri west,2018,13185,32171,33136,14123,0,92615,47259,0.51027371376127,0.220921736939661,0.107527578326045
SSD,Mundri west,2019,14092,33821,31003,7892,0,86808,38895,0.448057782692839,0.179657020858293,0.0800886247043283
SSD,Mundri west,2020,18704,28056,10000,2000,0,58760,12000,0.204220558202859,0.0794191059677785,0.0340367597004765
SSD,Mundri west,2021,19000,24000,7000,2000,0,52000,9000,0.173076923076923,0.0705128205128205,0.0320512820512821
SSD,Mundri west,2022,9934,17384,19868,4967,0,52153,24835,0.476195041512473,0.190478016604989,0.0846568962688841
SSD,Mvolo,2017,45794,29003,33147,29003,0,136947,62150,0.453825202450583,0.221869287631955,0.121019242642936
SSD,Mvolo,2018,12803,44384,42677,25606,0,125470,68283,0.544217741292739,0.249432799341144,0.128495523498313
SSD,Mvolo,2019,25055,35793,44286,13286,0,118420,57572,0.486167877047796,0.199453921071891,0.0914166150612697
SSD,Mvolo,2020,26000,39372,15000,0,0,80372,15000,0.186632160453889,0.0622107201512965,0.0207369067170988
SSD,Mvolo,2021,29000,33000,15000,4000,0,81000,19000,0.234567901234568,0.0946502057613169,0.0425240054869685
SSD,Mvolo,2022,22562,30083,26322,15041,0,94008,41363,0.439994468555868,0.199997163361983,0.102220614794013
SSD,Nagero,2017,10941,6869,2031,0,0,19841,2031,0.102363792147573,0.0341212640491911,0.0113737546830637
SSD,Nagero,2018,9596,7037,6020,4014,0,26667,10034,0.376270296621292,0.175597805027437,0.0919821835560389
SSD,Nagero,2019,5959,12140,4414,2207,0,24720,6621,0.267839805825243,0.119039913700108,0.0595199568500539
SSD,Nagero,2020,9000,11919,8000,3000,0,31919,11000,0.344622325260816,0.14620341071671,0.0696206717698619
SSD,Nagero,2021,11000,12000,8000,5000,0,36000,13000,0.361111111111111,0.166666666666667,0.0864197530864198
SSD,Nagero,2022,3876,11627,17440,9689,0,42632,27129,0.636352974291612,0.287874523049978,0.146462750985175
SSD,Nyirol,2017,16949,49616,77968,50848,8475,203856,137291,0.673470488972608,0.335349462365591,0.19492790117643
SSD,Nyirol,2018,17458,69831,87289,78560,26187,279325,192036,0.687500223753692,0.385417226050897,0.253472955637101
SSD,Nyirol,2019,18116,54348,90580,54348,0,217392,144928,0.666666666666667,0.305555555555556,0.157407407407407
SSD,Nyirol,2020,21000,28000,66156,46309,0,161465,112465,0.696528659461803,0.327777949813685,0.172993803266618
SSD,Nyirol,2021,7000,21000,76000,49000,0,153000,125000,0.816993464052288,0.379084967320261,0.197530864197531
SSD,Nyirol,2022,14225,21337,71123,42674,0,149359,113797,0.761902530145488,0.349205605286591,0.179893931920927
SSD,Nzara,2017,56818,29957,14161,0,0,100936,14161,0.140296821748435,0.0467656072494782,0.0155885357498261
SSD,Nzara,2018,21787,40886,5333,0,0,68006,5333,0.0784195512160692,0.0261398504053564,0.00871328346845213
SSD,Nzara,2019,52266,45402,16215,8108,0,121991,24323,0.199383561082375,0.0886158268506147,0.0443083688323091
SSD,Nzara,2020,48645,40538,12161,4000,0,105344,16161,0.153411679829891,0.0637941727420008,0.0297026883353584
SSD,Nzara,2021,41000,37000,8000,0,0,86000,8000,0.0930232558139535,0.0310077519379845,0.0103359173126615
SSD,Nzara,2022,37620,45980,8360,4180,0,96140,12540,0.130434782608696,0.0579710144927536,0.0289855072463768
SSD,Panyijiar,2017,15766,26835,46510,26835,7883,123829,81228,0.655969118704019,0.333333333333333,0.201709167032314
SSD,Panyijiar,2018,17890,42381,55279,41459,9213,166222,105951,0.637406600810964,0.332559268127364,0.203230218222217
SSD,Panyijiar,2019,10954,33462,54771,38339,9561,147087,102671,0.698029057632558,0.362896335728741,0.22222373304386
SSD,Panyijiar,2020,10954,32862,60248,29000,0,133064,89248,0.670714843984849,0.296218361089401,0.147170617981656
SSD,Panyijiar,2021,6000,29000,64000,29000,0,128000,93000,0.7265625,0.317708333333333,0.15625
SSD,Panyijiar,2022,6002,24007,54015,42012,0,126036,96027,0.761901361515757,0.365078231616364,0.195766817946195
SSD,Panyikang,2017,18843,24227,26919,15075,0,85064,41994,0.493675350324462,0.223631618546036,0.1139259851406
SSD,Panyikang,2018,979,5940,11013,12971,1958,32861,25942,0.789446456285566,0.43444610125478,0.272254513117542
SSD,Panyikang,2019,16220,25952,25952,8888,1016,78028,35856,0.459527349156713,0.199825703593582,0.100602063077072
SSD,Panyikang,2020,12976,22708,25952,16220,0,77856,42172,0.541666666666667,0.25,0.12962962962963
SSD,Panyikang,2021,13000,20000,33000,16000,0,82000,49000,0.597560975609756,0.264227642276423,0.131436314363144
SSD,Panyikang,2022,6692,16731,26770,23424,0,73617,50194,0.681826208620292,0.333337861272985,0.181820926024031
SSD,Pariang,2017,109020,97156,60567,36340,0,303083,96907,0.319737497649159,0.146546215613105,0.0754934383577363
SSD,Pariang,2018,109020,114786,124767,24953,0,373526,149720,0.400828857964372,0.155877591742833,0.0668045121951945
SSD,Pariang,2019,19120,62264,89936,20755,0,192075,110691,0.576290511518938,0.228115753394941,0.100051195279622
SSD,Pariang,2020,19120,70106,70106,19120,0,178452,89226,0.5,0.202381219226085,0.091270108114974
SSD,Pariang,2021,19000,45000,64000,26000,0,154000,90000,0.584415584415584,0.251082251082251,0.121212121212121
SSD,Pariang,2022,13116,26232,65579,39347,0,144274,104926,0.727268946587743,0.333331022914732,0.171715701450789
SSD,Pibor,2017,35584,106752,97856,37140,0,277332,134996,0.486766763301747,0.206895225457815,0.0987248336129821
SSD,Pibor,2018,28691,47818,92851,86072,9564,264996,188487,0.711282434451841,0.369423186261931,0.219380669896904
SSD,Pibor,2019,10244,99242,112683,99242,19848,341259,231773,0.679170366202796,0.362101316986023,0.224099258595052
SSD,Pibor,2020,20488,61464,112683,51220,0,245855,163903,0.666665310853959,0.291666497190078,0.143518650333643
SSD,Pibor,2022,11393,22786,91142,91142,22786,239249,205070,0.857140468716693,0.476190078119449,0.306878793409563
SSD,Pochalla,2017,31174,52550,40364,7915,0,132003,48279,0.365741687688916,0.141900815385509,0.060624884787972
SSD,Pochalla,2018,29347,57064,16304,8152,0,110867,24456,0.2205886332272,0.0980393925454223,0.0490196962727111
SSD,Pochalla,2019,26324,62599,33837,12689,0,135449,46526,0.343494599443333,0.145725205304826,0.0693930720951961
SSD,Pochalla,2020,18803,33845,37605,8000,0,98253,45605,0.46415885520035,0.181860435135144,0.0787140228683998
SSD,Pochalla,2021,12000,15000,43000,15000,0,85000,58000,0.682352941176471,0.286274509803922,0.134640522875817
SSD,Pochalla,2022,19853,27794,31764,7941,0,87352,39705,0.454540250938731,0.181816100375492,0.080807155722441
SSD,Raga,2017,22674,49883,40814,33362,0,146733,74176,0.505516823073201,0.244294057914716,0.131956986120671
SSD,Raga,2018,9818,20618,58909,24545,0,113890,83454,0.732759680393362,0.316091550326338,0.15325606579448
SSD,Raja,2018,4909,19636,54000,24545,0,103090,78545,0.76190707149093,0.333333333333333,0.164020650779793
SSD,Raja,2019,15282,35659,50941,20376,0,122258,71317,0.583331970096026,0.249998636762693,0.120369310074687
SSD,Raja,2020,11636,23271,29089,9000,0,72996,38089,0.52179571483369,0.215030047308528,0.0990754440121529
SSD,Raja,2021,9000,26000,20000,9000,0,64000,29000,0.453125,0.197916666666667,0.0972222222222222
SSD,Raja,2022,17858,26786,14881,5953,0,65478,20834,0.3181832065732,0.1363664131464,0.0656590339079114
SSD,Renk,2017,163862,72828,30842,30842,0,298374,61684,0.206733830695704,0.103366915347852,0.05742606408214
SSD,Renk,2018,50828,63535,44474,19060,0,177897,63534,0.357139243494831,0.154759964099076,0.0753956877668913
SSD,Renk,2019,56569,65997,65997,28285,0,216848,94282,0.434783811702206,0.188406933274306,0.0917883084515933
SSD,Renk,2020,47141,95000,75426,28285,0,245852,103711,0.421843222751899,0.178964037984912,0.0852210995956013
SSD,Renk,2021,28000,95000,76000,38000,0,237000,114000,0.481012658227848,0.213783403656821,0.106891701828411
SSD,Renk,2022,48447,67825,58136,38757,0,213165,96893,0.4545446015997,0.212120501333083,0.111110589866483
SSD,Rubkona,2017,21599,161993,118795,30239,0,332626,149034,0.44805276797364,0.179654226268141,0.080086944496221
SSD,Rubkona,2018,10902,39974,41922,33687,0,126485,75609,0.597770486618967,0.288034154247539,0.155196268332213
SSD,Rubkona,2019,31975,79937,159873,47962,0,319747,207835,0.649998279890038,0.266666041172135,0.122221978974349
SSD,Rubkona,2020,95924,111911,175860,67000,0,450695,242860,0.538856654722151,0.229171982530684,0.109426059259095
SSD,Rubkona,2021,50000,133000,133000,67000,0,383000,200000,0.522193211488251,0.232375979112272,0.116333043225994
SSD,Rubkona,2022,34174,102524,153786,102524,0,393008,256310,0.652175019338029,0.304348342357747,0.159420560282629
SSD,Rumbek centre,2017,100872,123970,99176,50436,0,374454,149612,0.399547073872892,0.178079728529183,0.0892914898907624
SSD,Rumbek centre,2018,75654,109093,142860,64936,0,392543,207796,0.529358567086918,0.231594160809559,0.113958923679133
SSD,Rumbek centre,2019,53907,94338,134769,40431,0,323445,175200,0.541668598989009,0.222223252794138,0.101852453018803
SSD,Rumbek centre,2020,53000,71091,91403,42000,0,257494,133403,0.518081974725625,0.227064190492465,0.111934862775659
SSD,Rumbek centre,2021,63000,84000,53000,42000,0,242000,95000,0.392561983471074,0.18870523415978,0.101469237832874
SSD,Rumbek centre,2022,43121,75462,75462,53901,0,247946,129363,0.521738604373533,0.246376227081703,0.130434314998696
SSD,Rumbek east,2017,82158,97863,68504,41079,0,289604,109583,0.378389110647643,0.173411509049138,0.0893250400163288
SSD,Rumbek east,2018,61618,84622,95200,52889,0,294329,148089,0.503141042846611,0.227611505039146,0.115802384406565
SSD,Rumbek east,2019,41887,65859,109766,43906,0,261418,153672,0.587840164028491,0.251931134555896,0.12129998699401
SSD,Rumbek east,2020,33510,51000,83774,34000,0,202284,117774,0.58222103577149,0.250100518742626,0.120718066348962
SSD,Rumbek east,2021,34000,51000,77000,34000,0,196000,111000,0.566326530612245,0.246598639455782,0.120748299319728
SSD,Rumbek east,2022,34912,52368,61095,43640,0,192015,104735,0.545452178215244,0.257575363035874,0.136363767876931
SSD,Rumbek north,2017,20247,21935,20247,14848,0,77277,35095,0.454145476661879,0.215428480229132,0.114507263193159
SSD,Rumbek north,2018,14848,20799,28140,17740,0,81527,45880,0.56275834999448,0.26011832480855,0.135060913698666
SSD,Rumbek north,2019,18245,25263,38088,15870,0,97466,53958,0.553608437814212,0.23881148297868,0.115787385686633
SSD,Rumbek north,2020,14000,21052,31578,24561,0,91191,56139,0.615619962496299,0.294985250737463,0.158180814627174
SSD,Rumbek north,2021,14000,25000,28000,25000,0,92000,53000,0.576086956521739,0.282608695652174,0.154589371980676
SSD,Rumbek north,2022,7272,18181,29089,21817,3636,79995,54542,0.68181761360085,0.348484280267517,0.207069886312339
SSD,Tambura,2017,54286,43297,11429,0,0,109012,11429,0.104841668807104,0.0349472229357013,0.0116490743119004
SSD,Tambura,2018,45339,52028,11149,0,0,108516,11149,0.102740609679679,0.0342468698932262,0.0114156232977421
SSD,Tambura,2019,66330,60737,11043,5522,0,143632,16565,0.115329453046675,0.0512583082692808,0.0256295409255752
SSD,Tambura,2020,70000,55216,27608,0,0,152824,27608,0.180652253572737,0.0602174178575791,0.020072472619193
SSD,Tambura,2021,81000,46000,0,0,0,127000,0,0,0,0
SSD,Tambura,2022,5955,11911,59554,53598,5955,136973,119107,0.86956553481343,0.449273457786084,0.265697943714779
SSD,Terekeka,2017,72599,92839,39391,7878,0,212707,47269,0.222225878791013,0.0864209139019089,0.0370373852816838
SSD,Terekeka,2018,39391,94537,97373,16229,0,247530,113602,0.458942350422171,0.174835373490082,0.0728481845073773
SSD,Terekeka,2019,61621,98593,84204,49297,0,293715,133501,0.454525645608839,0.20745507266114,0.106449373636953
SSD,Terekeka,2020,61621,123242,101000,50000,0,335863,151000,0.449588076090549,0.199486099987197,0.0995776386337419
SSD,Terekeka,2021,63000,126000,101000,50000,0,340000,151000,0.444117647058824,0.197058823529412,0.0983660130718954
SSD,Terekeka,2022,25839,77519,116279,64599,0,284236,180878,0.636365555383555,0.287879320939876,0.146464753076864
SSD,Tonj East,2018,11690,87674,64294,5845,0,169503,70139,0.413792086275759,0.149425083921819,0.0574712869716498
SSD,Tonj East,2019,24261,102824,73446,18196,0,218727,91642,0.418978909782514,0.167389790317001,0.0742833659208867
SSD,Tonj East,2020,44068,73446,72000,45000,0,234514,117000,0.498904116598583,0.230263438430115,0.119395856963763
SSD,Tonj East,2021,27000,45000,72000,54000,0,198000,126000,0.636363636363636,0.303030303030303,0.161616161616162
SSD,Tonj East,2022,13839,27678,41517,62275,0,145309,103792,0.714284731159116,0.380951397825783,0.222221457568201
SSD,Tonj North,2018,36106,168493,96282,48141,0,349022,144423,0.41379339984299,0.183908177707995,0.0919540888539977
SSD,Tonj North,2019,39345,162356,124890,49956,0,376547,174846,0.464340440901136,0.199003046100487,0.0958162814557899
SSD,Tonj North,2020,104921,104921,104921,39345,13000,367108,157266,0.428391644965514,0.202130344930284,0.114801517688407
SSD,Tonj North,2021,51000,64000,103000,51000,13000,282000,167000,0.592198581560284,0.288416075650118,0.167060677698976
SSD,Tonj North,2022,26304,52608,92065,105217,0,276194,197282,0.714287783224835,0.365080342078394,0.206349723583986
SSD,Tonj South,2018,12935,97012,58207,12935,0,181089,71142,0.392856551198582,0.154761839022065,0.0674603832001576
SSD,Tonj South,2019,26845,87246,60401,16397,0,190889,76798,0.402317577230747,0.162738554866965,0.0733346488156875
SSD,Tonj South,2020,32795,54658,43726,47000,0,178179,90726,0.509184584041891,0.257654755423853,0.144502625636766
SSD,Tonj South,2021,23000,23000,29000,47000,0,122000,76000,0.622950819672131,0.336065573770492,0.197632058287796
SSD,Tonj South,2022,17906,23875,41782,47751,0,131314,89533,0.681823720243082,0.348487848465002,0.196971466188762
SSD,Tonj east,2017,41892,76802,55856,19051,0,193601,74907,0.38691432378965,0.16177258037579,0.0757916195336457
SSD,Tonj east,2018,25401,76204,46760,23380,0,171745,70140,0.408396168738537,0.181509408328239,0.0907547041641193
SSD,Tonj north,2017,76834,128531,87810,23369,0,316544,111179,0.351227633441165,0.141684357730152,0.0636337725210046
SSD,Tonj north,2018,50548,140216,96282,36106,0,323152,132388,0.409677179779175,0.173802627452922,0.0827632541686609
SSD,Tonj south,2017,37674,70927,43953,12558,0,165112,56511,0.342258588109889,0.13943868404477,0.0633812200203498
SSD,Tonj south,2018,27163,75349,51740,19402,0,173654,71142,0.409676713464706,0.173801544066554,0.0827622744077303
SSD,Torit,2017,30092,45139,67708,35003,0,177942,102711,0.57721617156152,0.257975445182513,0.129705184835508
SSD,Torit,2018,61990,85237,54242,15498,0,216967,69740,0.321431369747473,0.130953862415329,0.0595246691381127
SSD,Torit,2019,48245,72368,72368,24123,0,217104,96491,0.444445979806913,0.185186208760164,0.086420435469739
SSD,Torit,2020,20525,29322,18000,5864,0,73711,23864,0.323750864864132,0.134434932823233,0.0624902961867594
SSD,Torit,2021,22000,25000,18000,3000,0,68000,21000,0.308823529411765,0.117647058823529,0.0490196078431373
SSD,Torit,2022,15744,22041,25190,6297,0,69272,31487,0.454541517496247,0.181814682218886,0.0808054561086089
SSD,Twic,2017,144600,201472,165258,82629,0,593959,247887,0.417346988596856,0.185487550487492,0.0927437752437458
SSD,Twic,2018,103286,297877,174471,106385,0,682019,280856,0.411800844258005,0.189262078231447,0.0977507795074461
SSD,Twic,2019,66237,264949,176632,44158,0,551976,220790,0.399999275330812,0.159999710132325,0.0711109822810332
SSD,Twic,2020,91891,118146,91891,40000,0,341928,131891,0.385727404599799,0.167570365691023,0.0818531646688452
SSD,Twic,2021,53000,106000,106000,40000,0,305000,146000,0.478688524590164,0.20327868852459,0.0969034608378871
SSD,Twic,2022,40563,54084,81126,108168,0,283941,189294,0.666666666666667,0.349206349206349,0.201058201058201
SSD,Twic east,2017,19419,64731,77677,25892,0,187719,103569,0.551723586850559,0.22988438392846,0.107279142406114
SSD,Twic east,2018,12014,54063,60070,30035,0,156182,90105,0.576923076923077,0.256410256410256,0.128205128205128
SSD,Twic east,2019,17844,47583,68568,43634,0,177629,112202,0.631664874541882,0.29243723340971,0.152067261289291
SSD,Twic east,2020,17844,41635,53531,36000,0,149010,89531,0.600838869874505,0.280811131243988,0.147291382382987
SSD,Twic east,2021,6000,18000,48000,61000,0,133000,109000,0.819548872180451,0.426065162907268,0.243943191311612
SSD,Twic east,2022,12412,18618,49647,49647,0,130324,99294,0.761901108007735,0.380950554003867,0.211639196668815
SSD,Ulang,2017,33683,72979,44910,23970,0,175542,68880,0.392384728441057,0.176311082248123,0.0891144759278881
SSD,Ulang,2018,14813,29627,54316,34565,0,133321,88881,0.666669166897938,0.308643549528331,0.160494845773234
SSD,Ulang,2019,15372,34692,51240,34692,0,135996,85932,0.631871525633107,0.295655754581017,0.155239859995882
SSD,Ulang,2020,17346,28910,62000,41000,0,149256,103000,0.690089510639438,0.321595111754301,0.168241887167759
SSD,Ulang,2021,7000,21000,76000,48000,0,152000,124000,0.81578947368421,0.37719298245614,0.195906432748538
SSD,Ulang,2022,28227,42340,49397,35284,0,155248,84681,0.545456302174585,0.257577123913566,0.136364612319214
SSD,Uror,2017,21287,63862,127724,74506,0,287379,202230,0.703704863612164,0.320988427593294,0.164609569012814
SSD,Uror,2018,19632,68711,107975,78527,19632,294477,206134,0.700000339585095,0.366667006251762,0.225926340974375
SSD,Uror,2019,27302,100107,122231,61116,0,310756,183347,0.590003089240433,0.262223952768946,0.131112155159961
SSD,Uror,2020,38000,100107,91006,45503,0,274616,136509,0.497090482710403,0.220929103426846,0.110464551713423
SSD,Uror,2021,29000,48000,76000,57000,0,210000,133000,0.633333333333333,0.301587301587302,0.160846560846561
SSD,Uror,2022,19592,29388,97960,58776,9796,215512,166532,0.772727272727273,0.378787878787879,0.217171717171717
SSD,Wau,2017,49135,122837,113010,117924,16638,419544,247572,0.590097820490819,0.316829700818031,0.194509594543918
SSD,Wau,2018,28562,102822,157089,110919,19411,418803,287419,0.686286869960339,0.347944021413409,0.205735552674328
SSD,Wau (Rural Only),2018,28562,82829,142808,59979,0,314178,202787,0.645452577838041,0.278786759947121,0.13535285376089
SSD,Wau (Rural Only),2019,47242,118554,157475,59277,0,382548,216752,0.566600792580278,0.240517965501497,0.114606678261435
SSD,Wau (Rural Only),2020,62990,125000,173222,47000,0,408212,220222,0.539479486149354,0.218205246293593,0.0983209160381806
SSD,Wau (Rural Only),2021,62000,125000,109000,31000,0,327000,140000,0.428134556574924,0.174311926605505,0.0791709140332994
SSD,Wau (Rural Only),2022,96043,128057,80036,48021,0,352157,128057,0.363636105487041,0.166666193392909,0.0858581699513443
SSD,West of Pibor,2020,8196,16392,40979,65566,32783,163916,139328,0.84999633958857,0.549997153013332,0.405553250852062
SSD,West of Pibor,2021,0,16392,49175,73762,32783,172112,155720,0.904759691363763,0.57142635803043,0.412696383750116
SSD,Wulu,2017,64841,45770,14314,3814,0,128739,18128,0.140812030542415,0.0568126208841144,0.0255210585413554
SSD,Wulu,2018,27266,34301,37284,6711,0,105562,43995,0.416769291980069,0.160114435118698,0.067499036900905
SSD,Wulu,2019,28856,41223,34821,7738,0,112638,42559,0.377838740034447,0.148845564255994,0.0648813998038949
SSD,Wulu,2020,32978,45345,17000,9000,0,104323,26000,0.249225961676716,0.111832162290834,0.0564486152515638
SSD,Wulu,2021,35000,39000,30000,0,0,104000,30000,0.288461538461538,0.0961538461538462,0.0320512820512821
SSD,Wulu,2022,22264,26717,35622,8905,0,93508,44527,0.476183855926766,0.190472116467753,0.0846534818173608
SSD,Yambio,2017,85505,103533,37395,23618,0,250051,61013,0.244002223546397,0.11281831839638,0.0585956020527368
SSD,Yambio,2018,84709,116334,67862,9695,0,278600,77557,0.278381191672649,0.104393395549174,0.042530908510808
SSD,Yambio,2019,140839,90540,50300,23844,0,305523,74144,0.242678947247834,0.106907390496515,0.0529787355525516
SSD,Yambio,2020,79481,79481,33000,7948,0,199910,40948,0.204832174478515,0.0815300218431628,0.0360117608479371
SSD,Yambio,2021,82000,66000,16000,8000,0,172000,24000,0.13953488372093,0.062015503875969,0.0310077519379845
SSD,Yambio,2022,50561,75842,50561,0,0,176964,50561,0.285713478447594,0.095237826149198,0.0317459420497327
SSD,Yei,2017,83633,107528,107255,39190,0,337606,146445,0.433774873669307,0.183285644607422,0.086891228236465
SSD,Yei,2018,8073,80732,104951,47028,0,240784,151979,0.631183965712007,0.275498648858174,0.135235545366617
SSD,Yei county,2019,94919,122039,75397,25133,0,317488,100530,0.316641888827294,0.13193464529893,0.0615697811150868
SSD,Yei county,2020,81359,133000,122039,27120,0,363518,149159,0.410320809423467,0.161641697705937,0.0704592956118328
SSD,Yei county,2021,88000,147000,88000,29000,0,352000,117000,0.332386363636364,0.138257575757576,0.0643939393939394
SSD,Yei county,2022,75547,120876,120876,15109,0,332408,135985,0.409090635604438,0.151514604542209,0.0606055744078896
SSD,Yirol east,2017,52788,56672,39591,26394,0,175445,65985,0.37610077232181,0.175513693750178,0.0919357443453314
SSD,Yirol east,2018,39591,59387,49850,33233,11078,193139,94161,0.487529706584377,0.258104266875152,0.162510477485703
SSD,Yirol east,2019,15022,60089,60089,52578,0,187778,112667,0.600001065087497,0.293333972385832,0.160000402366388
SSD,Yirol east,2020,23000,52578,75111,37556,0,188245,112667,0.598512576695264,0.266006179889683,0.133003385068513
SSD,Yirol east,2021,23000,47000,70000,31000,0,171000,101000,0.590643274853801,0.257309941520468,0.126055880441845
SSD,Yirol east,2022,24055,64148,56129,32074,0,176406,88203,0.5,0.227273070832814,0.116161959721703
SSD,Yirol west,2017,67472,83677,50206,33736,0,235091,83942,0.35706173354148,0.16685453717922,0.0875074852811134
SSD,Yirol west,2018,67472,69496,86870,34748,8687,267273,130305,0.487535216800799,0.22751643450704,0.126398019170578
SSD,Yirol west,2019,47297,55179,72116,54087,9014,237693,135217,0.568872453122305,0.290756003191792,0.172767206251575
SSD,Yirol west,2020,31531,63062,78828,26000,0,199421,104828,0.525661790884611,0.218679744527073,0.101866013219381
SSD,Yirol west,2021,26000,60000,85000,17000,0,188000,102000,0.542553191489362,0.210992907801418,0.0904255319148936
SSD,Yirol west,2022,26170,52341,78512,34894,0,191917,113406,0.590911696202004,0.257576626006729,0.126262915739617
SWZ,Dry middleveld,2021,68413,41048,27365,6841,0,143667,34206,0.238092255006369,0.0952364379665013,0.0423270479650859
SWZ,Dry middleveld,2022,68413,47889,27365,6841,0,150508,34206,0.227270311212693,0.0909076815407376,0.0404031679379169
SWZ,Hhohho,2017,224100,37350,12450,0,0,273900,12450,0.0454545454545455,0.0151515151515152,0.00505050505050505
SWZ,Hhohho,2018,288586,48098,16033,0,0,352717,16033,0.0454557052821384,0.0151519017607128,0.0050506339202376
SWZ,Hhohho,2019,160326,112228,51123,16033,0,339710,67156,0.197686261811545,0.0816274665646188,0.0376971861620533
SWZ,Hhohho,2020,101526,88835,63454,12691,0,266506,76145,0.28571589382603,0.11111194494683,0.0476195240966015
SWZ,Hhohho,2021,114216,101526,63454,12691,0,291887,76145,0.260871501642759,0.101450218749036,0.0434787739395344
SWZ,Hhohho urban,2020,39762,39762,17672,4418,0,101614,22090,0.217391304347826,0.0869565217391304,0.0386473429951691
SWZ,Hhohho urban,2021,49799,39762,17672,4418,0,111651,22090,0.197848653393163,0.0791394613572651,0.0351730939365622
SWZ,Hhohho urban,2022,49799,29050,16600,4150,0,99599,20750,0.208335425054468,0.0833341700217874,0.0370374088985722
SWZ,Highveld cattle and maize,2021,83993,53450,15272,7472,0,160187,22744,0.141984056134393,0.0628765130753432,0.0313245006010337
SWZ,Highveld cattle and maize,2022,76358,61086,38179,7472,0,183095,45651,0.249329583003359,0.0967129996267876,0.0413064256260411
SWZ,Lowveld cattle and maize,2021,101650,45178,79061,11294,0,237183,90355,0.380950574029336,0.14285593824178,0.0582002551241493
SWZ,Lowveld cattle and maize,2022,101650,67766,79061,22589,0,271066,101650,0.37500092228461,0.152778290158116,0.0694447518726477
SWZ,Lubombo,2017,108350,49250,59100,9850,0,226550,68950,0.304347826086957,0.115942028985507,0.0483091787439614
SWZ,Lubombo,2018,116892,57383,42506,17002,0,233783,59508,0.254543743557059,0.109089768431979,0.0525244920859658
SWZ,Lubombo,2019,54855,82283,63759,21253,0,222150,85012,0.382678370470403,0.159449321029335,0.0744096831470228
SWZ,Lubombo,2020,39052,68341,87867,19526,0,214786,107393,0.5,0.196969696969697,0.0858585858585859
SWZ,Lubombo,2021,58578,87867,58578,19526,0,224549,78104,0.347826086956522,0.144927536231884,0.0676328502415459
SWZ,Lubombo plateau,2021,17990,11244,15741,4497,0,49472,20238,0.409079883570505,0.166659928848642,0.0757532880551962
SWZ,Lubombo plateau,2022,13492,17990,15741,4497,0,51720,20238,0.391299303944316,0.159416086620263,0.0724606857437484
SWZ,Lubombo urban,2021,19327,22088,16566,5522,0,63503,22088,0.347826086956522,0.144927536231884,0.0676328502415459
SWZ,Lubombo urban,2022,22088,22088,19327,2761,0,66264,22088,0.333333333333333,0.125,0.0509259259259259
SWZ,Manzini,2017,198000,39600,34320,5280,0,277200,39600,0.142857142857143,0.053968253968254,0.0222222222222222
SWZ,Manzini,2018,302553,67630,24916,14238,0,409337,39154,0.0956522376428224,0.0434784378967289,0.0222223850872129
SWZ,Manzini,2019,125704,141417,31426,15713,0,314260,47139,0.15,0.0666666666666667,0.0333333333333333
SWZ,Manzini,2020,91627,117806,52358,13090,0,274881,65448,0.238095757800648,0.0952387881786422,0.0423286197784981
SWZ,Manzini,2021,104716,117806,52358,13090,0,287970,65448,0.227273674341077,0.0909099327476242,0.0404046717829404
SWZ,Manzini urban,2020,79007,39504,19752,0,0,138263,19752,0.142858176084708,0.047619392028236,0.0158731306760787
SWZ,Manzini urban,2021,65840,46088,26336,4626,0,142890,30962,0.216684162642592,0.0830195721650687,0.0348675360222704
SWZ,Manzini urban,2022,50887,37009,18504,4626,0,111026,23130,0.208329580458631,0.0833318321834525,0.0370363698593122
SWZ,Moist middleveld,2021,67582,54065,20274,0,0,141921,20274,0.142854123068468,0.0476180410228226,0.0158726803409409
SWZ,Moist middleveld,2022,54065,67582,27033,0,0,148680,27033,0.18182001614205,0.06060667204735,0.0202022240157833
SWZ,Peri-urban,2021,42818,26761,42818,5352,0,117749,48170,0.409090523061767,0.151514379456867,0.0606053743320302
SWZ,Peri-urban,2022,48170,42818,48170,5352,0,144510,53522,0.37036883260674,0.135801443960049,0.0534972589363289
SWZ,Shiselweni,2017,116000,50000,50000,6000,0,222000,56000,0.252252252252252,0.0930930930930931,0.037037037037037
SWZ,Shiselweni,2018,126549,51028,40822,10206,0,228605,51028,0.223214715338685,0.0892864693831427,0.0396831993078794
SWZ,Shiselweni,2019,85998,57332,51028,30617,0,224975,81645,0.362906989665518,0.166332555469126,0.0856865577656777
SWZ,Shiselweni,2020,49563,59475,89213,9913,0,208164,99126,0.476191848734652,0.174604318389987,0.0687839075600648
SWZ,Shiselweni,2021,69388,79300,69388,9913,0,227989,79301,0.347828184693121,0.130436117531986,0.0531409653779593
SWZ,Shiselweni urban,2021,22947,20398,10199,2550,0,56094,12749,0.227279209897672,0.0909128724403085,0.040406381351937
SWZ,Shiselweni urban,2022,25497,20398,12749,2550,0,61194,15299,0.250008170735693,0.0972263075900687,0.0416689363154703
SWZ,Timber highlands,2021,49594,31560,13526,0,0,94680,13526,0.142860160540769,0.0476200535135896,0.0158733511711965
SWZ,Timber highlands,2022,49594,36068,13526,0,0,99188,13526,0.13636730249627,0.0454557674987566,0.0151519224995855
TCD,Abdi,2020,137278,24809,3308,0,0,165395,3308,0.0200006046131987,0.00666686820439957,0.00222228940146652
TCD,Abdi,2021,148171,33079,6616,0,0,187866,6616,0.0352165905485825,0.0117388635161942,0.00391295450539806
TCD,Abdi,2022,128632,43835,23604,1686,0,197757,25290,0.127884221544623,0.0454699454380882,0.0170512295392831
TCD,Aboudeia,2020,81409,12906,4964,0,0,99279,4964,0.0500005036311808,0.0166668345437269,0.00555561151457565
TCD,Aboudeia,2021,69495,27589,20692,985,0,118761,21677,0.182526250199981,0.0636067395862278,0.0230453506528986
TCD,Aboudeia,2022,48973,37750,25507,2956,0,115186,28463,0.247104682860764,0.0909225079436737,0.0360103561968372
TCD,Abtouyour,2020,145453,47119,12292,0,0,204864,12292,0.0600007810059356,0.0200002603353119,0.00666675344510396
TCD,Abtouyour,2021,183651,53265,20406,0,0,257322,20406,0.0793014200107259,0.026433806670242,0.00881126889008065
TCD,Abtouyour,2022,224498,63768,30609,0,0,318875,30609,0.0959905919247354,0.0319968639749118,0.0106656213249706
TCD,Am-djarass,2020,62471,22877,2640,0,0,87988,2640,0.0300040914670182,0.0100013638223394,0.0033337879407798
TCD,Am-djarass,2021,57192,25517,5279,0,0,87988,5279,0.0599968177478747,0.0199989392492916,0.00666631308309719
TCD,Am-djarass,2022,91444,38832,12527,0,0,142803,12527,0.0877222467315112,0.0292407489105038,0.00974691630350125
TCD,Assoungha,2020,375712,53042,13260,0,0,442014,13260,0.0299990498038524,0.00999968326795079,0.0033332277559836
TCD,Assoungha,2021,322670,100084,26521,0,0,449275,26521,0.0590306605085972,0.0196768868361991,0.00655896227873302
TCD,Assoungha,2022,297380,126161,94621,13517,0,531679,108138,0.203389639237209,0.0762709579777773,0.0310732603695087
TCD,Baguirmi,2020,279614,31774,6355,0,0,317743,6355,0.0200004406076609,0.00666681353588697,0.00222227117862899
TCD,Baguirmi,2021,266904,57509,25559,0,0,349972,25559,0.0730315568102591,0.0243438522700864,0.00811461742336212
TCD,Baguirmi,2022,301048,79873,41534,0,0,422455,41534,0.0983157969487874,0.0327719323162625,0.0109239774387542
TCD,Bahr azoum,2020,234932,36359,8390,0,0,279681,8390,0.0299984625341014,0.00999948751136712,0.00333316250378904
TCD,Bahr azoum,2021,206964,63843,58291,0,0,329098,58291,0.177123531592413,0.0590411771974711,0.019680392399157
TCD,Bahr azoum,2022,218439,89100,63843,2776,0,374158,66619,0.17805044927544,0.0618232582670066,0.0222564917613533
TCD,Bahr koh,2020,402106,61499,9461,0,0,473066,9461,0.0199993235616172,0.00666644118720573,0.00222214706240191
TCD,Bahr koh,2021,401919,70960,18923,0,0,491802,18923,0.0384768667065201,0.0128256222355067,0.00427520741183557
TCD,Bahr koh,2022,416170,67749,19357,0,0,503276,19357,0.0384619969956843,0.0128206656652281,0.0042735552217427
TCD,Barh sara,2020,280855,39650,9913,0,0,330418,9913,0.030001392175971,0.010000464058657,0.00333348801955234
TCD,Barh sara,2021,294559,59475,16521,0,0,370555,16521,0.0445844746393923,0.0148614915464641,0.00495383051548803
TCD,Barh sara,2022,294722,51405,13239,0,0,359366,13239,0.036839879120451,0.012279959706817,0.00409331990227233
TCD,Barh signaka,2020,117855,7604,1267,0,0,126726,1267,0.00999794832946673,0.00333264944315557,0.00111088314771852
TCD,Barh signaka,2021,129383,23668,4734,0,0,157785,4734,0.0300028519821276,0.0100009506607092,0.0033336502202364
TCD,Barh signaka,2022,142139,36290,12623,0,0,191052,12623,0.0660710173146578,0.0220236724382193,0.00734122414607309
TCD,Barh-el-gazel nord,2020,74849,16525,4860,972,0,97206,5832,0.0599962965249059,0.023331893093019,0.00999938275415098
TCD,Barh-el-gazel nord,2021,55407,28286,18469,1944,0,104106,20413,0.196078996407508,0.0715840905743505,0.028010980261571
TCD,Barh-el-gazel nord,2022,45886,39052,24407,2829,0,112174,27236,0.242801362169487,0.089340370020385,0.0353845117604991
TCD,Barh-el-gazel ouest,2020,72187,9342,3397,0,0,84926,3397,0.0399995290017191,0.0133331763339064,0.00444439211130213
TCD,Barh-el-gazel ouest,2021,61996,30479,8237,824,0,101536,9061,0.0892392845887173,0.0324515442798613,0.0126205921490353
TCD,Barh-el-gazel ouest,2022,45206,34597,21324,2559,0,103686,23883,0.2303396794167,0.0850066547074822,0.0338200592815488
TCD,Barh-el-gazel sud,2020,188642,26632,6658,0,0,221932,6658,0.0300001802353874,0.0100000600784625,0.00333335335948749
TCD,Barh-el-gazel sud,2021,176518,44386,19974,0,0,240878,19974,0.0829216449821071,0.027640548327369,0.00921351610912301
TCD,Barh-el-gazel sud,2022,131312,78014,57953,11145,0,278424,69098,0.248175444645577,0.0960681071555134,0.0409180083453853
TCD,Batha est,2020,226264,31572,5262,0,0,263098,5262,0.0200001520346031,0.00666671734486769,0.0022222391149559
TCD,Batha est,2021,211549,55251,16484,2747,0,286031,19231,0.067233971142988,0.0256126084235625,0.0106717259473429
TCD,Batha est,2022,196291,76927,57695,8534,0,339447,66229,0.195108514731313,0.0734164685503186,0.0300590208322491
TCD,Batha ouest,2020,210559,60572,17306,0,0,288437,17306,0.0599992372684503,0.0199997457561501,0.0066665819187167
TCD,Batha ouest,2021,237947,69225,23075,0,0,330247,23075,0.0698719443325753,0.0232906481108584,0.00776354937028615
TCD,Batha ouest,2022,228911,109157,62376,12475,0,412919,74851,0.181272840436018,0.0704948589594247,0.0302120055291985
TCD,Biltine,2020,179534,55444,29042,0,0,264020,29042,0.10999924248163,0.0366664141605434,0.0122221380535145
TCD,Biltine,2021,190576,66005,52804,7921,0,317306,60725,0.191376778251908,0.072113354301526,0.0295851813566575
TCD,Biltine,2022,162666,77333,66667,0,0,306666,66667,0.21739286389753,0.0724642879658434,0.0241547626552811
TCD,Borkou,2020,69516,26737,10695,0,0,106948,10695,0.100001870067696,0.0333339566892322,0.0111113188964107
TCD,Borkou,2021,73951,29945,23528,3208,0,130632,26736,0.204666544185192,0.0764080266193072,0.0309265723559312
TCD,Borkou,2022,89515,31247,11863,2083,0,134708,13946,0.103527630133325,0.0396635686076551,0.0166574285780272
TCD,Borkou yala,2020,27214,7888,4339,0,0,39441,4339,0.110012423620091,0.0366708078733636,0.0122236026244545
TCD,Borkou yala,2021,28425,9860,7888,1183,0,47356,9071,0.191549117324098,0.0721767041135231,0.0296102335970568
TCD,Borkou yala,2022,33410,10755,6914,1921,0,53000,8835,0.166698113207547,0.0676477987421384,0.0306037735849057
TCD,Chari,2020,252172,24940,0,0,0,277112,0,0,0,0
TCD,Chari,2021,235545,52941,5573,0,0,294059,5573,0.0189519790246175,0.00631732634153917,0.00210577544717972
TCD,Chari,2022,207733,75015,31737,0,0,314485,31737,0.100917372847672,0.0336391242825572,0.0112130414275191
TCD,Dababa,2020,306565,27250,6813,0,0,340628,6813,0.0200012917317425,0.00666709724391418,0.00222236574797139
TCD,Dababa,2021,286128,66122,27841,0,0,380091,27841,0.0732482484457669,0.0244160828152556,0.00813869427175188
TCD,Dababa,2022,227021,115312,57656,0,0,399989,57656,0.144143963959009,0.0480479879863363,0.0160159959954454
TCD,Dagana,2020,249954,28085,2808,0,0,280847,2808,0.00999832649093635,0.00333277549697878,0.00111092516565959
TCD,Dagana,2021,235911,60256,8425,0,0,304592,8425,0.0276599516730577,0.00921998389101924,0.00307332796367308
TCD,Dagana,2022,186507,106959,83190,0,0,376656,83190,0.220864661654135,0.0736215538847118,0.0245405179615706
TCD,Dar tama,2020,182099,64435,33618,0,0,280152,33618,0.119999143322197,0.0399997144407322,0.0133332381469107
TCD,Dar tama,2021,210419,72840,58832,5603,0,347694,64435,0.185321000649997,0.067145248408083,0.0259628038191948
TCD,Dar tama,2022,200902,87718,62251,16396,0,367267,78647,0.214141210617888,0.0862614936817084,0.0386745579888443
TCD,Djourf al ahmar,2020,110854,9745,1218,0,0,121817,1218,0.00999860446407316,0.00333286815469105,0.00111095605156368
TCD,Djourf al ahmar,2021,103545,18630,3726,0,0,125901,3726,0.0295946815354922,0.00986489384516406,0.00328829794838802
TCD,Djourf al ahmar,2022,91310,32151,11574,2572,0,137607,14146,0.102800002906829,0.0404969708420841,0.0176525257516777
TCD,Dodje,2020,140635,17988,4906,0,0,163529,4906,0.0300007949660305,0.0100002649886768,0.00333342166289228
TCD,Dodje,2021,125917,34027,13082,0,0,173026,13082,0.0756071341879255,0.0252023780626418,0.00840079268754728
TCD,Dodje,2022,124156,43623,19444,0,0,187223,19444,0.103854761434226,0.0346182538114085,0.0115394179371362
TCD,Fada,2020,32226,8274,3048,0,0,43548,3048,0.0699917332598512,0.0233305777532837,0.00777685925109458
TCD,Fada,2021,32932,13772,11377,1796,0,59877,13173,0.220001002054211,0.0833319415913734,0.034442830023771
TCD,Fada,2022,37200,17980,13020,2994,0,71194,16014,0.224934685507206,0.0889962637300896,0.0390107780618217
TCD,Fittri,2020,122409,30602,8053,0,0,161064,8053,0.049998758257587,0.016666252752529,0.00555541758417634
TCD,Fittri,2021,121097,38655,14496,0,0,174248,14496,0.083191772645884,0.0277305908819613,0.00924353029398711
TCD,Fittri,2022,144548,47093,20183,5046,0,216870,25229,0.116332365011297,0.0465332534083399,0.0206816167391627
TCD,Fouli,2020,43387,11887,4160,0,0,59434,4160,0.0699936063532658,0.0233312021177553,0.00777706737258509
TCD,Fouli,2021,35675,16642,12481,1783,0,66581,14264,0.214235292350671,0.0803382346315015,0.032730391886908
TCD,Fouli,2022,35634,20961,19564,3567,0,79726,23131,0.2901311993578,0.111623978794036,0.0471503789367473
TCD,Grande sido,2020,146903,16506,1651,0,0,165060,1651,0.010002423361202,0.00333414112040066,0.00111138037346689
TCD,Grande sido,2021,140235,21458,4952,0,0,166645,4952,0.0297158630621981,0.00990528768739936,0.00330176256246645
TCD,Grande sido,2022,143519,25327,8153,0,0,176999,8153,0.0460624071322437,0.0153541357107479,0.00511804523691597
TCD,Gueni,2020,117419,16976,7073,0,0,141468,7073,0.0499971725054429,0.016665724168481,0.00555524138949366
TCD,Gueni,2021,108931,29437,11214,0,0,149582,11214,0.0749689133719298,0.0249896377906433,0.00832987926354775
TCD,Gueni,2022,103054,42092,15966,0,0,161112,15966,0.0990987635930285,0.0330329211976762,0.0110109737325587
TCD,Guera,2020,149809,44310,16880,0,0,210999,16880,0.0800003791487163,0.0266667930495721,0.00888893101652404
TCD,Guera,2021,194405,46420,23644,0,0,264469,23644,0.0894017824395298,0.0298005941465099,0.00993353138216998
TCD,Guera,2022,187697,78813,34152,0,0,300662,34152,0.113589346176105,0.0378631153920349,0.0126210384640116
TCD,Haraze al biar,2020,194680,20139,8951,0,0,223770,8951,0.0400008937748581,0.013333631258286,0.00444454375276201
TCD,Haraze al biar,2021,185729,48010,18290,0,0,252029,18290,0.0725710136531907,0.0241903378843969,0.00806344596146563
TCD,Haraze al biar,2022,177545,71018,25148,0,0,273711,25148,0.0918779296411178,0.0306259765470393,0.0102086588490131
TCD,Haraze mangueigne,2020,69749,15311,0,0,0,85060,0,0,0,0
TCD,Haraze mangueigne,2021,69069,18713,1749,0,0,89531,1749,0.019535133082396,0.00651171102746535,0.00217057034248845
TCD,Haraze mangueigne,2022,64697,27972,4371,1748,0,98788,6119,0.0619407215451269,0.0265450594539148,0.0127804546661088
TCD,Iriba,2020,163436,41404,13075,0,0,217915,13075,0.0600004588945231,0.020000152964841,0.00666671765494701
TCD,Iriba,2021,141645,56658,19612,4251,0,222166,23863,0.10741067490075,0.0421816719630066,0.0183126330961733
TCD,Iriba,2022,152086,66125,52900,12754,0,283865,65654,0.231285998626108,0.0920719356031917,0.0406750470196122
TCD,Kanem,2020,150911,58950,25938,0,0,235799,25938,0.11000046649901,0.0366668221663366,0.0122222740554455
TCD,Kanem,2021,117899,67617,45078,7074,0,237668,52152,0.219432149048252,0.083065452648232,0.0343027528597315
TCD,Kanem,2022,149808,90156,54093,13523,0,307580,67616,0.21983223876715,0.0879326787610811,0.0390810701461589
TCD,Kaya,2020,47824,14145,5389,0,0,67358,5389,0.0800053445767392,0.0266684481922464,0.0088894827307488
TCD,Kaya,2021,35714,20216,13472,2021,0,71423,15493,0.216918919675735,0.0817383755932963,0.0335341712209108
TCD,Kaya,2022,33736,26954,15499,3369,0,79558,18868,0.23716031071671,0.0931689249771655,0.0404666337067855
TCD,Kimiti,2020,342839,86853,27427,0,0,457119,27427,0.0599996937340167,0.0199998979113389,0.00666663263711297
TCD,Kimiti,2021,368191,105137,36570,0,0,509898,36570,0.0717202263982208,0.0239067421327403,0.00796891404424676
TCD,Kimiti,2022,330906,120648,72389,9652,0,533595,82041,0.153751440699407,0.0572800219892115,0.0231130351671211
TCD,Kouh est,2020,126471,26543,3123,0,0,156137,3123,0.0200016652042757,0.00666722173475858,0.00222240724491953
TCD,Kouh est,2021,135871,34350,6245,0,0,176466,6245,0.0353892534539231,0.0117964178179744,0.00393213927265813
TCD,Kouh est,2022,128151,36771,14389,0,0,179311,14389,0.0802460529471142,0.0267486843157047,0.00891622810523491
TCD,Kouh ouest,2020,64839,9154,2288,0,0,76281,2288,0.029994362947523,0.00999812098250766,0.00333270699416922
TCD,Kouh ouest,2021,62609,15256,4577,0,0,82442,4577,0.0555178185876131,0.0185059395292044,0.00616864650973479
TCD,Kouh ouest,2022,57799,20367,8592,0,0,86758,8592,0.0990340948385163,0.0330113649461721,0.0110037883153907
TCD,La kabbia,2020,333907,13913,0,0,0,347820,0,0,0,0
TCD,La kabbia,2021,319994,38347,6972,0,0,365313,6972,0.0190850038186432,0.00636166793954773,0.00212055597984924
TCD,La kabbia,2022,289347,101072,32487,0,0,422906,32487,0.0768184892150975,0.0256061630716992,0.00853538769056638
TCD,La nya,2020,154162,36912,23884,2171,0,217129,26055,0.119997789332609,0.0433321512403533,0.0166659758331069
TCD,La nya,2021,167475,49940,28227,2171,0,247813,30398,0.122665074067946,0.0438085707099036,0.016549665361471
TCD,La nya,2022,188975,47236,12883,0,0,249094,12883,0.0517194312187367,0.0172398104062456,0.00574660346874852
TCD,La nya pende,2020,141543,19983,4996,0,0,166522,4996,0.0300020417722583,0.0100006805907528,0.00333356019691759
TCD,La nya pende,2021,121560,41167,16467,0,0,179194,16467,0.0918948179068496,0.0306316059689499,0.0102105353229833
TCD,La nya pende,2022,121059,57633,24700,0,0,203392,24700,0.121440371302706,0.0404801237675687,0.0134933745891896
TCD,La pende,2020,192811,32135,19776,2472,0,247194,22248,0.0900021845190417,0.0333341424144599,0.013333656965784
TCD,La pende,2021,190665,44000,24719,2472,0,261856,27191,0.103839514847855,0.0377599393050633,0.0146844915610955
TCD,La pende,2022,220205,61111,12222,0,0,293538,12222,0.0416368579195879,0.0138789526398626,0.00462631754662088
TCD,Lac iro,2020,247130,21490,0,0,0,268620,0,0,0,0
TCD,Lac iro,2021,231013,32234,10615,0,0,273862,10615,0.0387603975725,0.0129201325241667,0.00430671084138889
TCD,Lac iro,2022,230817,41217,13269,0,0,285303,13269,0.0465084489122091,0.0155028163040697,0.0051676054346899
TCD,Lac lere,2020,246603,21679,2710,0,0,270992,2710,0.0100002952116668,0.00333343173722226,0.00111114391240742
TCD,Lac lere,2021,247688,27099,5420,0,0,280207,5420,0.0193428429696617,0.00644761432322057,0.00214920477440686
TCD,Lac lere,2022,242681,38608,11031,0,0,292320,11031,0.0377360426929392,0.0125786808976464,0.00419289363254881
TCD,Lac wey,2020,402637,81547,25483,0,0,509667,25483,0.0499993132771005,0.0166664377590335,0.00555547925301117
TCD,Lac wey,2021,388857,91740,40773,0,0,521370,40773,0.0782035790321653,0.0260678596773884,0.00868928655912947
TCD,Lac wey,2022,338356,183020,73208,0,0,594584,73208,0.123124739313537,0.041041579771179,0.013680526590393
TCD,Loug chari,2020,247722,28150,5630,0,0,281502,5630,0.0199998579050948,0.00666661930169827,0.00222220643389942
TCD,Loug chari,2021,230832,53780,8492,0,0,293104,8492,0.0289726513455975,0.00965755044853249,0.00321918348284416
TCD,Loug chari,2022,222748,96720,23447,0,0,342915,23447,0.0683755449601213,0.0227918483200404,0.00759728277334681
TCD,Mamdi,2020,165860,36149,10632,0,0,212641,10632,0.0499997648619034,0.0166665882873011,0.00555552942910038
TCD,Mamdi,2021,127636,57413,46781,4253,0,236083,51034,0.21616973691456,0.0780615292079481,0.0300238098936015
TCD,Mamdi,2022,76581,74454,48927,12764,0,212726,61691,0.2900021624061,0.116668076931514,0.0522231519523811
TCD,Mandoul occidental,2020,202342,28234,4706,0,0,235282,4706,0.0200015300787991,0.00666717669293302,0.00222239223097767
TCD,Mandoul occidental,2021,205033,42351,9411,0,0,256795,9411,0.0366479098113281,0.0122159699371094,0.00407198997903646
TCD,Mandoul occidental,2022,204983,41485,7070,0,0,253538,7070,0.0278853662961765,0.0092951220987255,0.0030983740329085
TCD,Mandoul oriental,2020,346679,42848,0,0,0,389527,0,0,0,0
TCD,Mandoul oriental,2021,331647,66220,11705,0,0,409572,11705,0.0285786137724259,0.00952620459080862,0.00317540153026954
TCD,Mandoul oriental,2022,319942,101002,15607,0,0,436551,15607,0.0357506912136268,0.0119168970712089,0.00397229902373631
TCD,Mangalme,2020,88254,22064,5806,0,0,116124,5806,0.0499982777031449,0.016666092567715,0.00555536418923832
TCD,Mangalme,2021,109883,24579,10121,0,0,144583,10121,0.0700013141240671,0.023333771374689,0.00777792379156302
TCD,Mangalme,2022,100306,44913,31439,0,0,176658,31439,0.177965334148468,0.0593217780494892,0.0197739260164964
TCD,Mayo boneye,2020,294104,50213,14347,0,0,358664,14347,0.0400012267749203,0.0133337422583068,0.00444458075276892
TCD,Mayo boneye,2021,305557,60973,25106,0,0,391636,25106,0.0641054448518522,0.0213684816172841,0.00712282720576136
TCD,Mayo boneye,2022,312694,82680,29780,0,0,425154,29780,0.0700452071484686,0.0233484023828229,0.00778280079427428
TCD,Mayo dallah,2020,456618,51888,10378,0,0,518884,10378,0.020000616708166,0.00666687223605533,0.00222229074535178
TCD,Mayo dallah,2021,448763,72644,15567,0,0,536974,15567,0.0289902304394626,0.00966341014648754,0.00322113671549585
TCD,Mayo dallah,2022,480516,81593,31682,0,0,593791,31682,0.0533554735588785,0.0177851578529595,0.0059283859509865
TCD,Mayo lemye,2020,103513,17460,3741,0,0,124714,3741,0.0299966322946903,0.00999887743156342,0.00333295914385447
TCD,Mayo lemye,2021,102499,23696,8750,0,0,134945,8750,0.0648412316128793,0.0216137438709598,0.00720458129031992
TCD,Mayo lemye,2022,110016,31250,12500,0,0,153766,12500,0.0812923533160777,0.0270974511053592,0.00903248370178641
TCD,Mayo-binder,2020,79145,5106,851,0,0,85102,851,0.00999976498789688,0.00333325499596563,0.00111108499865521
TCD,Mayo-binder,2021,76592,7527,1702,0,0,85821,1702,0.019831975856725,0.00661065861890835,0.00220355287296945
TCD,Mayo-binder,2022,79675,12990,2598,0,0,95263,2598,0.0272718684064117,0.00909062280213724,0.00303020760071241
TCD,Megri,2020,21372,7656,2871,0,0,31899,2871,0.0900028214050597,0.0300009404683532,0.0100003134894511
TCD,Megri,2021,26136,8612,6699,957,0,42404,7656,0.180549004810867,0.0677058768040751,0.0275838757349936
TCD,Megri,2022,23336,10208,7337,622,0,41503,7959,0.191769269691348,0.0689187127034994,0.0263033194387554
TCD,Mont illi,2020,294477,41573,10393,0,0,346443,10393,0.0299991629214618,0.00999972097382061,0.00333324032460687
TCD,Mont illi,2021,302092,58895,20787,0,0,381774,20787,0.0544484433198699,0.0181494811066233,0.0060498270355411
TCD,Mont illi,2022,305612,79100,14382,0,0,399094,14382,0.036036622950984,0.012012207650328,0.004004069216776
TCD,Monts de lam,2020,283389,47232,6747,0,0,337368,6747,0.0199989329159849,0.00666631097199497,0.00222210365733166
TCD,Monts de lam,2021,256400,86739,33361,0,0,376500,33361,0.0886082337317397,0.0295360779105799,0.00984535930352663
TCD,Monts de lam,2022,224536,110541,48362,0,0,383439,48362,0.126126971956426,0.0420423239854753,0.0140141079951584
TCD,Mourtcha,2020,17475,4959,1181,0,0,23615,1181,0.0500105864916367,0.0166701954972122,0.00555673183240408
TCD,Mourtcha,2021,17533,7792,6494,649,0,32468,7143,0.220001231982259,0.0799967147139748,0.0311075520512505
TCD,Mourtcha,2022,18491,12776,8069,1299,0,40635,9368,0.230540174726221,0.0875025634715557,0.0362714135323954
TCD,Ngourkosso,2020,200673,34261,9789,0,0,244723,9789,0.0400003269002096,0.0133334423000699,0.00444448076668996
TCD,Ngourkosso,2021,173753,72746,24249,0,0,270748,24249,0.0895629884615953,0.0298543294871984,0.00995144316239948
TCD,Ngourkosso,2022,175759,84870,32641,0,0,293270,32641,0.111300167081529,0.037100055693843,0.012366685231281
TCD,Nord kanem,2020,86820,36408,16804,0,0,140032,16804,0.120001142595978,0.040000380865326,0.013333460288442
TCD,Nord kanem,2021,68616,40155,30785,2801,0,142357,33586,0.235927983871534,0.0852012897152932,0.0327728488549523
TCD,Nord kanem,2022,88965,57397,37478,6692,0,190532,44170,0.231824575399408,0.0889824281485525,0.0374658558375729
TCD,Ouara,2020,422112,71200,15257,0,0,508569,15257,0.0299998623588933,0.0099999541196311,0.00333331803987703
TCD,Ouara,2021,371255,125167,25428,0,0,521850,25428,0.0487266455878126,0.0162422151959375,0.00541407173197918
TCD,Ouara,2022,335448,150342,129605,10368,0,625763,139973,0.223683726906193,0.0800840999973898,0.030376605129347
TCD,Tandjile centre,2020,115289,13563,6782,0,0,135634,6782,0.0500022118347907,0.0166674039449302,0.00555580131497674
TCD,Tandjile centre,2021,115302,24414,10851,0,0,150567,10851,0.0720675845304748,0.0240225281768249,0.00800750939227498
TCD,Tandjile centre,2022,105082,29474,11533,0,0,146089,11533,0.0789450266618294,0.0263150088872765,0.00877166962909216
TCD,Tandjile est,2020,333571,47092,11773,0,0,392436,11773,0.0299997961451039,0.00999993204836797,0.00333331068278932
TCD,Tandjile est,2021,294328,78487,19622,0,0,392437,19622,0.0500003822269562,0.0166667940756521,0.00555559802521735
TCD,Tandjile est,2022,333387,104738,58188,0,0,496313,58188,0.117240531680613,0.0390801772268709,0.0130267257422903
TCD,Tandjile ouest,2020,432996,49204,9841,0,0,492041,9841,0.0200003658231733,0.00666678860772442,0.00222226286924147
TCD,Tandjile ouest,2021,423145,68886,19682,0,0,511713,19682,0.0384629665457004,0.0128209888485668,0.00427366294952227
TCD,Tandjile ouest,2022,375436,133717,46287,0,0,555440,46287,0.0833339334581593,0.0277779778193864,0.00925932593979548
TCD,Tibesti est,2020,15691,5003,2047,0,0,22741,2047,0.0900136317664131,0.0300045439221377,0.0100015146407126
TCD,Tibesti est,2021,17096,5912,5003,910,0,28921,5913,0.204453511289374,0.0786395122344778,0.0332053986146168
TCD,Tibesti est,2022,15206,6128,4766,1096,0,27196,5862,0.215546403882924,0.0852821493356866,0.0373829484728146
TCD,Tibesti ouest,2020,11925,3858,1754,0,0,17537,1754,0.100017106688715,0.0333390355629051,0.0111130118543017
TCD,Tibesti ouest,2021,12002,4384,3683,526,0,20595,4209,0.204369992716679,0.0766367241239783,0.0312211701869386
TCD,Tibesti ouest,2022,12602,5251,3851,1014,0,22718,4865,0.214147372127828,0.0862605276286058,0.0386722227113107
TCD,Wadi bissam,2020,118151,15112,4122,0,0,137385,4122,0.030003275466754,0.0100010918222513,0.00333369727408378
TCD,Wadi bissam,2021,96170,39396,19698,2626,0,157890,22324,0.141389575020584,0.0526738024362953,0.0212538968761655
TCD,Wadi bissam,2022,32830,59094,32830,6566,0,131320,39396,0.3,0.116666666666667,0.05
TCD,Wadi hawar,2020,23177,6799,927,0,0,30903,927,0.0299970876613921,0.00999902922046403,0.00333300974015468
TCD,Wadi hawar,2021,94362,21776,4839,0,0,120977,4839,0.0399993387172768,0.0133331129057589,0.00444437096858632
TCD,Wadi hawar,2022,85876,50681,32379,2816,0,171752,35195,0.204917555545205,0.0737710963094074,0.0282338617438063
TCD,Wayi,2020,215102,73841,32105,0,0,321048,32105,0.100000622959807,0.0333335409866022,0.0111111803288674
TCD,Wayi,2021,170276,96383,67420,9631,0,343710,77051,0.224174449390475,0.0840650548427453,0.034248510533751
TCD,Wayi,2022,182978,128510,89826,28915,0,430229,118741,0.275994877146822,0.11440109027208,0.053068895350564
TGO,Agou,2020,93038,15506,2215,0,0,110759,2215,0.0199983748498993,0.00666612494996644,0.00222204164998881
TGO,Agou,2021,99683,11076,0,0,0,110759,0,0,0,0
TGO,Agou,2022,97236,12018,3278,0,0,112532,3278,0.0291294920555931,0.00970983068519769,0.00323661022839923
TGO,Akebou,2022,70012,11013,787,0,0,81812,787,0.00961961570429766,0.00320653856809922,0.00106884618936641
TGO,Amou,2020,117452,17754,1366,0,0,136572,1366,0.0100020502006268,0.00333401673354226,0.00111133891118075
TGO,Amou,2021,122915,13657,0,0,0,136572,0,0,0,0
TGO,Amou,2022,113250,25616,2696,0,0,141562,2696,0.0190446588773824,0.00634821962579412,0.00211607320859804
TGO,Anie,2022,140730,20556,1581,0,0,162867,1581,0.0097073071893017,0.00323576906310057,0.00107858968770019
TGO,Assoli,2020,56688,10004,0,0,0,66692,0,0,0,0
TGO,Assoli,2021,55354,10004,1334,0,0,66692,1334,0.0200023990883464,0.00666746636278214,0.00222248878759405
TGO,Assoli,2022,50761,11207,5933,0,0,67901,5933,0.087377210939456,0.0291257369798187,0.00970857899327289
TGO,Ave,2020,109818,12202,0,0,0,122020,0,0,0,0
TGO,Ave,2021,113479,8541,0,0,0,122020,0,0,0,0
TGO,Ave,2022,99942,30103,4816,0,0,134861,4816,0.0357108430161425,0.0119036143387142,0.00396787144623806
TGO,Bas-mono,2022,86971,23119,3303,0,0,113393,3303,0.0291287821999594,0.00970959406665314,0.00323653135555105
TGO,Bassar,2020,134206,18511,1543,0,0,154260,1543,0.0100025930247634,0.00333419767492113,0.00111139922497371
TGO,Bassar,2021,128036,23139,3085,0,0,154260,3085,0.0199987034876183,0.00666623449587277,0.00222207816529092
TGO,Bassar,2022,132563,19808,4571,0,0,156942,4571,0.0291254093869073,0.00970846979563576,0.00323615659854525
TGO,Binah,2020,82051,9117,0,0,0,91168,0,0,0,0
TGO,Binah,2021,77493,13675,0,0,0,91168,0,0,0,0
TGO,Binah,2022,62962,31481,8995,0,0,103438,8995,0.0869603047236025,0.0289867682412009,0.00966225608040028
TGO,Blitta,2020,165124,12429,0,0,0,177553,0,0,0,0
TGO,Blitta,2021,159798,17755,0,0,0,177553,0,0,0,0
TGO,Blitta,2022,145483,21034,12270,0,0,178787,12270,0.0686291508890467,0.0228763836296822,0.00762546120989408
TGO,Centrale,2021,689780,79285,23786,0,0,792851,23786,0.0300005927973856,0.0100001975991285,0.00333339919970951
TGO,Centrale,2022,650137,103071,39643,0,0,792851,39643,0.050000567571965,0.0166668558573217,0.00555561861910722
TGO,Cinkasse,2022,58691,28848,21885,0,0,109424,21885,0.200001827752595,0.0666672759175318,0.0222224253058439
TGO,Dankpen,2020,149293,16588,0,0,0,165881,0,0,0,0
TGO,Dankpen,2021,137681,24882,3318,0,0,165881,3318,0.0200022907988257,0.00666743026627522,0.00222247675542507
TGO,Dankpen,2022,145734,19650,1637,0,0,167021,1637,0.00980116272804019,0.00326705424268006,0.00108901808089335
TGO,Danyi,2020,41532,7597,1519,0,0,50648,1519,0.0299913125888485,0.00999710419628284,0.00333236806542761
TGO,Danyi,2021,41026,8104,1519,0,0,50649,1519,0.0299907204485775,0.00999690681619249,0.00333230227206416
TGO,Danyi,2022,42427,7986,998,0,0,51411,998,0.0194121880531404,0.00647072935104679,0.00215690978368226
TGO,Doufelgou,2020,87196,12310,3077,0,0,102583,3077,0.0299952233800922,0.00999840779336407,0.00333280259778802
TGO,Doufelgou,2021,84118,13336,5129,0,0,102583,5129,0.049998537769416,0.016666179256472,0.00555539308549067
TGO,Doufelgou,2022,60728,38461,13158,0,0,112347,13158,0.117119282223824,0.0390397607412748,0.0130132535804249
TGO,Est-mono,2020,129188,23347,3113,0,0,155648,3113,0.0200002569901316,0.00666675233004386,0.00222225077668129
TGO,Est-mono,2021,136970,18678,0,0,0,155648,0,0,0,0
TGO,Est-mono,2022,133646,24579,3072,0,0,161297,3072,0.0190456115116834,0.00634853717056114,0.00211617905685371
TGO,Haho,2020,278602,37991,0,0,0,316593,0,0,0,0
TGO,Haho,2021,291266,25327,0,0,0,316593,0,0,0,0
TGO,Haho,2022,287711,37527,6255,0,0,331493,6255,0.0188691767246971,0.00628972557489902,0.00209657519163301
TGO,Kara,2021,800426,138345,49409,0,0,988180,49409,0.05,0.0166666666666667,0.00555555555555556
TGO,Kara,2022,662081,247045,79054,0,0,988180,79054,0.0799995952154466,0.0266665317384822,0.0088888439128274
TGO,Keran,2020,92408,23694,2369,0,0,118471,2369,0.0199964548286078,0.00666548494286928,0.00222182831428976
TGO,Keran,2021,91223,24879,2369,0,0,118471,2369,0.0199964548286078,0.00666548494286928,0.00222182831428976
TGO,Keran,2022,97318,32044,2374,0,0,131736,2374,0.0180208902653792,0.00600696342179308,0.00200232114059769
TGO,Kloto,2020,98622,18041,3608,0,0,120271,3608,0.0299989191076818,0.00999963970256061,0.00333321323418687
TGO,Kloto,2021,102230,18041,0,0,0,120271,0,0,0,0
TGO,Kloto,2022,158568,27029,3604,0,0,189201,3604,0.0190485251135036,0.00634950837116788,0.00211650279038929
TGO,Kozah,2020,153421,29223,0,0,0,182644,0,0,0,0
TGO,Kozah,2021,147942,32876,1826,0,0,182644,1826,0.0099975909419417,0.00333253031398057,0.00111084343799352
TGO,Kozah,2022,174772,110689,32041,0,0,317502,32041,0.100915899742364,0.0336386332474546,0.0112128777491515
TGO,Kpele,2022,82226,16445,1935,0,0,100606,1935,0.0192334453213526,0.00641114844045087,0.00213704948015029
TGO,Kpendial- Ouest,2022,53829,38616,24574,0,0,117019,24574,0.210000085456208,0.0700000284854027,0.0233333428284676
TGO,Kpendjal,2020,81388,13728,2942,0,0,98058,2942,0.0300026514919741,0.010000883830658,0.00333362794355268
TGO,Kpendjal,2021,72563,20592,4903,0,0,98058,4903,0.0500010198046054,0.0166670066015351,0.00555566886717838
TGO,Kpendjal,2022,45637,43297,28085,0,0,117019,28085,0.240003760073151,0.0800012533577168,0.0266670844525723
TGO,Lacs,2020,177152,44849,2242,0,0,224243,2242,0.0099980824373559,0.0033326941457853,0.0011108980485951
TGO,Lacs,2021,195091,29152,0,0,0,224243,0,0,0,0
TGO,Lacs,2022,181629,48281,4598,0,0,234508,4598,0.0196070070104218,0.00653566900347394,0.00217855633449131
TGO,Maritime,2021,816291,323925,155484,0,0,1295700,155484,0.12,0.04,0.0133333333333333
TGO,Maritime,2022,932904,259140,103656,0,0,1295700,103656,0.08,0.0266666666666667,0.00888888888888889
TGO,Moyen-mono,2020,84462,11785,1964,0,0,98211,1964,0.0199977599250593,0.00666591997501977,0.00222197332500659
TGO,Moyen-mono,2021,85444,10803,1964,0,0,98211,1964,0.0199977599250593,0.00666591997501977,0.00222197332500659
TGO,Moyen-mono,2022,86294,18422,2909,0,0,107625,2909,0.0270290360046458,0.00900967866821525,0.00300322622273842
TGO,Ogou,2020,105115,11945,2389,0,0,119449,2389,0.0200001674354746,0.00666672247849152,0.00222224082616384
TGO,Ogou,2021,107504,11945,0,0,0,119449,0,0,0,0
TGO,Ogou,2022,225374,27546,5008,0,0,257928,5008,0.0194162712074688,0.00647209040248958,0.00215736346749653
TGO,Oti,2020,129149,18900,9450,0,0,157499,9450,0.0600003809547997,0.0200001269849332,0.00666670899497775
TGO,Oti,2021,129149,23625,4725,0,0,157499,4725,0.0300001904773999,0.0100000634924666,0.00333335449748887
TGO,Oti,2022,70769,37744,20051,0,0,128564,20051,0.155961233315703,0.0519870777719009,0.017329025923967
TGO,Oti-sud,2022,70557,42578,21897,0,0,135032,21897,0.162161561703892,0.0540538539012975,0.0180179513004325
TGO,Plaine du mo,2022,40064,7541,1414,0,0,49019,1414,0.0288459576898754,0.00961531922995845,0.00320510640998615
TGO,Plateaux,2021,1266955,404722,87983,0,0,1759660,87983,0.05,0.0166666666666667,0.00555555555555556
TGO,Plateaux,2022,1161376,475108,123176,0,0,1759660,123176,0.0699998863416796,0.0233332954472266,0.00777776514907552
TGO,Savanes,2021,713544,241346,94440,0,0,1049330,94440,0.0900002858967151,0.030000095298905,0.0100000317663017
TGO,Savanes,2022,598118,314799,136413,0,0,1049330,136413,0.130000095298905,0.043333365099635,0.0144444550332117
TGO,Sotouboua,2020,136304,15315,1532,0,0,153151,1532,0.0100031994567453,0.0033343998189151,0.00111146660630503
TGO,Sotouboua,2021,127115,22973,3063,0,0,153151,3063,0.0199998694099288,0.00666662313664292,0.00222220771221431
TGO,Sotouboua,2022,102615,45089,21767,0,0,169471,21767,0.128440854187442,0.0428136180624807,0.0142712060208269
TGO,Tandjoare,2022,83702,41851,38862,0,0,164415,38862,0.236365295137305,0.078788431712435,0.0262628105708117
TGO,Tandjouare,2020,125645,25735,0,0,0,151380,0,0,0,0
TGO,Tandjouare,2021,122618,27248,1514,0,0,151380,1514,0.0100013211784912,0.00333377372616374,0.00111125790872125
TGO,Tchamba,2020,146732,20239,1687,0,0,168658,1687,0.0100024902465344,0.00333416341551147,0.00111138780517049
TGO,Tchamba,2021,143359,23612,1687,0,0,168658,1687,0.0100024902465344,0.00333416341551147,0.00111138780517049
TGO,Tchamba,2022,136653,34997,9999,0,0,181649,9999,0.0550457200424996,0.0183485733474998,0.00611619111583328
TGO,Tchaoudjo,2020,217786,29698,0,0,0,247484,0,0,0,0
TGO,Tchaoudjo,2021,210361,34648,2475,0,0,247484,2475,0.0100006465064408,0.00333354883548027,0.00111118294516009
TGO,Tchaoudjo,2022,153899,68400,36643,0,0,258942,36643,0.14151045407852,0.0471701513595065,0.0157233837865022
TGO,Tone,2020,336821,25628,3661,0,0,366110,3661,0.00999972685804813,0.00333324228601604,0.00111108076200535
TGO,Tone,2021,322177,43933,0,0,0,366110,0,0,0,0
TGO,Tone,2022,216930,115696,57848,0,0,390474,57848,0.148148148148148,0.0493827160493827,0.0164609053497942
TGO,Vo,2020,220163,40771,10872,0,0,271806,10872,0.0399991170172844,0.0133330390057615,0.00444434633525382
TGO,Vo,2021,247343,24463,0,0,0,271806,0,0,0,0
TGO,Vo,2022,222832,61013,7958,0,0,291803,7958,0.0272718237989328,0.00909060793297761,0.00303020264432587
TGO,Wawa,2020,108703,20955,1310,0,0,130968,1310,0.0100024433449392,0.00333414778164641,0.00111138259388214
TGO,Wawa,2021,112632,18335,0,0,0,130967,0,0,0,0
TGO,Wawa,2022,115077,18102,2586,0,0,135765,2586,0.0190476190476191,0.00634920634920635,0.00211640211640212
TGO,Yoto,2020,162531,49187,2139,0,0,213857,2139,0.0100020106893859,0.00333400356312863,0.00111133452104288
TGO,Yoto,2021,175362,38494,0,0,0,213856,0,0,0,0
TGO,Yoto,2022,174838,43710,4163,0,0,222711,4163,0.0186923860967801,0.00623079536559338,0.00207693178853113
TGO,Zio,2020,320484,36009,3601,0,0,360094,3601,0.0100001666231595,0.0033333888743865,0.0011111296247955
TGO,Zio,2021,331286,28808,0,0,0,360094,0,0,0,0
TGO,Zio,2022,316213,46188,7106,0,0,369507,7106,0.0192310294527573,0.00641034315091911,0.00213678105030637
TZA,Bahi,2020,121981,162641,40660,0,0,325282,40660,0.124999231436108,0.0416664104787026,0.0138888034929009
TZA,Bahi DC,2022,201531,88869,29623,0,0,320023,29623,0.0925652218746778,0.0308550739582259,0.010285024652742
TZA,Chamwino,2020,162104,202630,60789,20263,0,445786,81052,0.181818181818182,0.0757575757575757,0.0353535353535354
TZA,Handeni DC,2022,181726,85659,85659,17132,0,370176,102791,0.277681427213001,0.107987371772706,0.0462803879475949
TZA,Handeni TC,2022,67895,29777,14889,0,0,112561,14889,0.13227494425245,0.0440916480841499,0.01469721602805
TZA,Kaskazini A,2017,18620,74480,24827,12413,0,130340,37240,0.285714285714286,0.126983274512813,0.0634912110207492
TZA,Kishapu,2020,154715,154715,85953,17191,0,412574,103144,0.250001211903804,0.0972229628301024,0.0416671379625904
TZA,Kongwa,2020,191851,172665,57555,19185,0,441256,76740,0.173912649346411,0.072463603894338,0.0338163484840244
TZA,Korogwe,2020,141395,113116,28279,0,0,282790,28279,0.1,0.0333333333333333,0.0111111111111111
TZA,Korogwe DC,2022,178361,90933,44590,15156,0,329040,59746,0.181576707999027,0.0758793257152119,0.0355289461598725
TZA,Korogwe TC,2022,58798,27137,13569,4523,0,104027,18092,0.173916387091813,0.0724651612882553,0.0338170752678525
TZA,Kusini,2017,29925,9107,3903,0,0,42935,3903,0.0909048561779434,0.0303016187259811,0.010100539575327
TZA,Longido,2020,50263,71805,35902,7180,0,165150,43082,0.260865879503482,0.101447169240085,0.0434769737948666
TZA,Longido,2022,59737,44803,54945,15699,0,175184,70644,0.403256005114622,0.164290117818979,0.0746776722379517
TZA,Magharibi,2017,45726,388668,45726,0,0,480120,45726,0.0952386903274181,0.0317462301091394,0.0105820767030465
TZA,Manyoni,2020,113301,79311,33990,11330,0,237932,45320,0.190474589378478,0.0793644122410325,0.0370367257124818
TZA,Manyoni,2022,151336,49114,29468,0,0,229918,29468,0.128167433606764,0.0427224778689214,0.0142408259563071
TZA,Meatu,2022,386268,92597,46299,0,0,525164,46299,0.0881610316015568,0.0293870105338523,0.00979567017795076
TZA,Micheweni,2017,15510,66473,27697,5539,0,115219,33236,0.288459368680513,0.112177679028632,0.0480755970996296
TZA,Mkinga,2020,80223,86908,13371,0,0,180502,13371,0.0740767415319498,0.0246922471773166,0.00823074905910553
TZA,Mkinga,2022,80533,41679,29285,7321,0,158818,36606,0.230490246697478,0.0921956789112905,0.0409756240896288
TZA,Mkoani district,2017,25850,72380,5170,0,0,103400,5170,0.05,0.0166666666666667,0.00555555555555556
TZA,Monduli,2022,97896,81714,39158,10214,0,228982,49372,0.215615201194854,0.086740442480195,0.038825953325783
TZA,Mpwapwa,2020,265258,113682,56841,37894,0,473675,94735,0.2,0.0933333333333333,0.0488888888888889
TZA,Musoma,2020,82922,124382,82922,13820,0,304046,96742,0.318182117179637,0.121211921880242,0.0505047847292113
TZA,Musoma DC,2022,209999,92892,15482,0,0,318373,15482,0.0486284955068426,0.0162094985022809,0.00540316616742696
TZA,Mwanga,2020,114385,30503,15251,7626,0,167765,22877,0.13636336542187,0.0606066024895936,0.0303036323958447
TZA,Mwanga,2022,103628,40671,32536,8134,0,184969,40670,0.219874681703421,0.0879498726813682,0.0390888323028303
TZA,Nzega,2020,322336,134307,80584,26861,0,564088,107445,0.190475599551843,0.0793646854155144,0.0370367744039937
TZA,Rorya,2020,209576,122253,34929,0,0,366758,34929,0.095237186373576,0.031745728791192,0.010581909597064
TZA,Rorya,2022,264327,117620,39207,0,0,421154,39207,0.0930942125683242,0.0310314041894414,0.0103438013964805
TZA,Same,2020,171948,93790,46895,31263,0,343896,78158,0.227272198571661,0.106060165476384,0.0555552324604596
TZA,Same,2022,213242,83783,67027,16757,0,380809,83784,0.220015808449905,0.0880064984458526,0.0391140965680958
TZA,Shinyanga,2020,271361,125244,41748,20874,0,459227,62622,0.136363933305315,0.0606061925801401,0.0303030962900701
TZA,Simanjiro,2020,78570,112243,44897,11224,0,246934,56121,0.227271254667239,0.0909082318892228,0.0404035086298363
UGA,Abim,2018,38136,81720,16344,0,0,136200,16344,0.12,0.04,0.0133333333333333
UGA,Abim,2019,31326,74910,29964,0,0,136200,29964,0.22,0.0733333333333333,0.0244444444444444
UGA,Abim,2020,84425,53725,30700,7675,0,176525,38375,0.217391304347826,0.0869565217391304,0.0386473429951691
UGA,Abim,2021,89595,57015,32580,8145,0,187335,40725,0.217391304347826,0.0869565217391304,0.0386473429951691
UGA,Abim,2022,77670,69040,51780,8630,0,207120,60410,0.291666666666667,0.111111111111111,0.0462962962962963
UGA,Acholi Region,2017,1390664,259984,129992,0,0,1780640,129992,0.0730029652259862,0.0243343217419954,0.00811144058066513
UGA,Adjumani District,2020,106155,106155,35385,11795,0,259490,47180,0.181818181818182,0.0757575757575758,0.0353535353535354
UGA,Adjumani Refugee settlement,2020,64343,96515,53619,10724,0,225201,64343,0.28571365136034,0.111111111111111,0.047619188586591
UGA,Amudat,2018,63393,48477,12430,0,0,124300,12430,0.1,0.0333333333333333,0.0111111111111111
UGA,Amudat,2019,55935,49720,18645,0,0,124300,18645,0.15,0.05,0.0166666666666667
UGA,Amudat,2020,67450,53960,20235,0,0,141645,20235,0.142857142857143,0.0476190476190476,0.0158730158730159
UGA,Amudat,2021,98280,42120,14040,0,0,154440,14040,0.0909090909090909,0.0303030303030303,0.0101010101010101
UGA,Amudat,2022,73050,51135,36525,7305,0,168015,43830,0.260869565217391,0.101449275362319,0.0434782608695652
UGA,Amuria,2018,77000,215600,15400,0,0,308000,15400,0.05,0.0166666666666667,0.00555555555555556
UGA,Amuria,2019,46200,209440,52360,0,0,308000,52360,0.17,0.0566666666666667,0.0188888888888889
UGA,Arua (Madi Okollo & Terego),2020,366080,457600,137280,45760,0,1006720,183040,0.181818181818182,0.0757575757575758,0.0353535353535354
UGA,Arua City,2020,32580,28960,10860,3620,0,76020,14480,0.19047619047619,0.0793650793650794,0.037037037037037
UGA,Bidibidi,2020,81453,69817,81453,23272,0,255995,104725,0.409090021289478,0.166666015612284,0.0757571219924
UGA,Bukedea,2018,83615,126617,28668,0,0,238900,28668,0.12,0.04,0.0133333333333333
UGA,Bukedea,2019,59725,131395,47780,0,0,238900,47780,0.2,0.0666666666666667,0.0222222222222222
UGA,Central Region,2017,7501845,1323855,597702,0,0,9423402,597702,0.0634274118837337,0.0211424706279112,0.00704749020930375
UGA,Central division,2020,41900,33520,8380,4190,0,87990,12570,0.142857142857143,0.0634920634920635,0.0317460317460318
UGA,East-Central Region,2017,3209527,1883700,376740,0,0,5469967,376740,0.0688742729160889,0.0229580909720296,0.00765269699067654
UGA,Elgon Region,2017,3371100,962675,0,0,0,4333775,0,0,0,0
UGA,Fort Portal City,2020,27360,27360,6080,3040,0,63840,9120,0.142857142857143,0.0634920634920635,0.0317460317460317
UGA,Gulu City,2020,62090,70960,44350,17740,0,195140,62090,0.318181818181818,0.136363636363636,0.0656565656565657
UGA,Hoima Municipality,2020,61350,42945,18405,6135,0,128835,24540,0.19047619047619,0.0793650793650794,0.037037037037037
UGA,Imvepi,2020,19833,23139,19833,6611,0,69416,26444,0.380949636971303,0.15872901540471,0.0740735405221979
UGA,Isingiro,2020,268380,268380,119280,0,0,656040,119280,0.181818181818182,0.0606060606060606,0.0202020202020202
UGA,Jinja City,2020,33360,37530,16680,8340,0,95910,25020,0.260869565217391,0.115942028985507,0.0579710144927536
UGA,Kaabong,2018,27705,114514,42481,0,0,184700,42481,0.23,0.0766666666666667,0.0255555555555556
UGA,Kaabong,2019,27705,96044,57257,3694,0,184700,60951,0.33,0.116666666666667,0.0433333333333333
UGA,Kaabong,2020,37620,62700,31350,12540,0,144210,43890,0.304347826086957,0.130434782608696,0.0628019323671498
UGA,Kaabong,2021,45010,57870,38580,12860,0,154320,51440,0.333333333333333,0.138888888888889,0.0648148148148148
UGA,Kaabong,2022,35300,56480,56480,14120,0,162380,70600,0.434782608695652,0.173913043478261,0.0772946859903382
UGA,Kampala refugees,2020,8025,44136,28087,4012,0,84260,32099,0.380951815808213,0.142855447424638,0.0581994883561463
UGA,Kamwenge,2020,167600,134080,33520,16760,0,351960,50280,0.142857142857143,0.0634920634920635,0.0317460317460318
UGA,Karamoja Region,2017,594964,370755,123096,0,0,1088815,123096,0.113055018529319,0.0376850061764395,0.0125616687254798
UGA,Karenga,2020,44525,20550,6850,3425,0,75350,10275,0.136363636363636,0.0606060606060606,0.0303030303030303
UGA,Karenga,2021,38445,27960,6990,3495,0,76890,10485,0.136363636363636,0.0606060606060606,0.0303030303030303
UGA,Karenga,2022,24720,27810,18540,3090,0,74160,21630,0.291666666666667,0.111111111111111,0.0462962962962963
UGA,Kasese Municipality,2020,46160,40390,23080,11540,0,121170,34620,0.285714285714286,0.126984126984127,0.0634920634920635
UGA,Katakwi,2018,64575,108855,11070,0,0,184500,11070,0.06,0.02,0.00666666666666667
UGA,Katakwi,2019,44280,112545,27675,0,0,184500,27675,0.15,0.05,0.0166666666666667
UGA,Kawempe division,2020,151080,169965,56655,18885,0,396585,75540,0.19047619047619,0.0793650793650794,0.037037037037037
UGA,Kikuube (from Hoima),2020,125545,179350,89675,35870,0,430440,125545,0.291666666666667,0.125,0.0601851851851852
UGA,Kiryandongo District,2020,141210,125520,47070,15690,0,329490,62760,0.19047619047619,0.0793650793650794,0.037037037037037
UGA,Kiryandongo Refuge Settlement,2020,27085,27085,16928,6771,0,77869,23699,0.304344475978888,0.130432735320431,0.0628006295473452
UGA,Koboko,2020,90300,129000,64500,0,0,283800,64500,0.227272727272727,0.0757575757575758,0.0252525252525253
UGA,Kotido,2018,71136,86944,39520,0,0,197600,39520,0.2,0.0666666666666667,0.0222222222222222
UGA,Kotido,2019,61256,77064,49400,9880,0,197600,59280,0.3,0.116666666666667,0.05
UGA,Kotido,2020,82600,82600,51625,10325,0,227150,61950,0.272727272727273,0.106060606060606,0.0454545454545455
UGA,Kotido,2021,73815,73815,73815,21090,0,242535,94905,0.391304347826087,0.159420289855072,0.072463768115942
UGA,Kotido,2022,53825,96885,96885,10765,0,258360,107650,0.416666666666667,0.152777777777778,0.0601851851851852
UGA,Kumi,2018,161100,80550,26850,0,0,268500,26850,0.1,0.0333333333333333,0.0111111111111111
UGA,Kumi,2019,93975,120825,53700,0,0,268500,53700,0.2,0.0666666666666667,0.0222222222222222
UGA,Kyaka II,2020,55520,30845,30845,18507,0,135717,49352,0.363639043008614,0.166667894712281,0.0858592184881448
UGA,Kyangwali R/S,2020,55368,36912,43064,12304,0,147648,55368,0.375,0.152777777777778,0.0694444444444445
UGA,Kyegegwa,2020,308700,110250,88200,0,0,507150,88200,0.173913043478261,0.0579710144927536,0.0193236714975845
UGA,Lamwo,2020,57520,57520,50330,7190,0,172560,57520,0.333333333333333,0.125,0.0509259259259259
UGA,Lango Region,2017,1944885,434920,0,0,0,2379805,0,0,0,0
UGA,Lira Municipality,2020,46601,52426,17475,11650,0,128152,29125,0.227269180348336,0.106058950829224,0.0555546885295933
UGA,Lobule,2020,1929,2480,1378,276,0,6063,1654,0.27280224311397,0.106108087305514,0.045485366613521
UGA,Lubaga division,2020,213650,192285,64095,21365,0,491395,85460,0.173913043478261,0.072463768115942,0.0338164251207729
UGA,Makindye division,2020,219150,175320,43830,21915,0,460215,65745,0.142857142857143,0.0634920634920635,0.0317460317460317
UGA,Masaka City,2020,46640,58300,17490,5830,0,128260,23320,0.181818181818182,0.0757575757575758,0.0353535353535354
UGA,Mbale City,2020,50085,44520,16695,5565,0,116865,22260,0.19047619047619,0.0793650793650794,0.037037037037037
UGA,Mbarara City,2020,110651,88520,22130,11065,0,232366,33195,0.142856528063486,0.0634917902504382,0.0317458951252191
UGA,Moroto,2018,33960,65656,13584,0,0,113200,13584,0.12,0.04,0.0133333333333333
UGA,Moroto,2019,33960,52072,27168,0,0,113200,27168,0.24,0.08,0.0266666666666667
UGA,Moroto,2020,47400,59250,29625,5925,0,142200,35550,0.25,0.0972222222222222,0.0416666666666667
UGA,Moroto,2021,42420,54540,30300,12120,0,139380,42420,0.304347826086957,0.130434782608696,0.0628019323671498
UGA,Moroto,2022,37140,43330,43330,18570,0,142370,61900,0.434782608695652,0.188405797101449,0.0917874396135266
UGA,Mukono Municipality,2020,86085,86085,28695,9565,0,210430,38260,0.181818181818182,0.0757575757575758,0.0353535353535354
UGA,Nabilatuk,2020,26910,35880,31395,8970,0,103155,40365,0.391304347826087,0.159420289855072,0.072463768115942
UGA,Nabilatuk,2021,37520,42210,23450,9380,0,112560,32830,0.291666666666667,0.125,0.0601851851851852
UGA,Nabilatuk,2022,39280,34370,34370,4910,0,112930,39280,0.347826086956522,0.130434782608696,0.0531400966183575
UGA,Nakapiripirit,2018,46525,120965,18610,0,0,186100,18610,0.1,0.0333333333333333,0.0111111111111111
UGA,Nakapiripirit,2019,46525,120965,18610,0,0,186100,18610,0.1,0.0333333333333333,0.0111111111111111
UGA,Nakapiripirit,2020,39655,62315,22660,0,0,124630,22660,0.181818181818182,0.0606060606060606,0.0202020202020202
UGA,Nakapiripirit,2021,59050,59050,17715,0,0,135815,17715,0.130434782608696,0.0434782608695652,0.0144927536231884
UGA,Nakapiripirit,2022,49200,55350,24600,6150,0,135300,30750,0.227272727272727,0.0909090909090909,0.0404040404040404
UGA,Nakawa division,2020,159075,159075,35350,17675,0,371175,53025,0.142857142857143,0.0634920634920635,0.0317460317460317
UGA,Nakivale,2020,46445,53080,33175,13270,0,145970,46445,0.318181818181818,0.136363636363636,0.0656565656565657
UGA,Napak,2018,47337,88566,16797,0,0,152700,16797,0.11,0.0366666666666667,0.0122222222222222
UGA,Napak,2019,47337,80931,24432,0,0,152700,24432,0.16,0.0533333333333333,0.0177777777777778
UGA,Napak,2020,79150,71235,31660,7915,0,189960,39575,0.208333333333333,0.0833333333333333,0.037037037037037
UGA,Napak,2021,64400,72450,48300,8050,0,193200,56350,0.291666666666667,0.111111111111111,0.0462962962962963
UGA,Napak,2022,40900,65440,65440,16360,0,188140,81800,0.434782608695652,0.173913043478261,0.0772946859903382
UGA,Ngora,2018,55055,83369,18876,0,0,157300,18876,0.12,0.04,0.0133333333333333
UGA,Ngora,2019,28314,91234,37752,0,0,157300,37752,0.24,0.08,0.0266666666666667
UGA,Obongi,2020,14730,19640,14730,4910,0,54010,19640,0.363636363636364,0.151515151515152,0.0707070707070707
UGA,Oruchinga,2020,2769,3956,1582,396,0,8703,1978,0.227277950132138,0.0909265004404612,0.040420289299986
UGA,Palabek Refugee Settlement,2020,16142,18832,18832,2690,0,56496,21522,0.380947323704333,0.142853771358444,0.0581988105352591
UGA,Palorinya,2020,36843,55265,36843,12281,0,141232,49124,0.347824855556814,0.144927023148673,0.0676326108027139
UGA,Rhino Camp,2020,36049,48066,42057,6008,0,132180,48065,0.363632924799516,0.136362031573107,0.0555547149509928
UGA,Rwamwanja,2020,32700,29066,14533,3633,0,79932,18166,0.227268177951259,0.0909064371382342,0.04040239759351
UGA,Serere,2018,216255,99810,16635,0,0,332700,16635,0.05,0.0166666666666667,0.00555555555555555
UGA,Serere,2019,216255,99810,16635,0,0,332700,16635,0.05,0.0166666666666667,0.00555555555555555
UGA,South-Western,2017,4184349,1238076,309519,0,0,5731944,309519,0.0539989574217752,0.0179996524739251,0.00599988415797503
UGA,Teso Region,2017,1719828,1103577,193610,0,0,3017015,193610,0.064172700500329,0.0213909001667763,0.00713030005559211
UGA,Wakiso Municipalities,2020,755850,604680,151170,75585,0,1587285,226755,0.142857142857143,0.0634920634920635,0.0317460317460317
UGA,West Nile Region,2017,2376442,1041180,144905,0,0,3562527,144905,0.0406747794472856,0.0135582598157619,0.00451941993858729
UGA,Western Region,2017,4706076,886770,0,0,0,5592846,0,0,0,0
UGA,Yumbe,2020,265440,232260,165900,66360,0,729960,232260,0.318181818181818,0.136363636363636,0.0656565656565657
YEM,Abs,2018,31456,72349,157282,53476,0,314563,210758,0.670002511420606,0.280001144444833,0.131111697462476
YEM,Abs,2020,31500,94500,141500,47000,0,314500,188500,0.599364069952305,0.249602543720191,0.116410528175234
YEM,Abs,2021,15500,63000,141500,94500,0,314500,236000,0.750397456279809,0.350291467938527,0.183536477654125
YEM,Abyan,2017,56800,56800,198800,255600,0,568000,454400,0.8,0.416666666666667,0.238888888888889
YEM,Ad dahi,2018,14973,24955,44918,14973,0,99819,59891,0.599995992746872,0.249999165155598,0.11666672232296
YEM,Ad dahi,2020,10000,25000,45000,20000,0,100000,65000,0.65,0.283333333333333,0.138888888888889
YEM,Ad dahi,2021,10000,25000,45000,20000,0,100000,65000,0.65,0.283333333333333,0.138888888888889
YEM,Ad dhale'e,2018,19825,39650,48901,22468,0,130844,71369,0.545451071504998,0.239055669346703,0.11784432012337
YEM,Ad dhale'e,2020,46258,66083,53000,26500,0,191841,79500,0.414405679703504,0.184180302090446,0.0920901510452232
YEM,Ad dhale'e,2021,26500,26500,53000,26500,0,132500,79500,0.6,0.266666666666667,0.133333333333333
YEM,Ad dis,2018,8937,10366,14656,2145,0,36104,16801,0.465350099711943,0.174920599748874,0.0715094664795529
YEM,Ad dis,2020,7149,21448,7149,3575,0,39321,10724,0.272729584700287,0.121215974500479,0.0606094001226373
YEM,Ad dis,2021,7000,18000,7000,3500,0,35500,10500,0.295774647887324,0.131455399061033,0.0657276995305164
YEM,Ad dulayah,2020,5595,16786,5595,0,0,27976,5595,0.199992851015156,0.0666642836717186,0.0222214278905729
YEM,Ad durayhimi,2018,1971,4598,6569,8102,438,21678,15109,0.696973890580312,0.370375495894455,0.219982368197148
YEM,Ad durayhimi,2019,1095,4598,8978,0,0,14671,8978,0.611955558584964,0.203985186194988,0.067995062064996
YEM,Ad durayhimi,2020,5500,8759,7664,4500,0,26423,12164,0.460356507588086,0.210220893413567,0.107919447282881
YEM,Ad durayhimi,2021,4500,4500,7500,5500,0,22000,13000,0.590909090909091,0.28030303030303,0.148989898989899
YEM,Aden,2017,92500,277500,462500,92500,0,925000,555000,0.6,0.233333333333333,0.1
YEM,Adh dhlia'ah,2018,8393,12589,5595,1399,0,27976,6994,0.25,0.100002382994948,0.0444468274393925
YEM,Adh dhlia'ah,2020,5500,17000,5500,0,0,28000,5500,0.196428571428571,0.0654761904761905,0.0218253968253968
YEM,Adh dhlia'ah,2021,5500,14000,7000,1500,0,28000,8500,0.303571428571429,0.119047619047619,0.0515873015873016
YEM,Aflah al yaman,2018,6240,13729,31202,11233,0,62404,42435,0.680004486891866,0.286669657927911,0.135557549729718
YEM,Aflah al yaman,2020,12500,22000,22000,6000,0,62500,28000,0.448,0.181333333333333,0.0817777777777778
YEM,Aflah al yaman,2021,6000,22000,22000,12500,0,62500,34500,0.552,0.250666666666667,0.128
YEM,Aflah ash shawm,2018,12344,22219,32918,14813,0,82294,47731,0.580005832746008,0.253335601623448,0.124445416568779
YEM,Aflah ash shawm,2020,20500,24500,33000,4000,0,82000,37000,0.451219512195122,0.166666666666667,0.0663956639566396
YEM,Aflah ash shawm,2021,16500,24500,33000,8000,0,82000,41000,0.5,0.199186991869919,0.0880758807588076
YEM,Ahwar,2018,6879,8598,15477,3439,0,34393,18916,0.549995638647399,0.216662305314066,0.0944410522813105
YEM,Ahwar,2020,8598,13757,12038,5159,0,39552,17197,0.434794700647249,0.188410194174757,0.0917891495864797
YEM,Ahwar,2021,5000,10500,14000,5000,0,34500,19000,0.550724637681159,0.231884057971015,0.109500805152979
YEM,Ain,2018,6487,8109,12001,5514,0,32111,17515,0.545451714365794,0.23905619050585,0.117844698424562
YEM,Ain,2020,5000,11500,13000,3000,0,32500,16000,0.492307692307692,0.194871794871795,0.0854700854700855
YEM,Ain,2021,5000,11500,11500,5000,0,33000,16500,0.5,0.217171717171717,0.106060606060606
YEM,Al  hawtah,2018,4879,11850,11850,4879,0,33458,16729,0.5,0.215274871978799,0.104163760867688
YEM,Al  hawtah,2020,10500,17500,5000,1500,0,34500,6500,0.188405797101449,0.0772946859903382,0.035426731078905
YEM,Al  hawtah,2021,8500,17500,7000,1500,0,34500,8500,0.246376811594203,0.0966183574879227,0.0418679549114332
YEM,Al  mukha,2018,18058,27087,27087,15349,1806,89387,44242,0.494948929933883,0.235690499364188,0.13019168832654
YEM,Al  mukha,2020,18000,36000,22500,13500,0,90000,36000,0.4,0.183333333333333,0.0944444444444444
YEM,Al  mukha,2021,13500,31500,31500,13500,0,90000,45000,0.5,0.216666666666667,0.105555555555556
YEM,Al a'rsh,2018,9629,28887,19258,6419,0,64193,25677,0.399996884395495,0.166664070329579,0.0777758737972469
YEM,Al a'rsh,2020,13000,25500,19500,6500,0,64500,26000,0.403100775193798,0.167958656330749,0.078380706287683
YEM,Al a'rsh,2021,13000,22500,22500,6500,0,64500,29000,0.449612403100775,0.183462532299742,0.0835486649440138
YEM,Al abdiyah,2018,4943,5973,7003,2060,0,19979,9063,0.453626307623004,0.185578190433288,0.0847723442948429
YEM,Al abdiyah,2020,5149,6179,8238,3089,0,22655,11327,0.499977929816818,0.212109173839476,0.101002967213517
YEM,Al abdiyah,2021,2000,5000,9500,4000,0,20500,13500,0.658536585365854,0.284552845528455,0.138211382113821
YEM,Al abr,2018,1490,1956,2981,3540,0,9967,6521,0.654259054881108,0.336477040901642,0.191086139816951
YEM,Al abr,2019,1490,3540,2981,0,0,8011,2981,0.372113344151791,0.12403778138393,0.0413459271279768
YEM,Al abr,2020,1863,4658,2500,1500,0,10521,4000,0.380191996958464,0.174254665272629,0.0897675548374151
YEM,Al abr,2021,1000,3500,3500,2000,0,10000,5500,0.55,0.25,0.127777777777778
YEM,Al ashah,2018,5622,8433,16867,20802,3936,55660,41605,0.747484728710025,0.420882740447958,0.270489479778017
YEM,Al ashah,2019,8433,19678,19678,8433,0,56222,28111,0.5,0.21666488800351,0.105553776892399
YEM,Al ashah,2020,5500,8500,28000,14000,0,56000,42000,0.75,0.333333333333333,0.166666666666667
YEM,Al ashah,2021,3000,5500,28000,17000,3000,56500,48000,0.849557522123894,0.418879056047198,0.24188790560472
YEM,Al azariq,2018,6485,19454,27236,9727,1297,64199,38260,0.595959438620539,0.262626105287206,0.134680187126487
YEM,Al azariq,2019,9727,19454,25939,9727,0,64847,35666,0.550002313137077,0.233333847363795,0.111111111111111
YEM,Al azariq,2020,25939,29181,26000,9727,0,90847,35727,0.393265600405077,0.166778576434371,0.0793862207887988
YEM,Al azariq,2021,13000,16000,22500,13000,0,64500,35500,0.550387596899225,0.250645994832041,0.128337639965547
YEM,Al bayda,2017,212800,152000,266000,129200,0,760000,395200,0.52,0.23,0.114444444444444
YEM,Al bayda,2018,11664,17497,23329,5832,0,58322,29161,0.5,0.199998856920773,0.0888877458096621
YEM,Al bayda,2020,17500,20500,17500,3000,0,58500,20500,0.35042735042735,0.133903133903134,0.0560303893637227
YEM,Al bayda,2021,14500,20500,17500,6000,0,58500,23500,0.401709401709402,0.168091168091168,0.0788224121557455
YEM,Al bayda city,2018,4350,10874,20444,7394,0,43062,27838,0.646463239050671,0.272723050485347,0.129064552918531
YEM,Al bayda city,2020,8500,13000,15000,6500,0,43000,21500,0.5,0.217054263565892,0.10594315245478
YEM,Al bayda city,2021,6500,11000,19500,6500,0,43500,26000,0.597701149425287,0.24904214559387,0.116219667943806
YEM,Al buraiqeh,2018,19544,26059,42997,42997,0,131597,85994,0.653464744637036,0.326732372318518,0.181517984621399
YEM,Al buraiqeh,2020,26000,45500,39000,19500,0,130000,58500,0.45,0.2,0.1
YEM,Al buraiqeh,2021,19500,39000,52000,19500,0,130000,71500,0.55,0.233333333333333,0.111111111111111
YEM,Al burayqah,2020,32573,58632,39088,19544,0,149837,58632,0.39130521833726,0.173913430372115,0.0869567151860577
YEM,Al dhaher,2018,3596,5394,8989,15462,2517,35958,26968,0.749986094888481,0.439994808758366,0.288886416869063
YEM,Al dhaher,2020,3500,9000,18000,5500,0,36000,23500,0.652777777777778,0.268518518518519,0.123456790123457
YEM,Al dhaher,2021,3500,9000,16000,7000,0,35500,23000,0.647887323943662,0.28169014084507,0.137715179968701
YEM,Al dhale'e,2017,194400,180000,216000,129600,0,720000,345600,0.48,0.22,0.113333333333333
YEM,Al dhihar,2018,45309,90617,67963,22654,0,226543,90617,0.399999117165395,0.166665930971162,0.0777772382677412
YEM,Al dhihar,2020,79500,79500,45500,22500,0,227000,68000,0.299559471365639,0.132892804698972,0.0663240332843857
YEM,Al dhihar,2021,68000,68000,56500,34000,0,226500,90500,0.399558498896247,0.183222958057395,0.0944321805248958
YEM,Al garrahi,2018,19358,38715,49039,21939,0,129051,70978,0.549999612556276,0.240000723228284,0.117778587104668
YEM,Al garrahi,2020,32500,45000,45000,6500,0,129000,51500,0.39922480620155,0.149870801033592,0.0611541774332472
YEM,Al garrahi,2021,26000,38500,51500,13000,0,129000,64500,0.5,0.200258397932817,0.0891472868217054
YEM,Al ghaydah,2018,13878,19430,12768,9437,0,55513,22205,0.399996397240286,0.189997538114195,0.101109449838576
YEM,Al ghaydah,2020,8500,30500,14000,3000,0,56000,17000,0.303571428571429,0.119047619047619,0.0515873015873016
YEM,Al ghaydah,2021,5500,28000,16500,5500,0,55500,22000,0.396396396396396,0.165165165165165,0.0770770770770771
YEM,Al ghaydhah,2020,19430,33308,13878,2776,0,69392,16654,0.239998847129352,0.0933344862039813,0.0400014090641252
YEM,Al ghayl,2018,998,1997,3994,1498,0,8487,5492,0.647107340638624,0.274537527983976,0.130735896730948
YEM,Al ghayl,2020,1248,3744,3744,1664,0,10400,5408,0.52,0.226666666666667,0.111111111111111
YEM,Al ghayl,2021,1000,1500,3500,2000,0,8000,5500,0.6875,0.3125,0.159722222222222
YEM,Al had,2018,15467,19334,30934,11600,0,77335,42534,0.549996767311049,0.233331178207366,0.111109674360466
YEM,Al had,2020,38668,27068,23201,7734,0,96671,30935,0.320002896421885,0.133335402206108,0.0622236474456892
YEM,Al had,2021,23000,27000,19500,7500,0,77000,27000,0.350649350649351,0.149350649350649,0.0714285714285714
YEM,Al hada,2018,44812,67219,78422,33609,0,224062,112031,0.5,0.216666220361626,0.105555109250515
YEM,Al hada,2020,45000,78500,78500,22500,0,224500,101000,0.44988864142539,0.183370452858203,0.0833951992081168
YEM,Al hada,2021,45000,45000,101000,33500,0,224500,134500,0.599109131403118,0.249443207126949,0.116307844592923
YEM,Al hajjaylah,2018,4999,8498,1500,1000,0,15997,2500,0.156279302369194,0.072930341105624,0.038201607245803
YEM,Al hajjaylah,2020,3500,4000,6500,2500,0,16500,9000,0.545454545454545,0.232323232323232,0.111111111111111
YEM,Al hajjaylah,2021,2500,4000,7500,2500,0,16500,10000,0.606060606060606,0.252525252525253,0.117845117845118
YEM,Al hali,2018,6093,12187,17062,24374,1219,60935,42655,0.70000820546484,0.380006017340882,0.228894176855119
YEM,Al hali,2019,6093,15234,21327,18280,0,60934,39607,0.6499983588801,0.316665025546766,0.172220945795633
YEM,Al hali,2020,6000,18500,24500,12000,0,61000,36500,0.598360655737705,0.265027322404372,0.132058287795993
YEM,Al hali,2021,6000,15000,24500,15000,0,60500,39500,0.652892561983471,0.300275482093664,0.155188246097337
YEM,Al hasayn,2020,18866,25155,15722,9433,0,69176,25155,0.363637677807332,0.166666666666667,0.0858582938205929
YEM,Al hashwah,2018,2408,8026,12038,4013,0,26485,16051,0.606041155370965,0.252520294506324,0.117844482201666
YEM,Al hashwah,2020,2500,5500,14500,4000,0,26500,18500,0.69811320754717,0.283018867924528,0.127882599580713
YEM,Al hashwah,2021,2500,5500,14500,4000,0,26500,18500,0.69811320754717,0.283018867924528,0.127882599580713
YEM,Al hawak,2018,12342,16456,24684,28798,0,82280,53482,0.65,0.333333333333333,0.188888888888889
YEM,Al hawak,2019,16456,24684,32912,8228,0,82280,41140,0.5,0.2,0.0888888888888889
YEM,Al hawak,2020,20500,29000,20500,12500,0,82500,33000,0.4,0.183838383838384,0.0949494949494949
YEM,Al hawak,2021,16500,20500,29000,16500,0,82500,45500,0.551515151515152,0.250505050505051,0.127946127946128
YEM,Al hawtah,2020,12198,17426,15683,3485,0,48792,19168,0.392851287096245,0.154758976881456,0.0674586908600681
YEM,Al haymah ad dakhiliyah,2018,15914,26524,44560,18036,0,105034,62596,0.595959403621684,0.255891742991158,0.123456319964117
YEM,Al haymah ad dakhiliyah,2020,16000,37000,42500,10500,0,106000,53000,0.5,0.199685534591195,0.0885744234800839
YEM,Al haymah ad dakhiliyah,2021,10500,37000,42500,16000,0,106000,58500,0.55188679245283,0.234276729559748,0.111635220125786
YEM,Al haymah al kharijiyah,2018,15064,20336,26362,12804,0,74566,39166,0.525252796180565,0.232322148611074,0.115599305015393
YEM,Al haymah al kharijiyah,2020,11500,26500,26500,11500,0,76000,38000,0.5,0.217105263157895,0.105994152046784
YEM,Al haymah al kharijiyah,2021,7500,22500,30000,15000,0,75000,45000,0.6,0.266666666666667,0.133333333333333
YEM,Al hazm,2018,10443,18450,3481,2437,0,34811,5918,0.170003734451754,0.0800034471862342,0.042224839530289
YEM,Al hazm,2020,7000,17406,12184,5222,0,41812,17406,0.416291973596097,0.180394782996907,0.0878854555311075
YEM,Al hazm,2021,7000,10500,10500,7000,0,35000,17500,0.5,0.233333333333333,0.122222222222222
YEM,Al hudaydah,2017,478350,956700,956700,797250,0,3189000,1753950,0.55,0.266666666666667,0.144444444444444
YEM,Al humaydat,2018,4046,6474,11600,4586,0,26706,16186,0.606081030480042,0.259267580319029,0.12458290687902
YEM,Al humaydat,2020,4000,9500,9500,4000,0,27000,13500,0.5,0.216049382716049,0.104938271604938
YEM,Al humaydat,2021,2500,6500,11000,6500,0,26500,17500,0.660377358490566,0.30188679245283,0.155136268343816
YEM,Al husha,2018,15340,30680,38861,18408,0,103289,57269,0.554454007687169,0.244224134870767,0.121012133162507
YEM,Al husha,2020,25500,25500,30500,20500,0,102000,51000,0.5,0.233660130718954,0.122549019607843
YEM,Al husha,2021,15500,25500,36000,25500,0,102500,61500,0.6,0.282926829268293,0.149593495934959
YEM,Al husn,2018,7636,15655,13364,1909,0,38564,15273,0.396042941603568,0.148515022646337,0.0605054800677661
YEM,Al husn,2020,7500,17000,13500,0,0,38000,13500,0.355263157894737,0.118421052631579,0.0394736842105263
YEM,Al husn,2021,5500,17000,13500,2000,0,38000,15500,0.407894736842105,0.153508771929825,0.0628654970760234
YEM,Al hussein,2018,6289,15722,31444,9433,0,62888,40877,0.649996819743035,0.266664546495357,0.122220808774682
YEM,Al hussein,2020,12500,19000,19000,12500,0,63000,31500,0.5,0.232804232804233,0.121693121693122
YEM,Al hussein,2021,12500,15500,22000,12500,0,62500,34500,0.552,0.250666666666667,0.128
YEM,Al jabin,2018,34107,34107,45021,24557,0,137792,69578,0.504949489084998,0.227722460907261,0.115511463332817
YEM,Al jabin,2020,20500,27500,61500,27500,0,137000,89000,0.64963503649635,0.28345498783455,0.139091646390916
YEM,Al jabin,2021,13500,20500,68000,34000,0,136000,102000,0.75,0.333333333333333,0.166666666666667
YEM,Al jafariyah,2018,28564,34276,39989,11425,0,114254,51414,0.44999737427136,0.183331291099947,0.0833318745952002
YEM,Al jafariyah,2020,23000,34500,40000,17000,0,114500,57000,0.497816593886463,0.215429403202329,0.104803493449782
YEM,Al jafariyah,2021,17000,28500,45500,23000,0,114000,68500,0.600877192982456,0.267543859649123,0.13401559454191
YEM,Al jamimah,2018,9240,18480,22792,11088,0,61600,33880,0.55,0.243333333333333,0.121111111111111
YEM,Al jamimah,2020,9000,15500,27500,9000,0,61000,36500,0.598360655737705,0.248633879781421,0.115664845173042
YEM,Al jamimah,2021,6000,12500,27500,15500,0,61500,43000,0.699186991869919,0.317073170731707,0.161698283649503
YEM,Al jawf,2017,235600,88350,176700,88350,0,589000,265050,0.45,0.2,0.1
YEM,Al jubah,2018,10600,12367,8834,3533,0,35334,12367,0.35000283013528,0.14999716986472,0.0722187631679906
YEM,Al jubah,2020,10600,17667,9000,2000,0,39267,11000,0.280133445386712,0.110355599697795,0.0481037229451929
YEM,Al jubah,2021,5500,16000,10500,3500,0,35500,14000,0.394366197183099,0.164319248826291,0.0766823161189358
YEM,Al khabt,2018,15849,36981,42264,10566,0,105660,52830,0.5,0.2,0.0888888888888889
YEM,Al khabt,2020,21000,31500,37000,16000,0,105500,53000,0.502369668246446,0.218009478672986,0.10637177461822
YEM,Al khabt,2021,16000,26500,42500,21000,0,106000,63500,0.599056603773585,0.265723270440252,0.132599580712788
YEM,Al khalaq,2020,2292,6112,6112,2292,0,16808,8404,0.5,0.212121212121212,0.101010101010101
YEM,Al khalq,2018,4431,8557,1528,1070,0,15586,2598,0.16668805338124,0.078446469053424,0.0414046794131486
YEM,Al khalq,2020,2500,4500,6000,2500,0,15500,8500,0.548387096774194,0.236559139784946,0.114695340501792
YEM,Al khalq,2021,1500,4000,7500,2500,0,15500,10000,0.645161290322581,0.268817204301075,0.125448028673835
YEM,Al khawkhah,2018,5928,9880,11856,11856,0,39520,23712,0.6,0.3,0.166666666666667
YEM,Al khawkhah,2020,8000,14000,10000,8000,0,40000,18000,0.45,0.216666666666667,0.116666666666667
YEM,Al khawkhah,2021,6000,12000,14000,8000,0,40000,22000,0.55,0.25,0.127777777777778
YEM,Al khukhah,2020,5928,13832,13832,5928,0,39520,19760,0.5,0.216666666666667,0.105555555555556
YEM,Al ma'afer,2018,5501,11001,14668,5501,0,36671,20169,0.549998636524774,0.233336060283785,0.111114141056057
YEM,Al ma'afer,2020,30500,45500,45500,30500,0,152000,76000,0.5,0.233552631578947,0.122441520467836
YEM,Al ma'afer,2021,23000,38000,53000,38000,0,152000,91000,0.598684210526316,0.282894736842105,0.149853801169591
YEM,Al maafer,2020,30346,53105,45519,30346,0,159316,75865,0.476191970674634,0.222222919648163,0.116402481720466
YEM,Al madan,2018,10777,14369,33767,12213,0,71126,45980,0.646458397772966,0.272722586208513,0.129065164481187
YEM,Al madan,2020,7500,13000,13000,3500,0,37000,16500,0.445945945945946,0.18018018018018,0.0810810810810811
YEM,Al madan,2021,5500,11000,14500,5500,0,36500,20000,0.547945205479452,0.232876712328767,0.111111111111111
YEM,Al madaribah wa al aarah,2020,25145,25145,25145,7184,0,82619,32329,0.3913022428255,0.159418535687917,0.0724624817266946
YEM,Al madaribah wa al arah,2018,11113,16670,22226,5557,0,55566,27783,0.5,0.200002399548885,0.0888912884377737
YEM,Al madaribah wa al arah,2020,21500,25000,21500,3500,0,71500,25000,0.34965034965035,0.132867132867133,0.0551670551670552
YEM,Al madaribah wa al arah,2021,18000,25000,25000,3500,0,71500,28500,0.398601398601399,0.149184149184149,0.0606060606060606
YEM,Al maflahi,2020,25004,22226,13891,5557,0,66678,19448,0.291670416029275,0.125003749362608,0.0601881013561028
YEM,Al maflahy,2018,14329,23881,42986,14329,0,95525,57315,0.6,0.250000872371979,0.116667539038646
YEM,Al maflahy,2020,25000,16500,11000,3000,0,55500,14000,0.252252252252252,0.102102102102102,0.0460460460460461
YEM,Al maflahy,2021,22000,19500,11000,3000,0,55500,14000,0.252252252252252,0.102102102102102,0.0460460460460461
YEM,Al maghrabah,2018,12015,20024,40049,8010,0,80098,48059,0.600002496941247,0.233334997960831,0.100001109751665
YEM,Al maghrabah,2020,14500,19000,38000,24000,0,95500,62000,0.649214659685864,0.300174520069808,0.155904595695172
YEM,Al maghrabah,2021,9500,14500,38000,28500,5000,95500,71500,0.74869109947644,0.383944153577661,0.229203025014543
YEM,Al mahabishah,2018,5461,9829,14562,6553,0,36405,21115,0.580002746875429,0.253335164583619,0.124445665277969
YEM,Al mahabishah,2020,8000,20000,36000,16000,0,80000,52000,0.65,0.283333333333333,0.138888888888889
YEM,Al mahabishah,2021,4000,16000,32000,28000,0,80000,60000,0.75,0.366666666666667,0.2
YEM,Al maharah,2017,90000,37500,15000,7500,0,150000,22500,0.15,0.0666666666666667,0.0333333333333333
YEM,Al mahfad,2018,16053,21672,28093,13645,0,79463,41738,0.525250745630042,0.232321961164315,0.115599573246528
YEM,Al mahfad,2020,5461,16382,14562,5500,0,41905,20062,0.478749552559361,0.20333293560832,0.0969441461506847
YEM,Al mahfad,2021,3500,11000,16500,5500,0,36500,22000,0.602739726027397,0.251141552511416,0.117199391171994
YEM,Al mahwait,2018,6931,9357,12129,5891,0,34308,18020,0.52524192608138,0.232317049473398,0.115596621455313
YEM,Al mahwait,2020,16000,24000,24000,16000,0,80000,40000,0.5,0.233333333333333,0.122222222222222
YEM,Al mahwait,2021,12000,20000,32000,16000,0,80000,48000,0.6,0.266666666666667,0.133333333333333
YEM,Al mahwait city,2018,6931,9357,12129,5891,0,34308,18020,0.52524192608138,0.232317049473398,0.115596621455313
YEM,Al mahwait city,2020,8500,8500,12000,5000,0,34000,17000,0.5,0.215686274509804,0.104575163398693
YEM,Al mahwait city,2021,7000,7000,12000,8500,0,34500,20500,0.594202898550725,0.280193236714976,0.148148148148148
YEM,Al mahwit,2017,243250,173750,173750,104250,0,695000,278000,0.4,0.183333333333333,0.0944444444444444
YEM,Al makha,2020,22573,40631,22573,13544,0,99321,36117,0.363639109553871,0.166668344727366,0.0858596537153942
YEM,Al makhadir,2018,23843,47687,47687,39739,0,158956,87426,0.550001258209819,0.26666708606994,0.144444584245535
YEM,Al makhadir,2020,47500,55500,47500,8000,0,158500,55500,0.350157728706625,0.1335436382755,0.0557308096740273
YEM,Al makhadir,2021,39500,47500,55500,16000,0,158500,71500,0.451104100946372,0.184016824395373,0.0837714686295128
YEM,Al malagim,2018,15791,19738,35529,7895,0,78953,43424,0.549998100135524,0.21666476680219,0.094442966772074
YEM,Al malagim,2020,12000,14000,12000,2000,0,40000,14000,0.35,0.133333333333333,0.0555555555555556
YEM,Al malagim,2021,10000,12000,14000,4000,0,40000,18000,0.45,0.183333333333333,0.0833333333333333
YEM,Al malah,2020,18042,14033,18042,4009,0,54126,22051,0.407401248937664,0.160489721513998,0.0699561106389618
YEM,Al manar,2018,34181,76907,42726,17091,0,170905,59817,0.350001462800971,0.150001462800971,0.072223359956311
YEM,Al manar,2020,16000,27500,27500,8000,0,79000,35500,0.449367088607595,0.183544303797468,0.0836849507735584
YEM,Al manar,2021,12000,23500,31500,12000,0,79000,43500,0.550632911392405,0.234177215189873,0.111814345991561
YEM,Al mansura,2018,24097,28916,26025,17350,0,96388,43375,0.450004149894178,0.210001936617283,0.110001014418577
YEM,Al mansura,2020,51500,68500,42500,8500,0,171000,51000,0.298245614035088,0.11598440545809,0.0497076023391813
YEM,Al mansura,2021,42500,60000,51500,17000,0,171000,68500,0.400584795321637,0.166666666666667,0.0776478232618583
YEM,Al mansurah,2020,51272,93998,42726,8545,0,196541,51271,0.260866689393053,0.101447874319692,0.043477498899014
YEM,Al mansuriyah,2018,8384,25152,37728,12576,0,83840,50304,0.6,0.25,0.116666666666667
YEM,Al mansuriyah,2020,29000,38500,19500,9500,0,96500,29000,0.300518134715026,0.132987910189983,0.0662061024755325
YEM,Al mansuriyah,2021,19500,33500,29000,14500,0,96500,43500,0.450777202072539,0.200345423143351,0.100172711571675
YEM,Al maqatirah,2018,47877,71816,83785,35908,0,239386,119693,0.5,0.216666805911791,0.10555569480068
YEM,Al maqatirah,2020,29344,25152,29344,12576,0,96416,41920,0.434782608695652,0.188405797101449,0.0917874396135266
YEM,Al maqatirah,2021,21000,29500,25000,8500,0,84000,33500,0.398809523809524,0.166666666666667,0.078042328042328
YEM,Al marawi'ah,2018,47877,71816,83785,35908,0,239386,119693,0.5,0.216666805911791,0.10555569480068
YEM,Al marawi'ah,2020,60000,84000,60000,36000,0,240000,96000,0.4,0.183333333333333,0.0944444444444445
YEM,Al marawi'ah,2021,48000,72000,72000,48000,0,240000,120000,0.5,0.233333333333333,0.122222222222222
YEM,Al mashannah,2018,5986,6952,5021,1931,0,19890,6952,0.349522373051785,0.148868778280543,0.0711971398245908
YEM,Al mashannah,2020,44500,52000,29500,22000,0,148000,51500,0.347972972972973,0.165540540540541,0.0882132132132132
YEM,Al mashannah,2021,37000,44500,37000,29500,0,148000,66500,0.449324324324324,0.216216216216216,0.116366366366366
YEM,Al masilah,2018,1985,4538,5530,2552,0,14605,8082,0.553372132831222,0.242702270911788,0.119730685838183
YEM,Al masilah,2020,6759,11586,5000,1000,0,24345,6000,0.246457178065311,0.0958444581365099,0.0410761963442185
YEM,Al masilah,2021,2000,10500,5000,2000,0,19500,7000,0.358974358974359,0.153846153846154,0.0740740740740741
YEM,Al maslub,2018,7863,18347,16774,8911,0,51895,25685,0.494941709220542,0.222217940071298,0.112230893577844
YEM,Al maslub,2020,3000,7090,4500,1500,0,16090,6000,0.372902423865755,0.155376009944065,0.0725088046405635
YEM,Al maslub,2021,3000,4500,5000,2000,0,14500,7000,0.482758620689655,0.206896551724138,0.0996168582375479
YEM,Al matammah,2018,4769,11923,22416,8585,0,47693,31001,0.650011532090663,0.27667232787481,0.132225320743552
YEM,Al matammah,2020,8000,15500,21000,8000,0,52500,29000,0.552380952380952,0.234920634920635,0.112169312169312
YEM,Al matammah,2021,5000,13000,21000,13000,0,52000,34000,0.653846153846154,0.301282051282051,0.155982905982906
YEM,Al maton,2018,25229,42048,72322,30274,0,169873,102596,0.603957073813967,0.260724188069911,0.126511505000141
YEM,Al maton,2020,5000,16500,16500,9500,0,47500,26000,0.547368421052632,0.249122807017544,0.127485380116959
YEM,Al maton,2021,2500,14500,19000,12000,0,48000,31000,0.645833333333333,0.298611111111111,0.155092592592593
YEM,Al mawasit,2018,7284,11169,21852,8741,0,49046,30593,0.623761366880072,0.267327270997295,0.128713633912835
YEM,Al mawasit,2020,50457,84096,33638,17000,0,185191,50638,0.273436614090318,0.121744577220275,0.0609808852002047
YEM,Al mawasit,2021,25000,67500,50500,25000,0,168000,75500,0.449404761904762,0.199404761904762,0.099537037037037
YEM,Al miftah,2018,6115,12230,31799,10396,0,60540,42195,0.696977205153618,0.289566127078516,0.134682303711045
YEM,Al miftah,2020,5000,14500,22000,7500,0,49000,29500,0.602040816326531,0.251700680272109,0.117913832199546
YEM,Al miftah,2021,2500,12000,24500,9500,0,48500,34000,0.701030927835052,0.298969072164948,0.143184421534937
YEM,Al mighlaf,2018,6014,12028,16038,6014,0,40094,22052,0.550007482416322,0.233334996092516,0.111111111111111
YEM,Al mighlaf,2020,12000,18500,24500,6000,0,61000,30500,0.5,0.199453551912568,0.0883424408014572
YEM,Al mighlaf,2021,9000,15500,27500,9000,0,61000,36500,0.598360655737705,0.248633879781421,0.115664845173042
YEM,Al milah,2018,6014,12028,16038,6014,0,40094,22052,0.550007482416322,0.233334996092516,0.111111111111111
YEM,Al milah,2020,14000,16000,8000,2000,0,40000,10000,0.25,0.1,0.0444444444444444
YEM,Al milah,2021,12000,16000,10000,2000,0,40000,12000,0.3,0.116666666666667,0.05
YEM,Al mina,2018,20218,40437,49872,22914,0,133441,72786,0.545454545454545,0.239056961503586,0.117844840291465
YEM,Al mina,2019,4970,13583,11596,0,0,30149,11596,0.384623038906763,0.128207679635588,0.0427358932118626
YEM,Al mina,2020,6500,10000,13500,3500,0,33500,17000,0.507462686567164,0.203980099502488,0.0912106135986733
YEM,Al mina,2021,5000,8500,15000,5000,0,33500,20000,0.597014925373134,0.248756218905473,0.116086235489221
YEM,Al misrakh,2018,20170,32272,20170,8068,0,80680,28238,0.35,0.15,0.0722222222222222
YEM,Al misrakh,2020,33697,53916,40500,20218,0,148331,60718,0.40934127053684,0.181881512742897,0.0909167859569327
YEM,Al misrakh,2021,20000,40500,54000,20000,0,134500,74000,0.550185873605948,0.232961586121437,0.110698058653449
YEM,Al mualla,2018,24855,41425,71250,29826,0,167356,101076,0.603958029589617,0.260725638758097,0.126512743293737
YEM,Al mualla,2020,28238,40340,20170,8068,0,96816,28238,0.291666666666667,0.125,0.0601851851851852
YEM,Al mualla,2021,20000,24000,24000,12000,0,80000,36000,0.45,0.2,0.1
YEM,Al mudhaffar,2018,7143,8000,8571,5143,0,28857,13714,0.475239976435527,0.217821210336025,0.112212326683685
YEM,Al mudhaffar,2020,66279,74564,25000,16570,0,182413,41570,0.227889459632811,0.106242427897135,0.0556003257565098
YEM,Al mudhaffar,2021,33000,58000,41500,33000,0,165500,74500,0.450151057401813,0.216515609264854,0.11648204095334
YEM,Al mukalla,2018,56405,112809,84607,28202,0,282023,112809,0.399999290837981,0.166666075698318,0.0777773444009886
YEM,Al mukalla,2020,8571,15714,5714,1429,0,31428,7143,0.227281405116457,0.0909168045479615,0.0404098256331933
YEM,Al mukalla,2021,3500,11500,5500,2500,0,23000,8000,0.347826086956522,0.152173913043478,0.0748792270531401
YEM,Al mukalla city,2018,56405,112809,84607,28202,0,282023,112809,0.399999290837981,0.166666075698318,0.0777773444009886
YEM,Al mukalla city,2020,70506,169214,56405,28202,0,324327,84607,0.260869431160526,0.115941626814912,0.057970642112573
YEM,Al mukalla city,2021,56500,169000,56500,0,0,282000,56500,0.200354609929078,0.0667848699763593,0.0222616233254531
YEM,Al munirah,2018,5616,9360,16848,5616,0,37440,22464,0.6,0.25,0.116666666666667
YEM,Al munirah,2020,15500,18500,18500,9000,0,61500,27500,0.447154471544715,0.197831978319783,0.0984643179765131
YEM,Al munirah,2021,15500,15500,18500,12000,0,61500,30500,0.495934959349594,0.230352303523035,0.120144534778681
YEM,Al musaymir,2018,18958,37916,48027,21486,0,126387,69513,0.550001186830924,0.240000949464739,0.117778463502312
YEM,Al musaymir,2019,7488,20591,7488,1872,0,37439,9360,0.25000667752878,0.100002671011512,0.044445631560672
YEM,Al musaymir,2020,14976,17000,13104,5616,0,50696,18720,0.369259902161906,0.160012624270159,0.0779548682341802
YEM,Al musaymir,2021,11000,11000,9500,5500,0,37000,15000,0.405405405405405,0.184684684684685,0.0945945945945946
YEM,Al qabbaytah,2018,495,990,990,495,0,2970,1485,0.5,0.222222222222222,0.111111111111111
YEM,Al qabbaytah,2020,31500,50500,31500,12500,0,126000,44000,0.349206349206349,0.149470899470899,0.0718694885361552
YEM,Al qabbaytah,2021,31500,44000,38000,12500,0,126000,50500,0.400793650793651,0.166666666666667,0.0776014109347443
YEM,Al qaf,2018,693,891,1089,594,0,3267,1683,0.515151515151515,0.232323232323232,0.117845117845118
YEM,Al qaf,2020,1500,1500,500,0,0,3500,500,0.142857142857143,0.0476190476190476,0.0158730158730159
YEM,Al qaf,2021,500,2000,500,0,0,3000,500,0.166666666666667,0.0555555555555556,0.0185185185185185
YEM,Al qaff,2020,1320,2145,495,0,0,3960,495,0.125,0.0416666666666667,0.0138888888888889
YEM,Al qaflah,2018,4966,7448,14897,19862,2483,49656,37242,0.75,0.416666666666667,0.261112006157922
YEM,Al qaflah,2019,12414,17379,14897,4966,0,49656,19863,0.400012083131948,0.166673379517749,0.077781805488427
YEM,Al qaflah,2020,5000,10000,25000,10000,0,50000,35000,0.7,0.3,0.144444444444444
YEM,Al qaflah,2021,2500,5000,25000,15000,2500,50000,42500,0.85,0.416666666666667,0.238888888888889
YEM,Al qafr,2018,14663,36658,43989,51321,0,146631,95310,0.649998977023958,0.333333333333333,0.188889116216898
YEM,Al qafr,2019,29326,51321,43989,21995,0,146631,65984,0.450000340992014,0.200000909312037,0.100000833536034
YEM,Al qafr,2020,36500,36500,44000,29500,0,146500,73500,0.501706484641638,0.234357224118316,0.122866894197952
YEM,Al qafr,2021,29500,29500,51500,36500,0,147000,88000,0.598639455782313,0.282312925170068,0.149281934996221
YEM,Al qahirah,2018,29774,29774,41684,17864,0,119096,59548,0.5,0.21666554712165,0.105554436010539
YEM,Al qahirah,2020,36152,72303,18076,12051,0,138582,30127,0.217394755451646,0.101451366940392,0.0531414212844702
YEM,Al qahirah,2021,18000,48000,30000,24000,0,120000,54000,0.45,0.216666666666667,0.116666666666667
YEM,Al qanawis,2018,19617,44137,24521,9808,0,98083,34329,0.349999490227664,0.149998810531217,0.0722211460361802
YEM,Al qanawis,2020,18000,30000,47500,24000,0,119500,71500,0.598326359832636,0.266387726638773,0.133426313342631
YEM,Al qanawis,2021,18000,24000,47500,30000,0,119500,77500,0.648535564853557,0.299860529986053,0.155741515574152
YEM,Al qatn,2018,6019,14044,14044,6019,0,40126,20063,0.5,0.216667497383243,0.105556386272132
YEM,Al qatn,2020,19617,59000,29425,9808,0,117850,39233,0.332906236741621,0.138710224862113,0.0647310611417527
YEM,Al qatn,2021,10000,54000,29500,5000,0,98500,34500,0.350253807106599,0.133671742808799,0.0558375634517767
YEM,Al qubaytah,2020,37916,50555,44236,12639,0,145346,56875,0.3913076383251,0.159421885248533,0.0724646322874
YEM,Al quraishyah,2018,2057,4937,4937,2057,0,13988,6994,0.5,0.21568487274807,0.104573761636959
YEM,Al quraishyah,2020,12000,14000,10000,4000,0,40000,14000,0.35,0.15,0.0722222222222222
YEM,Al quraishyah,2021,10000,12000,14000,4000,0,40000,18000,0.45,0.183333333333333,0.0833333333333333
YEM,Al talh,2018,30528,50881,87514,34599,0,203522,122113,0.599999017305255,0.256666764936141,0.123333649979418
YEM,Al talh,2020,2000,3500,6000,2000,0,13500,8000,0.592592592592593,0.246913580246914,0.11522633744856
YEM,Al talh,2021,1500,4000,5500,2500,0,13500,8000,0.592592592592593,0.259259259259259,0.127572016460905
YEM,Al udayn,2018,30528,50881,87514,34599,0,203522,122113,0.599999017305255,0.256666764936141,0.123333649979418
YEM,Al udayn,2020,61000,71000,51000,20500,0,203500,71500,0.351351351351351,0.150696150696151,0.0726180726180726
YEM,Al udayn,2021,40500,61000,61000,40500,0,203000,101500,0.5,0.233169129720854,0.122058018609743
YEM,Al wade'a,2018,9652,17051,2895,2574,0,32172,5469,0.169992540096979,0.0833333333333333,0.0455572133117825
YEM,Al wade'a,2020,6500,9500,11500,5000,0,32500,16500,0.507692307692308,0.220512820512821,0.107692307692308
YEM,Al wade'a,2021,5000,9500,13000,5000,0,32500,18000,0.553846153846154,0.235897435897436,0.112820512820513
YEM,Al wadi,2020,9652,12869,11260,4826,0,38607,16086,0.416660191157044,0.180554476303952,0.0879633227134976
YEM,Al wahdah,2018,963,2984,4043,1540,0,9530,5583,0.585834207764953,0.249143057012942,0.118957677509619
YEM,Al wahdah,2020,50000,70500,70500,10000,0,201000,80500,0.400497512437811,0.150082918739635,0.0610834715312327
YEM,Al wahdah,2021,50000,70500,70500,10000,0,201000,80500,0.400497512437811,0.150082918739635,0.0610834715312327
YEM,Al wazi'iyah,2018,866,2984,4043,1540,193,9626,5776,0.600041554124247,0.266708220790914,0.137821178751991
YEM,Al wazi'iyah,2019,1540,3465,2984,0,0,7989,2984,0.373513581174114,0.124504527058038,0.041501509019346
YEM,Al wazi'iyah,2020,1500,3000,3500,2000,0,10000,5500,0.55,0.25,0.127777777777778
YEM,Al wazi'iyah,2021,1500,3000,3500,2000,0,10000,5500,0.55,0.25,0.127777777777778
YEM,Al waziyah,2020,1925,3850,3369,1925,0,11069,5294,0.47827265335622,0.217393922968049,0.111111111111111
YEM,Alluheyah,2018,22759,45519,60692,22759,0,151729,83451,0.550000329534894,0.233332674263544,0.111110378811346
YEM,Alluheyah,2020,43000,60000,43000,25500,0,171500,68500,0.399416909620991,0.182701652089407,0.093942338840298
YEM,Alluheyah,2021,43000,43000,51500,34500,0,172000,86000,0.5,0.233527131782946,0.122416020671835
YEM,Amanat al asimah,2017,646600,808250,1293200,484950,0,3233000,1778150,0.55,0.233333333333333,0.111111111111111
YEM,Amd,2018,6080,8512,10640,5472,0,30704,16112,0.524752475247525,0.234323432343234,0.117711771177118
YEM,Amd,2020,9120,16720,6080,1520,0,33440,7600,0.227272727272727,0.0909090909090909,0.0404040404040404
YEM,Amd,2021,9000,12000,7500,1500,0,30000,9000,0.3,0.116666666666667,0.05
YEM,Amran,2017,263000,263000,368200,157800,0,1052000,526000,0.5,0.216666666666667,0.105555555555556
YEM,Amran,2018,20718,30387,62154,23481,0,136740,85635,0.626261518209741,0.265993856954805,0.126824630685973
YEM,Amran,2020,20500,34500,62000,20500,0,137500,82500,0.6,0.24969696969697,0.116363636363636
YEM,Amran,2021,14000,27500,69000,27500,0,138000,96500,0.699275362318841,0.29951690821256,0.144122383252818
YEM,An nadirah,2018,16129,43011,37635,10753,0,107528,48388,0.450003719961312,0.18333519331399,0.0833343666559201
YEM,An nadirah,2020,32500,37500,27000,11000,0,108000,38000,0.351851851851852,0.151234567901235,0.0730452674897119
YEM,An nadirah,2021,27000,32500,32500,16000,0,108000,48500,0.449074074074074,0.199074074074074,0.0992798353909465
YEM,Anss,2018,64411,55209,46008,18403,0,184031,64411,0.350000815080068,0.150000090564452,0.0722221316577702
YEM,Anss,2020,46000,73500,46000,18500,0,184000,64500,0.35054347826087,0.15036231884058,0.072463768115942
YEM,Anss,2021,46000,55000,55000,27500,0,183500,82500,0.449591280653951,0.199818346957312,0.0999091734786558
YEM,Ar radmah,2018,24347,31303,10434,3478,0,69562,13912,0.19999424973405,0.0833309373891876,0.0388877707816209
YEM,Ar radmah,2020,27000,27000,43500,11000,0,108500,54500,0.502304147465438,0.201228878648233,0.0896057347670251
YEM,Ar radmah,2021,22000,22000,49000,16500,0,109500,65500,0.598173515981735,0.249619482496195,0.116692034500254
YEM,Ar rawdah,2018,22755,39821,39821,11377,0,113774,51198,0.4499973631937,0.183331282483989,0.0833318684409443
YEM,Ar rawdah,2020,11642,15523,11500,2000,0,40665,13500,0.33198081888602,0.127054387474897,0.0532808721668921
YEM,Ar rawdah,2021,11500,13500,9500,4000,0,38500,13500,0.350649350649351,0.151515151515152,0.0735930735930736
YEM,Ar raydah wa qusayar,2018,3606,12622,14425,5409,0,36062,19834,0.549997226997948,0.233329635997264,0.11110802999772
YEM,Ar raydah wa qusayar,2020,14000,41500,10500,3500,0,69500,14000,0.201438848920863,0.0839328537170264,0.0391686650679456
YEM,Ar raydah wa qusayar,2021,14000,28000,21000,7000,0,70000,28000,0.4,0.166666666666667,0.0777777777777778
YEM,Ar raydah wa qussayar,2020,13912,41737,20869,6956,0,83474,27825,0.333337326592712,0.138889554432119,0.0648145929670716
YEM,Ar rujum,2018,22912,32077,27494,9165,0,91648,36659,0.39999781773743,0.166666666666667,0.0777782627250155
YEM,Ar rujum,2020,23000,40000,45500,5500,0,114000,51000,0.447368421052632,0.165204678362573,0.0657894736842105
YEM,Ar rujum,2021,17000,34000,51000,11500,0,113500,62500,0.550660792951542,0.217327459618209,0.0949583945178659
YEM,Ar ryashyyah,2018,1447,5063,5931,2025,0,14466,7956,0.54997926171713,0.229987557030278,0.10776994331536
YEM,Ar ryashyyah,2020,9000,12500,11000,3500,0,36000,14500,0.402777777777778,0.166666666666667,0.0771604938271605
YEM,Ar ryashyyah,2021,9000,11000,12500,3500,0,36000,16000,0.444444444444444,0.180555555555556,0.0817901234567901
YEM,Arhab,2018,21765,27206,48971,10883,0,108825,59854,0.550002297266253,0.21666896393292,0.0944462312070858
YEM,Arhab,2020,13500,32000,41000,4500,0,91000,45500,0.5,0.183150183150183,0.0720390720390721
YEM,Arhab,2021,9000,27500,46000,9000,0,91500,55000,0.601092896174863,0.233151183970856,0.0995749848208865
YEM,Arma,2018,3881,13582,15523,5821,0,38807,21344,0.550003865282037,0.233334192284897,0.111111111111111
YEM,Arma,2020,2000,5000,6000,1500,0,14500,7500,0.517241379310345,0.206896551724138,0.0919540229885057
YEM,Arma,2021,2000,5000,5000,2000,0,14000,7000,0.5,0.214285714285714,0.103174603174603
YEM,Armaa,2020,2893,5786,5786,1447,0,15912,7233,0.454562594268477,0.181833417127535,0.0808195072900955
YEM,As sabain,2018,5034,6002,6970,1936,0,19942,8906,0.446595125865009,0.18122555410691,0.0819821928035748
YEM,As sabain,2020,183500,183500,214000,30500,0,611500,244500,0.399836467702371,0.149904606159717,0.0610520577814118
YEM,As sabain,2021,153000,183500,244500,30500,0,611500,275000,0.44971381847915,0.166530389751976,0.0665939856454983
YEM,As sabrah,2018,20195,30292,40389,10097,0,100973,50486,0.499995048181197,0.199997359029972,0.0888873483230391
YEM,As sabrah,2020,30500,35500,30500,5000,0,101500,35500,0.349753694581281,0.133004926108374,0.0552818828680898
YEM,As sabrah,2021,30500,30500,30500,10000,0,101500,40500,0.399014778325123,0.165845648604269,0.077175697865353
YEM,As saddah,2018,24122,48244,36183,12061,0,120610,48244,0.4,0.166666666666667,0.0777777777777778
YEM,As saddah,2020,60500,42000,12000,6000,0,120500,18000,0.149377593360996,0.0663900414937759,0.033195020746888
YEM,As saddah,2021,48000,42000,24000,6000,0,120000,30000,0.25,0.1,0.0444444444444444
YEM,As safra,2018,9330,25192,41986,16795,0,93303,58781,0.630001178954589,0.270002036376108,0.130001774386199
YEM,As safra,2020,9500,18500,51500,14000,0,93500,65500,0.700534759358289,0.283422459893048,0.12774806892454
YEM,As safra,2021,9500,18500,51500,14000,0,93500,65500,0.700534759358289,0.283422459893048,0.12774806892454
YEM,As said,2018,4933,14798,17265,12332,0,49328,29597,0.600004054492378,0.283334684830793,0.150000450499153
YEM,As said,2020,12332,19731,17500,5000,0,54563,22500,0.412367355167421,0.168001515068209,0.0763643250310039
YEM,As said,2021,10000,17500,15000,7500,0,50000,22500,0.45,0.2,0.1
YEM,As salafiyah,2018,7528,20325,33874,12797,0,74524,46671,0.626254629381139,0.265990374465497,0.126822679047466
YEM,As salafiyah,2020,11500,29000,52000,23000,0,115500,75000,0.649350649350649,0.282828282828283,0.138528138528139
YEM,As salafiyah,2021,6000,23000,58000,29000,0,116000,87000,0.75,0.333333333333333,0.166666666666667
YEM,As salif,2018,7446,10921,22338,8439,0,49144,30777,0.626261598567475,0.265993814097347,0.126824569971241
YEM,As salif,2020,2500,3500,2500,1500,0,10000,4000,0.4,0.183333333333333,0.0944444444444444
YEM,As salif,2021,2500,2500,3000,2000,0,10000,5000,0.5,0.233333333333333,0.122222222222222
YEM,As sawadiyah,2018,26573,70860,53145,26573,0,177151,79718,0.45000028224509,0.200000752653574,0.100000689932443
YEM,As sawadiyah,2020,7000,8500,12000,7000,0,34500,19000,0.550724637681159,0.251207729468599,0.128824476650564
YEM,As sawadiyah,2021,5000,8500,13500,7000,0,34000,20500,0.602941176470588,0.269607843137255,0.13562091503268
YEM,As sawd,2018,3632,7924,9905,11556,0,33017,21461,0.649998485628616,0.333333333333333,0.188889225415863
YEM,As sawd,2020,3500,6500,13000,8500,1500,33000,23000,0.696969696969697,0.348484848484849,0.203703703703704
YEM,As sawd,2021,1500,5000,15000,10000,1500,33000,26500,0.803030303030303,0.398989898989899,0.230639730639731
YEM,As sawm,2018,48339,84594,72509,36255,0,241697,108764,0.450001448094101,0.200001103309791,0.100000781511102
YEM,As sawm,2020,6000,10649,3872,0,0,20521,3872,0.188684761951172,0.0628949206503907,0.0209649735501302
YEM,As sawm,2021,4000,11500,4000,0,0,19500,4000,0.205128205128205,0.0683760683760684,0.0227920227920228
YEM,As sawma'ah,2018,6213,18638,26714,9319,1243,62127,37276,0.599996780787741,0.263336928120356,0.134450399987123
YEM,As sawma'ah,2020,9500,15500,25000,12500,0,62500,37500,0.6,0.266666666666667,0.133333333333333
YEM,As sawma'ah,2021,9500,15500,21500,15500,0,62000,37000,0.596774193548387,0.282258064516129,0.149641577060932
YEM,As sawmaah,2020,9319,18638,24850,15532,0,68339,40382,0.590907095509153,0.272728602993898,0.141415915102975
YEM,As sayyani,2018,56557,80796,16159,8080,0,161592,24239,0.150001237685034,0.0666679043517006,0.0333342959772486
YEM,As sayyani,2020,32500,48500,64500,16000,0,161500,80500,0.498452012383901,0.199174406604747,0.0884072927416581
YEM,As sayyani,2021,32500,40500,56500,32500,0,162000,89000,0.549382716049383,0.25,0.127914951989026
YEM,As silw,2018,12624,25248,15780,9468,0,63120,25248,0.4,0.183333333333333,0.0944444444444444
YEM,As silw,2020,5500,16500,25000,8500,0,55500,33500,0.603603603603604,0.252252252252252,0.118118118118118
YEM,As silw,2021,3000,14000,27500,11000,0,55500,38500,0.693693693693694,0.297297297297297,0.143143143143143
YEM,As sudah,2018,8954,17909,26863,35818,0,89544,62681,0.700002233538819,0.366668900205486,0.21111284830797
YEM,As sudah,2020,4000,8500,17000,10500,2000,42000,29500,0.702380952380952,0.349206349206349,0.203703703703704
YEM,As sudah,2021,2000,6500,19000,12500,2000,42000,33500,0.797619047619048,0.396825396825397,0.23015873015873
YEM,As sukhnah,2018,25014,37521,43775,18761,0,125071,62536,0.50000399772929,0.216668932046598,0.1055569325512
YEM,As sukhnah,2020,37500,50000,25000,12500,0,125000,37500,0.3,0.133333333333333,0.0666666666666667
YEM,As sukhnah,2021,31500,31500,44000,19000,0,126000,63000,0.5,0.216931216931217,0.105820105820106
YEM,Ash sha'ir,2018,9330,25192,41986,16795,0,93303,58781,0.630001178954589,0.270002036376108,0.130001774386199
YEM,Ash sha'ir,2020,34500,17500,6000,0,0,58000,6000,0.103448275862069,0.0344827586206897,0.0114942528735632
YEM,Ash sha'ir,2021,26000,20000,11500,0,0,57500,11500,0.2,0.0666666666666667,0.0222222222222222
YEM,Ash shaghadirah,2018,122373,183560,244747,61187,0,611867,305934,0.500000817171052,0.200000435824561,0.0888891431198828
YEM,Ash shaghadirah,2020,15000,22500,26500,11500,0,75500,38000,0.503311258278146,0.218543046357616,0.106696100073584
YEM,Ash shaghadirah,2021,11500,19000,30000,15000,0,75500,45000,0.596026490066225,0.264900662251656,0.132450331125828
YEM,Ash shahil,2018,20195,30292,40389,10097,0,100973,50486,0.499995048181197,0.199997359029972,0.0888873483230391
YEM,Ash shahil,2020,7500,17500,22500,2500,0,50000,25000,0.5,0.183333333333333,0.0722222222222222
YEM,Ash shahil,2021,2500,15000,25000,7500,0,50000,32500,0.65,0.266666666666667,0.122222222222222
YEM,Ash shaikh outhman,2018,24122,48244,36183,12061,0,120610,48244,0.4,0.166666666666667,0.0777777777777778
YEM,Ash shaikh outhman,2020,35500,71000,53000,17500,0,177000,70500,0.398305084745763,0.165725047080979,0.0772128060263654
YEM,Ash shaikh outhman,2021,26500,53000,71000,26500,0,177000,97500,0.550847457627119,0.233521657250471,0.111111111111111
YEM,Ash shamayatayn,2018,48339,84594,72509,36255,0,241697,108764,0.450001448094101,0.200001103309791,0.100000781511102
YEM,Ash shamayatayn,2020,48339,96679,84594,36500,0,266112,121094,0.455049001924002,0.197403098444765,0.0962810980172091
YEM,Ash shamayatayn,2021,36500,72500,96500,36500,0,242000,133000,0.549586776859504,0.233471074380165,0.111340679522498
YEM,Ash sharyah,2018,4648,16731,15802,9295,0,46476,25097,0.539999139340735,0.246664945348137,0.126665136605751
YEM,Ash sharyah,2020,11500,11500,14000,9500,0,46500,23500,0.505376344086022,0.236559139784946,0.124253285543608
YEM,Ash sharyah,2021,9500,9500,18500,9500,0,47000,28000,0.595744680851064,0.265957446808511,0.133569739952719
YEM,Ash shaykh othman,2020,44288,88576,53145,17715,0,203724,70860,0.347823525946869,0.144926469144529,0.0676323522674468
YEM,Ash shihr,2018,2954,4955,953,953,0,9815,1906,0.194192562404483,0.0970962812022415,0.0539423784456897
YEM,Ash shihr,2020,34000,62080,22575,11287,0,129942,33862,0.26059318772991,0.115818339464274,0.0579087421909604
YEM,Ash shihr,2021,28000,56500,22500,5500,0,112500,28000,0.248888888888889,0.0992592592592593,0.0439506172839506
YEM,Ash shu'ayb,2018,5108,9876,13622,5108,0,33714,18730,0.555555555555556,0.235688438037611,0.112231647914154
YEM,Ash shu'ayb,2020,12500,16000,22000,12500,0,63000,34500,0.547619047619048,0.248677248677249,0.126984126984127
YEM,Ash shu'ayb,2021,12500,12500,22000,16000,0,63000,38000,0.603174603174603,0.285714285714286,0.151675485008818
YEM,Ash shuayb,2020,18936,22092,18936,12624,0,72588,31560,0.434782608695652,0.202898550724638,0.106280193236715
YEM,Aslem,2018,3632,8584,9905,11556,0,33677,21461,0.637259850936841,0.326800684938286,0.185187384730099
YEM,Aslem,2019,8954,26863,31340,22386,0,89543,53726,0.600002233563763,0.283335008506155,0.150001178825319
YEM,Aslem,2020,22500,27000,31500,9000,0,90000,40500,0.45,0.183333333333333,0.0833333333333333
YEM,Aslem,2021,18000,27000,27000,18000,0,90000,45000,0.5,0.233333333333333,0.122222222222222
YEM,Assafi'yah,2018,8295,13825,23779,9401,0,55300,33180,0.6,0.256666666666667,0.123333333333333
YEM,Assafi'yah,2020,63500,84500,53000,10500,0,211500,63500,0.300236406619385,0.116627265563436,0.0499080640924613
YEM,Assafi'yah,2021,42500,74000,74000,21000,0,211500,95000,0.449172576832151,0.182821118991332,0.0830049908064093
YEM,At ta'iziyah,2018,28162,70406,98568,78854,5632,281622,183054,0.649998934742314,0.323331747283001,0.183331636811834
YEM,At ta'iziyah,2019,28162,112649,98568,42243,0,281622,140811,0.5,0.216666311580771,0.10555520046966
YEM,At ta'iziyah,2020,42000,126500,84500,28000,0,281000,112500,0.400355871886121,0.166666666666667,0.0776986951364176
YEM,At ta'iziyah,2021,28000,84500,112500,56500,0,281500,169000,0.600355239786856,0.267021906453523,0.133609630945333
YEM,At taffah,2018,4146,11684,16961,4900,0,37691,21861,0.5800058369372,0.236670115765921,0.107779929779877
YEM,At taffah,2020,7500,9500,15000,5500,0,37500,20500,0.546666666666667,0.231111111111111,0.10962962962963
YEM,At taffah,2021,4000,9500,17000,7500,0,38000,24500,0.644736842105263,0.280701754385965,0.137426900584795
YEM,At tahrir,2018,17489,23610,30605,15740,0,87444,46345,0.529996340515073,0.236665751795435,0.11888878723653
YEM,At tahrir,2020,33000,46500,46500,6500,0,132500,53000,0.4,0.149685534591195,0.0607966457023061
YEM,At tahrir,2021,33000,39500,46500,13000,0,132000,59500,0.450757575757576,0.183080808080808,0.0829124579124579
YEM,At talh,2020,2743,4115,6172,2057,0,15087,8229,0.5454364684828,0.227259671682022,0.106051567574733
YEM,At tawahi,2020,32005,45722,18289,4572,0,100588,22861,0.227273631049429,0.0909087896501902,0.0404035383058726
YEM,At tawilah,2018,53613,125097,132245,42890,0,353845,175135,0.494948353092456,0.205386539303933,0.0953980163944979
YEM,At tawilah,2020,17500,26000,35000,8500,0,87000,43500,0.5,0.199233716475096,0.0881226053639847
YEM,At tawilah,2021,13000,22000,39500,13000,0,87500,52500,0.6,0.24952380952381,0.116190476190476
YEM,At tuhayat,2018,8087,12130,24261,32348,4043,80869,60652,0.750003091419456,0.416665636193515,0.261108157088075
YEM,At tuhayat,2020,28500,28500,16000,8000,0,81000,24000,0.296296296296296,0.131687242798354,0.065843621399177
YEM,At tuhayat,2021,16000,28500,20000,16000,0,80500,36000,0.447204968944099,0.215320910973085,0.115942028985507
YEM,At tuhayta,2020,28304,36391,28304,12130,0,105129,40434,0.384613189510031,0.1666650813128,0.0811954836439042
YEM,Ataq,2018,4146,11684,16961,5654,0,38445,22615,0.588242944466121,0.245103394459618,0.114382740133813
YEM,Ataq,2020,10693,21500,21387,5500,0,59080,26887,0.455094786729858,0.182729632137215,0.0815974573083578
YEM,Ataq,2021,8000,18500,18500,8000,0,53000,26500,0.5,0.216981132075472,0.105870020964361
YEM,Ath'thaorah,2018,13247,33118,63587,22520,0,132472,86107,0.650001509753004,0.273333232683133,0.128888452738021
YEM,Ath'thaorah,2020,143000,125000,71500,18000,0,357500,89500,0.25034965034965,0.1002331002331,0.0445998445998446
YEM,Ath'thaorah,2021,125000,125000,89500,18000,0,357500,107500,0.300699300699301,0.117016317016317,0.0501942501942502
YEM,Attawahi,2018,8020,16040,19783,9624,0,53467,29407,0.550002805468794,0.243333894427092,0.12111104876736
YEM,Attawahi,2020,27500,36500,18500,9000,0,91500,27500,0.300546448087432,0.132969034608379,0.0661809350333941
YEM,Attawahi,2021,18500,32000,27500,13500,0,91500,41000,0.448087431693989,0.198542805100182,0.0989678202792957
YEM,Attyal,2018,4608,11521,22120,7834,0,46083,29954,0.650001084998807,0.273332899333811,0.12888821377852
YEM,Attyal,2020,11500,23000,11500,0,0,46000,11500,0.25,0.0833333333333333,0.0277777777777778
YEM,Attyal,2021,7000,25500,11500,2500,0,46500,14000,0.301075268817204,0.118279569892473,0.0513739545997611
YEM,Ayn,2020,8109,11352,12974,3243,0,35678,16217,0.454537810415382,0.181811387035895,0.0808029847213658
YEM,Az zahir,2018,2957,5492,9505,2957,0,20911,12462,0.595954282435082,0.24578770344157,0.113353418455996
YEM,Az zahir,2020,4000,7500,7500,2000,0,21000,9500,0.452380952380952,0.182539682539683,0.082010582010582
YEM,Az zahir,2021,3000,7500,7500,3000,0,21000,10500,0.5,0.214285714285714,0.103174603174603
YEM,Az zahir (1),2018,6416,9624,10908,5133,0,32081,16041,0.500015585549079,0.220005610797668,0.108891036231206
YEM,Az zahir (1),2020,5000,11000,11000,5000,0,32000,16000,0.5,0.21875,0.107638888888889
YEM,Az zahir (1),2021,6500,8000,13000,5000,0,32500,18000,0.553846153846154,0.235897435897436,0.112820512820513
YEM,Az zaydiyah,2018,56015,60496,67218,38090,0,221819,105308,0.474747429210302,0.21548800298141,0.109988574268009
YEM,Az zaydiyah,2020,38500,61500,38500,15500,0,154000,54000,0.350649350649351,0.1504329004329,0.0725108225108225
YEM,Az zaydiyah,2021,31000,46000,54000,23000,0,154000,77000,0.5,0.216450216450217,0.105339105339105
YEM,Az zuhrah,2018,47527,71291,95054,23764,0,237636,118818,0.5,0.200000561082215,0.0888894499711043
YEM,Az zuhrah,2020,45000,56000,78500,45000,0,224500,123500,0.55011135857461,0.25018559762435,0.127938629052215
YEM,Az zuhrah,2021,45000,45000,89500,45000,0,224500,134500,0.599109131403118,0.266518188567186,0.13338282603316
YEM,Az'zal,2018,30752,38440,56891,27677,0,153760,84568,0.55,0.243333766909469,0.121111544687247
YEM,Az'zal,2020,59500,71500,95000,12000,0,238000,107000,0.449579831932773,0.166666666666667,0.0667600373482727
YEM,Az'zal,2021,47500,71500,95000,24000,0,238000,119000,0.5,0.200280112044818,0.0891690009337068
YEM,Ba'dan,2018,56904,81291,16258,8129,0,162582,24387,0.149998154777282,0.0666658465676807,0.0333329232838404
YEM,Ba'dan,2020,49000,57000,49000,8000,0,163000,57000,0.349693251533742,0.132924335378323,0.0552147239263804
YEM,Ba'dan,2021,40500,49000,57000,16500,0,163000,73500,0.450920245398773,0.184049079754601,0.0838445807770961
YEM,Bajil,2018,39442,78884,97290,44701,0,260317,141991,0.545454196229981,0.239057251991482,0.11784520838482
YEM,Bajil,2020,26500,65500,105000,65500,0,262500,170500,0.64952380952381,0.29968253968254,0.155343915343915
YEM,Bajil,2021,26500,52500,118500,65500,0,263000,184000,0.699619771863118,0.316223067173638,0.160752006759611
YEM,Bakil al mir,2018,5034,7551,15101,19128,4027,50841,38256,0.752463562872485,0.429036932134826,0.279424523951579
YEM,Bakil al mir,2019,2517,10068,22652,15101,0,50338,37753,0.749990067146092,0.349994040287656,0.183329580921857
YEM,Bakil al mir,2020,5000,10000,22500,12500,0,50000,35000,0.7,0.316666666666667,0.161111111111111
YEM,Bakil al mir,2021,2500,7500,22500,17500,0,50000,40000,0.8,0.383333333333333,0.205555555555556
YEM,Bani al awam,2018,7798,21836,35093,13257,0,77984,48350,0.619998974148543,0.263331794556148,0.125554244745361
YEM,Bani al awam,2020,15500,23500,27500,11500,0,78000,39000,0.5,0.215811965811966,0.104700854700855
YEM,Bani al awam,2021,11500,15500,35000,15500,0,77500,50500,0.651612903225806,0.283870967741936,0.139068100358423
YEM,Bani al harith,2018,92260,115325,184519,69195,0,461299,253714,0.549999024493875,0.233333116554194,0.111111111111111
YEM,Bani al harith,2020,115500,161500,161500,23000,0,461500,184500,0.399783315276273,0.149873600577826,0.0610328638497653
YEM,Bani al harith,2021,92500,138500,184500,46000,0,461500,230500,0.499458288190683,0.199711087035031,0.0887203563259901
YEM,Bani dhabyan,2018,2932,5026,9005,3560,0,20523,12565,0.612239925936754,0.261901281489061,0.125847964614227
YEM,Bani dhabyan,2020,2000,4000,10500,4000,0,20500,14500,0.707317073170732,0.300813008130081,0.143631436314363
YEM,Bani dhabyan,2021,1000,3000,11500,5000,0,20500,16500,0.804878048780488,0.349593495934959,0.170731707317073
YEM,Bani hushaysh,2018,17041,39762,39762,17041,0,113606,56803,0.5,0.2166669600784,0.105555848967289
YEM,Bani hushaysh,2020,22500,40000,45500,5500,0,113500,51000,0.449339207048458,0.165932452276065,0.066079295154185
YEM,Bani hushaysh,2021,17000,40000,45500,11500,0,114000,57000,0.5,0.200292397660819,0.0891812865497076
YEM,Bani matar,2018,31979,57561,25583,12791,0,127914,38374,0.299998436449489,0.133331769782823,0.0666654505718252
YEM,Bani matar,2020,38500,45000,32000,13000,0,128500,45000,0.350194552529183,0.150453955901427,0.072632944228275
YEM,Bani matar,2021,32000,45000,38500,13000,0,128500,51500,0.400778210116732,0.167315175097276,0.0782533506268915
YEM,Bani qa'is,2018,8952,13428,33121,28645,4476,88622,66242,0.747466768973844,0.390568933221999,0.235688905940085
YEM,Bani qa'is,2019,8952,17903,35807,26855,0,89517,62662,0.700001117106248,0.333333333333333,0.177777529531945
YEM,Bani qa'is,2020,18000,27000,27000,18000,0,90000,45000,0.5,0.233333333333333,0.122222222222222
YEM,Bani qa'is,2021,13500,22500,31500,22500,0,90000,54000,0.6,0.283333333333333,0.15
YEM,Bani sa'd,2018,19700,21670,39400,16745,0,97515,56145,0.575757575757576,0.249158249158249,0.121212121212121
YEM,Bani sa'd,2020,15000,29500,34500,19500,0,98500,54000,0.548223350253807,0.248730964467005,0.126903553299492
YEM,Bani sa'd,2021,15000,24500,39500,19500,0,98500,59000,0.598984771573604,0.265651438240271,0.132543711223914
YEM,Bani suraim,2018,4414,11917,19862,7503,0,43696,27365,0.626258696448188,0.265989259123642,0.126820659912934
YEM,Bani suraim,2020,6500,13000,15500,9000,0,44000,24500,0.556818181818182,0.253787878787879,0.130050505050505
YEM,Bani suraim,2021,6500,11000,15500,11000,0,44000,26500,0.602272727272727,0.284090909090909,0.150252525252525
YEM,Baqim,2018,566,3539,4954,3963,566,13588,9483,0.697895201648513,0.357619468158179,0.211788179112289
YEM,Baqim,2020,2000,3000,6500,3000,0,14500,9500,0.655172413793103,0.287356321839081,0.14176245210728
YEM,Baqim,2021,2000,3000,5500,3500,0,14000,9000,0.642857142857143,0.297619047619048,0.154761904761905
YEM,Bart al anan,2018,11606,19343,33270,13153,0,77372,46423,0.599997415085561,0.256664771062745,0.123332012154842
YEM,Bart al anan,2020,11500,15500,35000,15500,0,77500,50500,0.651612903225806,0.283870967741936,0.139068100358423
YEM,Bart al anan,2021,7500,11500,35000,19500,4000,77500,58500,0.754838709677419,0.36989247311828,0.213620071684588
YEM,Bayhan,2018,9880,19760,26347,9880,0,65867,36227,0.55000227731641,0.233333839403647,0.111111111111111
YEM,Bayhan,2020,13173,26347,23053,6500,0,69073,29553,0.427851693136247,0.173985011026981,0.078906856996704
YEM,Bayhan,2021,13000,23000,20000,10000,0,66000,30000,0.454545454545455,0.202020202020202,0.101010101010101
YEM,Bayt al faqiah,2018,62011,82681,198435,74413,0,417540,272848,0.653465536236049,0.277227730676502,0.132013167068491
YEM,Bayt al faqiah,2020,103500,124000,124000,62000,0,413500,186000,0.449818621523579,0.199919387343813,0.0999596936719065
YEM,Bayt al faqiah,2021,82500,103500,144500,82500,0,413000,227000,0.549636803874092,0.249798224374496,0.127656712402475
YEM,Bidbadah,2018,7955,9545,6629,2386,0,26515,9015,0.339996228549877,0.143327676158149,0.0677729587026212
YEM,Bidbadah,2020,2500,13500,8000,2500,0,26500,10500,0.39622641509434,0.163522012578616,0.0754716981132076
YEM,Bidbadah,2021,1500,10500,9500,5500,0,27000,15000,0.555555555555556,0.253086419753086,0.12962962962963
YEM,Bilad ar rus,2018,5938,9897,17023,7126,0,39984,24149,0.603966586634654,0.260729291716687,0.126514494686764
YEM,Bilad ar rus,2020,6000,12000,18000,4000,0,40000,22000,0.55,0.216666666666667,0.0944444444444444
YEM,Bilad ar rus,2021,4000,12000,20000,4000,0,40000,24000,0.6,0.233333333333333,0.1
YEM,Bilad at ta'am,2018,10589,15884,18531,7942,0,52946,26473,0.5,0.216667296238935,0.105556185127824
YEM,Bilad at ta'am,2020,8000,13000,18500,13000,0,52500,31500,0.6,0.282539682539683,0.149206349206349
YEM,Bilad at ta'am,2021,5500,10500,21000,16000,0,53000,37000,0.69811320754717,0.333333333333333,0.178197064989518
YEM,Brom mayfa,2018,5595,9592,9592,2398,0,27177,11990,0.441181881738235,0.176472752695294,0.0784323345312417
YEM,Brom mayfa,2020,5500,13500,5500,2500,0,27000,8000,0.296296296296296,0.12962962962963,0.0637860082304527
YEM,Brom mayfa,2021,2500,10500,9500,4000,0,26500,13500,0.509433962264151,0.220125786163522,0.106918238993711
YEM,Brum mayfah,2020,5329,15986,9325,3997,0,34637,13322,0.384617605450818,0.166671478476773,0.0812008994877026
YEM,Bura,2018,11193,18655,31341,12686,0,73875,44027,0.595966159052454,0.255896221094191,0.123459296860312
YEM,Bura,2020,11000,22500,26000,15000,0,74500,41000,0.550335570469799,0.250559284116331,0.128262490678598
YEM,Bura,2021,11000,15000,30000,18500,0,74500,48500,0.651006711409396,0.299776286353468,0.155108128262491
YEM,Craiter,2018,19433,51821,45343,12955,0,129552,58298,0.449996912436705,0.183331789551686,0.0833324756768625
YEM,Craiter,2020,45500,39000,32500,13000,0,130000,45500,0.35,0.15,0.0722222222222222
YEM,Craiter,2021,32500,39000,39000,19500,0,130000,58500,0.45,0.2,0.1
YEM,Critar - Sirah,2020,51821,58298,32388,12955,0,155462,45343,0.291666130629993,0.124999463963327,0.0601847682677725
YEM,Dahr,2020,2803,5605,6306,1401,0,16115,7707,0.478250077567484,0.18839590443686,0.0821181094218637
YEM,Damt,2018,18907,23634,35923,16071,0,94535,51994,0.549997355476808,0.239999294793815,0.117777660243414
YEM,Damt,2020,33000,28500,23500,9500,0,94500,33000,0.349206349206349,0.149911816578483,0.072310405643739
YEM,Damt,2021,23500,23500,33000,14000,0,94000,47000,0.5,0.216312056737589,0.105200945626478
YEM,Dar sad,2018,21700,28933,43400,50633,0,144666,94033,0.650000691247425,0.333333333333333,0.18888873527835
YEM,Dar sad,2019,28933,50633,43400,21700,0,144666,65100,0.450002073742275,0.200000921663233,0.100000460831617
YEM,Dar sad,2020,28933,57866,58000,21700,0,166499,79700,0.478681553642965,0.203004222247581,0.0966305436602555
YEM,Dar sad,2021,21500,36000,58000,29000,0,144500,87000,0.602076124567474,0.267589388696655,0.133794694348328
YEM,Daw'an,2018,23444,33491,6698,3349,0,66982,10047,0.149995521184796,0.0666646760821315,0.0333323380410658
YEM,Daw'an,2020,27000,30000,10000,0,0,67000,10000,0.149253731343284,0.0497512437810945,0.0165837479270315
YEM,Daw'an,2021,27000,30000,10000,0,0,67000,10000,0.149253731343284,0.0497512437810945,0.0165837479270315
YEM,Dawan,2020,26793,40189,10047,0,0,77029,10047,0.130431395967752,0.0434771319892508,0.0144923773297503
YEM,Dawran aness,2018,19234,38468,76937,57703,0,192342,134640,0.700003119443491,0.333335066357495,0.177778817592275
YEM,Dawran aness,2020,29000,48000,86500,29000,0,192500,115500,0.6,0.25021645021645,0.116883116883117
YEM,Dawran aness,2021,29000,38500,86500,38500,0,192500,125000,0.649350649350649,0.283116883116883,0.138816738816739
YEM,Dhamar,2017,382600,478250,765200,286950,0,1913000,1052150,0.55,0.233333333333333,0.111111111111111
YEM,Dhamar city,2018,44254,59005,103259,88508,0,295026,191767,0.650000338953177,0.316667005619844,0.172222485852471
YEM,Dhamar city,2020,74000,103500,88500,29500,0,295500,118000,0.399323181049069,0.166384658770446,0.0776461740928746
YEM,Dhamar city,2021,44500,88500,103500,59000,0,295500,162500,0.549915397631134,0.249858996051889,0.127655574356082
YEM,Dhar,2018,1541,4064,4064,4064,0,13733,8128,0.591859025704507,0.295929512852254,0.164405284917919
YEM,Dhar,2020,1500,5000,6500,1500,0,14500,8000,0.551724137931035,0.218390804597701,0.0957854406130268
YEM,Dhar,2021,1500,4000,6500,2000,0,14000,8500,0.607142857142857,0.25,0.115079365079365
YEM,Dhi as sufal,2018,38311,76622,102162,38311,0,255406,140473,0.54999882539956,0.233333072311013,0.111111111111111
YEM,Dhi as sufal,2020,51000,76500,76500,51000,0,255000,127500,0.5,0.233333333333333,0.122222222222222
YEM,Dhi as sufal,2021,38500,64000,89500,64000,0,256000,153500,0.599609375,0.283203125,0.149956597222222
YEM,Dhi bin,2018,8549,11969,14961,7694,0,43173,22655,0.524749264586663,0.234320833236822,0.117709885550897
YEM,Dhi bin,2020,6500,10500,17000,8500,0,42500,25500,0.6,0.266666666666667,0.133333333333333
YEM,Dhi bin,2021,4500,10500,17000,10500,0,42500,27500,0.647058823529412,0.298039215686275,0.154248366013072
YEM,Dhi na'im,2018,3107,10875,12428,4350,0,30760,16778,0.545448634590377,0.228955353272648,0.107744545585898
YEM,Dhi na'im,2020,8000,8000,11000,4500,0,31500,15500,0.492063492063492,0.211640211640212,0.102292768959436
YEM,Dhi na'im,2021,4500,8000,14000,4500,0,31000,18500,0.596774193548387,0.247311827956989,0.114695340501792
YEM,Dhubab,2018,3972,6620,10592,4502,530,26216,15624,0.595971925541654,0.269377479401892,0.14143186518835
YEM,Dhubab,2019,5561,10592,7944,2383,0,26480,10327,0.389992447129909,0.159994964753273,0.0733299765021819
YEM,Dhubab,2020,6620,11916,6620,4000,0,29156,10620,0.364247496227192,0.167146842273746,0.0862029542232588
YEM,Dhubab,2021,4000,9500,8000,5500,0,27000,13500,0.5,0.234567901234568,0.123456790123457
YEM,Dimnat khadir,2018,18111,54334,77879,30789,0,181113,108668,0.600001104282962,0.256666648261951,0.123333069532404
YEM,Dimnat khadir,2020,36000,63500,63500,18000,0,181000,81500,0.450276243093923,0.183241252302026,0.0831798649478207
YEM,Dimnat khadir,2021,27000,54500,72500,27000,0,181000,99500,0.549723756906077,0.232965009208103,0.110804174340086
YEM,Far al udayn,2018,19513,39026,49433,23416,0,131388,72849,0.55445702803909,0.244225753747171,0.121013080849596
YEM,Far al udayn,2020,32500,45500,26000,26000,0,130000,52000,0.4,0.2,0.111111111111111
YEM,Far al udayn,2021,26000,26000,39000,39000,0,130000,78000,0.6,0.3,0.166666666666667
YEM,Ghamr,2018,6633,6948,12634,5369,0,31584,18003,0.570003799392097,0.246664978047957,0.119997467071935
YEM,Ghamr,2020,4500,8000,14000,4500,0,31000,18500,0.596774193548387,0.247311827956989,0.114695340501792
YEM,Ghamr,2021,4500,8000,14000,4500,0,31000,18500,0.596774193548387,0.247311827956989,0.114695340501792
YEM,Ghayl ba wazir,2018,18840,22608,26376,7536,0,75360,33912,0.45,0.183333333333333,0.0833333333333333
YEM,Ghayl ba wazir,2020,22500,41500,11500,0,0,75500,11500,0.152317880794702,0.0507726269315673,0.0169242089771891
YEM,Ghayl ba wazir,2021,22500,37500,15000,0,0,75000,15000,0.2,0.0666666666666667,0.0222222222222222
YEM,Ghayl bawazir,2020,22608,41448,11304,0,0,75360,11304,0.15,0.05,0.0166666666666667
YEM,Ghayl bin yamin,2018,8462,14809,14809,3808,0,41888,18617,0.444447097020626,0.178452062643239,0.0796860410830999
YEM,Ghayl bin yamin,2020,10578,23500,8462,2116,0,44656,10578,0.236877463274812,0.0947539710975755,0.042114534814284
YEM,Ghayl bin yamin,2021,8500,23500,8500,2000,0,42500,10500,0.247058823529412,0.0980392156862745,0.0431372549019608
YEM,Habban,2018,8447,10559,12670,10559,0,42235,23229,0.549994080738724,0.266666666666667,0.144445759835839
YEM,Habban,2020,12670,15000,15000,4223,0,46893,19223,0.409933252297784,0.16666311247592,0.0755668341875238
YEM,Habban,2021,8500,15000,12500,6500,0,42500,19000,0.447058823529412,0.2,0.100653594771242
YEM,Habil jabr,2018,8928,14880,26784,8928,0,59520,35712,0.6,0.25,0.116666666666667
YEM,Habil jabr,2020,20832,21000,23808,9000,0,74640,32808,0.439549839228296,0.186709539121115,0.0890317970703823
YEM,Habil jabr,2021,15000,21000,15000,9000,0,60000,24000,0.4,0.183333333333333,0.0944444444444445
YEM,Habur zulaymah,2018,7760,13967,20692,8794,0,51213,29486,0.575752250405171,0.249155487864409,0.121210543329927
YEM,Habur zulaymah,2020,5000,10500,26000,10500,0,52000,36500,0.701923076923077,0.301282051282051,0.145299145299145
YEM,Habur zulaymah,2021,2500,10500,26000,13000,0,52000,39000,0.75,0.333333333333333,0.166666666666667
YEM,Hadramaut,2017,297800,297800,670050,223350,0,1489000,893400,0.6,0.25,0.116666666666667
YEM,Hagr as sai'ar,2018,990,990,990,495,0,3465,1485,0.428571428571429,0.19047619047619,0.0952380952380952
YEM,Hagr as sai'ar,2020,1500,2000,500,0,0,4000,500,0.125,0.0416666666666667,0.0138888888888889
YEM,Hagr as sai'ar,2021,1000,2500,500,0,0,4000,500,0.125,0.0416666666666667,0.0138888888888889
YEM,Hajar,2020,9821,21605,15713,7856,0,54995,23569,0.428566233293936,0.19047186107828,0.0952349203462941
YEM,Hajar as sayar,2020,1333,2285,571,0,0,4189,571,0.136309381714013,0.0454364605713376,0.0151454868571125
YEM,Hajjah,2017,212900,319350,638700,958050,0,2129000,1596750,0.75,0.4,0.233333333333333
YEM,Hajjah,2018,4133,9505,20664,7026,0,41328,27690,0.670005807200929,0.280003871467286,0.131113692089302
YEM,Hajjah,2020,6000,16500,12500,6000,0,41000,18500,0.451219512195122,0.199186991869919,0.0989159891598916
YEM,Hajjah,2021,4000,12500,16500,8500,0,41500,25000,0.602409638554217,0.269076305220884,0.13520749665328
YEM,Hajjah city,2018,10224,27604,46007,18403,0,102238,64410,0.63000058686594,0.270000717280594,0.13000058686594
YEM,Hajjah city,2020,20500,41000,36000,5000,0,102500,41000,0.4,0.149593495934959,0.0607046070460705
YEM,Hajjah city,2021,15500,30500,41000,15500,0,102500,56500,0.551219512195122,0.234146341463415,0.111653116531165
YEM,Hajr,2018,7856,13356,13356,3928,0,38496,17284,0.448981712385702,0.183672762538099,0.0838990486746098
YEM,Hajr,2020,10000,13500,8000,8000,0,39500,16000,0.405063291139241,0.20253164556962,0.112517580872011
YEM,Hajr,2021,4000,12000,15500,8000,0,39500,23500,0.59493670886076,0.265822784810127,0.133614627285513
YEM,Halimayn,2018,5998,9997,17994,5998,0,39987,23992,0.599994998374472,0.249997915989363,0.11666569412837
YEM,Halimayn,2020,10000,16000,8000,6000,0,40000,14000,0.35,0.166666666666667,0.0888888888888889
YEM,Halimayn,2021,8000,16000,10000,6000,0,40000,16000,0.4,0.183333333333333,0.0944444444444444
YEM,Halmin,2020,11996,13995,17994,5998,0,49983,23992,0.48000320108837,0.200001333786821,0.0933339557671831
YEM,Hamdan,2018,32159,64318,40199,24119,0,160795,64318,0.4,0.183332815075096,0.0944439261862067
YEM,Hamdan,2020,32000,48000,72500,8000,0,160500,80500,0.501557632398754,0.18380062305296,0.072343371408792
YEM,Hamdan,2021,24000,40000,80500,16000,0,160500,96500,0.601246105919003,0.233644859813084,0.100034614053306
YEM,Haradh,2018,3427,5140,13365,10623,1371,33926,25359,0.74747980899605,0.380475151800979,0.223348857316905
YEM,Haradh,2020,14000,28000,63000,35000,0,140000,98000,0.7,0.316666666666667,0.161111111111111
YEM,Haradh,2021,7000,21000,63000,49000,0,140000,112000,0.8,0.383333333333333,0.205555555555556
YEM,Harf sufyan,2018,8486,15275,22629,10183,0,56573,32812,0.579993990065933,0.253330505129066,0.124442951781081
YEM,Harf sufyan,2020,5500,11500,25500,14000,0,56500,39500,0.699115044247788,0.315634218289086,0.160275319567355
YEM,Harf sufyan,2021,3000,8500,25500,17000,3000,57000,45500,0.798245614035088,0.400584795321637,0.234892787524366
YEM,Harib,2018,17040,19880,14200,5680,0,56800,19880,0.35,0.15,0.0722222222222222
YEM,Harib,2020,20000,22720,17040,3000,0,62760,20040,0.319311663479924,0.122370936902486,0.0514127894625027
YEM,Harib,2021,14000,20000,17000,5500,0,56500,22500,0.398230088495575,0.165191740412979,0.0766961651917404
YEM,Harib al qaramish,2018,2992,2992,2992,962,0,9938,3954,0.397866773998793,0.164888978332327,0.0764741396659288
YEM,Harib al qaramish,2020,1000,2000,5500,2000,0,10500,7500,0.714285714285714,0.301587301587302,0.142857142857143
YEM,Harib al qaramish,2021,500,1500,6000,2500,0,10500,8500,0.80952380952381,0.349206349206349,0.169312169312169
YEM,Haridah,2020,7880,13508,3377,1126,0,25891,4503,0.173921439882585,0.0724704852394011,0.0338212763766045
YEM,Haswin,2020,6264,13572,4176,1044,0,25056,5220,0.208333333333333,0.0833333333333333,0.037037037037037
YEM,Hat,2018,2021,2021,984,518,0,5544,1502,0.270923520923521,0.121452621452621,0.0612473945807279
YEM,Hat,2020,1554,3109,518,500,0,5681,1018,0.179193803907763,0.0890688259109312,0.049247980598095
YEM,Hat,2021,1000,3000,1000,500,0,5500,1500,0.272727272727273,0.121212121212121,0.0606060606060606
YEM,Hatib,2018,2075,5470,7922,3584,0,19051,11506,0.603957797490945,0.264028135006036,0.12981529111916
YEM,Hatib,2020,3000,6601,6601,4000,0,20202,10601,0.524750024750025,0.240916740916741,0.124305624305624
YEM,Hatib,2021,3000,5500,5500,4500,0,18500,10000,0.540540540540541,0.261261261261261,0.141141141141141
YEM,Hawf,2018,3455,4015,1401,374,0,9245,1775,0.191995673336939,0.077483324319452,0.0348176191334655
YEM,Hawf,2020,6537,5603,1500,500,0,14140,2000,0.141442715700141,0.0589344648750589,0.0275027502750275
YEM,Hawf,2021,1500,5500,2000,500,0,9500,2500,0.263157894736842,0.105263157894737,0.0467836257309942
YEM,Haydan,2018,6032,8043,20108,6032,0,40215,26140,0.650006216585851,0.266666666666667,0.1222208407587
YEM,Haydan,2020,8000,10000,14000,8000,0,40000,22000,0.55,0.25,0.127777777777778
YEM,Haydan,2021,6000,8000,14000,12000,0,40000,26000,0.65,0.316666666666667,0.172222222222222
YEM,Hayfan,2018,17054,34108,42067,20465,0,113694,62532,0.550002638661671,0.243334447434928,0.121111638843445
YEM,Hayfan,2020,22500,34000,40000,17000,0,113500,57000,0.502202643171806,0.217327459618209,0.105726872246696
YEM,Hayfan,2021,17000,28500,45500,22500,0,113500,68000,0.599118942731278,0.265785609397944,0.132648066568771
YEM,Hayran,2018,945,4491,8509,8509,945,23399,17963,0.767682379588871,0.404034360442754,0.242413018600035
YEM,Hayran,2020,2500,4500,10500,6000,0,23500,16500,0.702127659574468,0.319148936170213,0.163120567375887
YEM,Hayran,2021,1000,3500,10500,8500,0,23500,19000,0.808510638297872,0.390070921985816,0.210401891252955
YEM,Hays,2018,7214,12023,14427,14427,0,48091,28854,0.599987523653074,0.299993761826537,0.166663201014743
YEM,Hays,2020,14500,24046,12023,7214,0,57783,19237,0.332917986258934,0.152588131457349,0.0786063567331414
YEM,Hays,2021,9500,17000,12000,9500,0,48000,21500,0.447916666666667,0.215277777777778,0.115740740740741
YEM,Hazm al udayn,2018,11720,35159,52738,17579,0,117196,70317,0.599994880371344,0.249997155761858,0.116664960123781
YEM,Hazm al udayn,2020,23500,35000,41000,17500,0,117000,58500,0.5,0.216524216524217,0.105413105413105
YEM,Hazm al udayn,2021,17500,29500,47000,23500,0,117500,70500,0.6,0.266666666666667,0.133333333333333
YEM,Hidaybu,2018,5277,15832,26387,5277,0,52773,31664,0.600003789816762,0.233332701697206,0.0999985261823702
YEM,Hidaybu,2020,13194,16000,18500,8000,0,55694,26500,0.475814270837074,0.206485438287787,0.100748933657326
YEM,Hidaybu,2021,10500,16000,18500,8000,0,53000,26500,0.5,0.216981132075472,0.105870020964361
YEM,Hubaysh,2018,21892,58378,51081,14595,0,145946,65676,0.450002055554794,0.183334932098173,0.083334475308219
YEM,Hubaysh,2020,58500,44000,36500,7500,0,146500,44000,0.300341296928328,0.117178612059158,0.0504361016306409
YEM,Hubaysh,2021,51000,36500,51000,7500,0,146000,58500,0.400684931506849,0.150684931506849,0.0616438356164384
YEM,Hufash,2018,5908,8862,23632,20678,0,59080,44310,0.75,0.366666666666667,0.2
YEM,Hufash,2020,9000,17500,23500,9000,0,59000,32500,0.550847457627119,0.234463276836158,0.112052730696798
YEM,Hufash,2021,6000,15000,26500,12000,0,59500,38500,0.647058823529412,0.282913165266106,0.139122315592904
YEM,Huraidhah,2018,9906,9006,2477,901,0,22290,3378,0.151547779273217,0.063989831015403,0.030312546732466
YEM,Huraidhah,2020,10000,14500,4500,0,0,29000,4500,0.155172413793103,0.0517241379310345,0.0172413793103448
YEM,Huraidhah,2021,7000,14500,7000,0,0,28500,7000,0.245614035087719,0.0818713450292398,0.0272904483430799
YEM,Huswain,2018,8561,9605,2088,1044,0,21298,3132,0.147056061602028,0.0653582496009015,0.0326791248004507
YEM,Huswain,2020,5000,10500,4000,1000,0,20500,5000,0.24390243902439,0.0975609756097561,0.043360433604336
YEM,Huswain,2021,5000,9500,5000,1000,0,20500,6000,0.292682926829268,0.113821138211382,0.0487804878048781
YEM,Huth,2018,7038,8093,14075,5982,0,35188,20057,0.569995452995339,0.246665529915502,0.119999873694315
YEM,Huth,2020,7000,9000,16000,3500,0,35500,19500,0.549295774647887,0.215962441314554,0.0938967136150235
YEM,Huth,2021,5500,9000,16000,5500,0,36000,21500,0.597222222222222,0.25,0.117283950617284
YEM,Ibb,2017,680880,567400,1134800,453920,0,2837000,1588720,0.56,0.24,0.115555555555556
YEM,Ibb,2018,29670,59339,73185,33626,0,195820,106811,0.545455009702788,0.239057978415552,0.117845754037154
YEM,Ibb,2020,69000,69000,39500,20000,0,197500,59500,0.30126582278481,0.134177215189873,0.0672292545710267
YEM,Ibb,2021,59500,59500,49500,29500,0,198000,79000,0.398989898989899,0.182659932659933,0.0939955106621773
YEM,Iyal surayh,2018,14276,21414,28552,7138,0,71380,35690,0.5,0.2,0.0888888888888889
YEM,Iyal surayh,2020,14500,25000,25000,7000,0,71500,32000,0.447552447552448,0.181818181818182,0.0823620823620824
YEM,Iyal surayh,2021,10500,21500,28500,10500,0,71000,39000,0.549295774647887,0.232394366197183,0.110328638497653
YEM,Jabal ash sharq,2018,15086,25144,30173,30173,0,100576,60346,0.60000397709195,0.300001988545975,0.166667771414431
YEM,Jabal ash sharq,2020,15000,20000,45500,20000,0,100500,65500,0.651741293532338,0.283582089552239,0.138750690989497
YEM,Jabal ash sharq,2021,10000,15000,50500,25000,0,100500,75500,0.751243781094527,0.333333333333333,0.166390270867883
YEM,Jabal habashi,2020,32124,80311,40155,24093,0,176683,64248,0.363634305507604,0.166665723357652,0.0858580999115176
YEM,Jabal habashy,2018,32124,40155,64248,24093,0,160620,88341,0.55,0.233333333333333,0.111111111111111
YEM,Jabal habashy,2020,32000,64000,40000,24000,0,160000,64000,0.4,0.183333333333333,0.0944444444444444
YEM,Jabal habashy,2021,24000,56000,56000,24000,0,160000,80000,0.5,0.216666666666667,0.105555555555556
YEM,Jabal iyal yazid,2018,23745,26120,47490,21371,0,118726,68861,0.579999326179607,0.253334007153727,0.124445268002703
YEM,Jabal iyal yazid,2020,18000,41500,47500,12000,0,119000,59500,0.5,0.200280112044818,0.0891690009337068
YEM,Jabal iyal yazid,2021,12000,41500,47500,18000,0,119000,65500,0.550420168067227,0.233893557422969,0.111577964519141
YEM,Jabal murad,2018,7032,6027,5023,2009,0,20091,7032,0.350007466029565,0.150000829558841,0.0722213926633816
YEM,Jabal murad,2020,7032,7032,7032,3014,0,24110,10046,0.416673579427623,0.180561316189686,0.0879671874279921
YEM,Jabal murad,2021,3000,6000,7000,4000,0,20000,11000,0.55,0.25,0.127777777777778
YEM,Jabal ra's,2018,18077,21693,25308,7231,0,72309,32539,0.449999308523144,0.183333563825619,0.0833337174871424
YEM,Jabal ra's,2020,18000,18000,29000,7000,0,72000,36000,0.5,0.199074074074074,0.087962962962963
YEM,Jabal ra's,2021,7000,18000,36000,11000,0,72000,47000,0.652777777777778,0.268518518518519,0.123456790123457
YEM,Jahaf,2018,6038,12075,16100,6038,0,40251,22138,0.549998757794837,0.233335817743659,0.111113871567028
YEM,Jahaf,2020,16100,18113,10000,6000,0,50213,16000,0.318642582598132,0.146044517024144,0.0752350542245589
YEM,Jahaf,2021,8000,12000,12000,8000,0,40000,20000,0.5,0.233333333333333,0.122222222222222
YEM,Jahran,2018,41670,34725,48615,13890,0,138900,62505,0.45,0.183333333333333,0.0833333333333333
YEM,Jahran,2020,34500,48500,41500,14000,0,138500,55500,0.40072202166065,0.167268351383875,0.0782190132370638
YEM,Jahran,2021,28000,41500,48500,21000,0,139000,69500,0.5,0.217026378896883,0.105915267785771
YEM,Jardan,2018,2534,8062,8523,3916,0,23035,12439,0.540004341219883,0.236668837276608,0.116667872561079
YEM,Jardan,2020,4607,8062,9214,2500,0,24383,11714,0.480416683755075,0.194315711766395,0.0875564487097112
YEM,Jardan,2021,3500,8000,8000,3500,0,23000,11500,0.5,0.217391304347826,0.106280193236715
YEM,Jayshan,2018,5051,6062,6466,2425,0,20004,8891,0.444461107778444,0.188562287542492,0.089793152480615
YEM,Jayshan,2020,3031,10103,9092,2021,0,24247,11113,0.458324741205098,0.180558419598301,0.0787084771082791
YEM,Jayshan,2021,3000,6000,8000,3000,0,20000,11000,0.55,0.233333333333333,0.111111111111111
YEM,Jiblah,2018,16354,65416,65416,16354,0,163540,81770,0.5,0.2,0.0888888888888889
YEM,Jiblah,2020,24500,41000,57000,41000,0,163500,98000,0.599388379204893,0.283384301732926,0.150186884131838
YEM,Jiblah,2021,16500,32500,65500,49000,0,163500,114500,0.700305810397554,0.333333333333333,0.177709819911655
YEM,Jihanah,2018,13009,16262,26018,9757,0,65046,35775,0.549995387879347,0.233332308417633,0.111111111111111
YEM,Jihanah,2020,16500,26000,23000,0,0,65500,23000,0.351145038167939,0.11704834605598,0.0390161153519932
YEM,Jihanah,2021,10000,29500,23000,3500,0,66000,26500,0.401515151515151,0.151515151515152,0.0622895622895623
YEM,Juban,2018,13838,20757,24216,10378,0,69189,34594,0.49999277341774,0.216662571603386,0.105553066399444
YEM,Juban,2020,17500,21000,24000,7000,0,69500,31000,0.446043165467626,0.182254196642686,0.0831334932054356
YEM,Juban,2021,17500,17500,24000,10500,0,69500,34500,0.496402877697842,0.215827338129496,0.105515587529976
YEM,Kamaran,2018,982,2004,511,511,0,4008,1022,0.25499001996008,0.12749500998004,0.0708305611000222
YEM,Kamaran,2020,1000,1000,1000,1000,0,4000,2000,0.5,0.25,0.138888888888889
YEM,Kamaran,2021,1000,1000,1000,1000,0,4000,2000,0.5,0.25,0.138888888888889
YEM,Khabb wa ash sha'af,2018,29719,49532,9906,9906,0,99063,19812,0.199993943248236,0.099996971624118,0.05555387312451
YEM,Khabb wa ash sha'af,2020,10000,20000,49500,20000,0,99500,69500,0.698492462311558,0.299832495812395,0.144611948632049
YEM,Khabb wa ash sha'af,2021,5000,15000,54500,25000,0,99500,79500,0.798994974874372,0.350083752093802,0.172529313232831
YEM,Khamir,2018,20803,41606,31205,10402,0,104016,41607,0.400005768343332,0.166669871301851,0.0777797005588884
YEM,Khamir,2020,15500,26000,41500,21000,0,104000,62500,0.600961538461538,0.267628205128205,0.134081196581197
YEM,Khamir,2021,15500,21000,41500,26000,0,104000,67500,0.649038461538462,0.299679487179487,0.155448717948718
YEM,Khanfar,2020,50336,67114,41947,33557,0,192954,75504,0.391305699804098,0.188405872211339,0.10144905003265
YEM,Khanfir,2018,16779,58725,63759,30201,0,169464,93960,0.554454043336638,0.244222961808998,0.121010952178634
YEM,Khanfir,2019,33557,67114,50336,16779,0,167786,67115,0.400003575983694,0.166668653324274,0.0777789697723423
YEM,Khanfir,2020,42000,50500,42000,33500,0,168000,75500,0.449404761904762,0.216269841269841,0.116402116402116
YEM,Khanfir,2021,25000,50500,50500,42000,0,168000,92500,0.550595238095238,0.266865079365079,0.144510582010582
YEM,Kharab al marashi,2018,13192,30782,30782,13192,0,87948,43974,0.5,0.216665908642986,0.105554797531875
YEM,Kharab al marashi,2020,9000,17500,31000,26500,4500,88500,62000,0.700564971751413,0.367231638418079,0.22284996861268
YEM,Kharab al marashi,2021,4500,13000,31000,35000,4500,88000,70500,0.801136363636364,0.433712121212121,0.267045454545455
YEM,Kharif,2018,12812,17296,22421,10890,0,63419,33311,0.525252684526719,0.232322595226457,0.115599776442742
YEM,Kharif,2020,9500,19000,22500,13000,0,64000,35500,0.5546875,0.252604166666667,0.129340277777778
YEM,Kharif,2021,6500,16000,25500,16000,0,64000,41500,0.6484375,0.299479166666667,0.155381944444444
YEM,Khayran al muharraq,2018,13346,20019,53385,40039,6673,133462,100097,0.750003746384739,0.383335081646211,0.227778527054726
YEM,Khayran al muharraq,2019,20019,33366,53385,26692,0,133462,80077,0.599998501446105,0.266665168112771,0.133332167791415
YEM,Khayran al muharraq,2020,33500,40000,33500,26500,0,133500,60000,0.449438202247191,0.215980024968789,0.116104868913858
YEM,Khayran al muharraq,2021,26500,33500,33500,40000,0,133500,73500,0.550561797752809,0.283395755305868,0.161048689138577
YEM,Khur maksar,2018,21785,29047,14523,7262,0,72617,21785,0.29999862291199,0.133334251392006,0.0666678907448975
YEM,Khur maksar,2020,29047,32678,11000,3631,0,76356,14631,0.191615590130442,0.0797230516702464,0.0371418094190371
YEM,Khur maksar,2021,22000,25500,18000,7500,0,73000,25500,0.349315068493151,0.150684931506849,0.0730593607305936
YEM,Khwlan,2018,6009,9014,10516,4507,0,30046,15023,0.5,0.216667776076682,0.105556664965571
YEM,Khwlan,2020,4500,10500,12000,3000,0,30000,15000,0.5,0.2,0.0888888888888889
YEM,Khwlan,2021,3000,10500,12000,4500,0,30000,16500,0.55,0.233333333333333,0.111111111111111
YEM,Kitaf wa al boqe'e,2018,4915,9830,17203,14746,2458,49152,34407,0.70001220703125,0.366678873697917,0.222233525028935
YEM,Kitaf wa al boqe'e,2020,7500,10000,22000,10000,0,49500,32000,0.646464646464647,0.282828282828283,0.139169472502806
YEM,Kitaf wa al boqe'e,2021,5000,7500,22000,14500,0,49000,36500,0.744897959183674,0.346938775510204,0.18140589569161
YEM,Ku'aydinah,2018,11883,23767,47533,35650,0,118833,83183,0.699999158482913,0.333333333333333,0.177777964781575
YEM,Ku'aydinah,2020,18000,35500,41500,24000,0,119000,65500,0.550420168067227,0.250700280112045,0.128384687208217
YEM,Ku'aydinah,2021,12000,29500,47500,29500,0,118500,77000,0.649789029535865,0.29957805907173,0.155180496952649
YEM,Kuhlan affar,2018,9164,13440,27491,10386,0,60481,37877,0.626262793273921,0.265995381469663,0.126825871853236
YEM,Kuhlan affar,2020,6000,18500,27500,9000,0,61000,36500,0.598360655737705,0.248633879781421,0.115664845173042
YEM,Kuhlan affar,2021,3000,15500,27500,15500,0,61500,43000,0.699186991869919,0.317073170731707,0.161698283649503
YEM,Kuhlan ash sharaf,2018,14537,20352,25440,12357,0,72686,37797,0.520003852186116,0.230003026717662,0.114446615120748
YEM,Kuhlan ash sharaf,2020,11000,25500,29000,7500,0,73000,36500,0.5,0.200913242009132,0.0898021308980213
YEM,Kuhlan ash sharaf,2021,11000,22000,25500,14500,0,73000,40000,0.547945205479452,0.248858447488585,0.127092846270928
YEM,Kushar,2018,5716,22864,45728,40012,0,114320,85740,0.75,0.366666666666667,0.2
YEM,Kushar,2020,17000,34500,51500,11500,0,114500,63000,0.550218340611354,0.21688500727802,0.0946142649199418
YEM,Kushar,2021,17000,23000,51500,23000,0,114500,74500,0.650655021834061,0.283842794759825,0.139252789907812
YEM,Kusmah,2018,26816,37543,32180,10727,0,107266,42907,0.400005593571122,0.166669774206179,0.0777796423014852
YEM,Kusmah,2020,16000,21500,48500,21500,0,107500,70000,0.651162790697675,0.283720930232558,0.139018087855297
YEM,Kusmah,2021,10500,16000,48500,32000,0,107000,80500,0.752336448598131,0.350467289719626,0.183281412253375
YEM,Lahj,2017,147450,147450,245750,442350,0,983000,688100,0.7,0.383333333333333,0.227777777777778
YEM,Lawdar,2018,41676,59537,11907,5954,0,119074,17861,0.149999160186103,0.0666672265425982,0.0333340798345753
YEM,Lawdar,2020,35722,47630,41676,18000,0,143028,59676,0.417232989344744,0.18102749112062,0.08830904904401
YEM,Lawdar,2021,24000,35500,41500,18000,0,119000,59500,0.5,0.217086834733894,0.105975723622782
YEM,Ma'ain,2018,122470,183705,226570,73482,0,606227,300052,0.494949911501797,0.205387310913789,0.095398441691167
YEM,Ma'ain,2020,92000,214500,245000,61000,0,612500,306000,0.499591836734694,0.199727891156463,0.0887074829931973
YEM,Ma'ain,2021,61000,183500,275500,92000,0,612000,367500,0.600490196078431,0.250272331154684,0.116830065359477
YEM,Mabyan,2018,12096,24192,29837,13709,0,79834,43546,0.545456822907533,0.239058546483954,0.117845919171169
YEM,Mabyan,2020,16000,20000,32500,12000,0,80500,44500,0.552795031055901,0.233954451345756,0.111111111111111
YEM,Mabyan,2021,12000,16000,36500,16000,0,80500,52500,0.652173913043478,0.283643892339545,0.13871635610766
YEM,Madghal al jidan,2020,1516,7581,7581,3032,0,19710,10613,0.53845763571791,0.230762726196516,0.111105473814758
YEM,Maghirib ans,2018,17340,26010,30345,13005,0,86700,43350,0.5,0.216666666666667,0.105555555555556
YEM,Maghirib ans,2020,8500,26000,39000,13000,0,86500,52000,0.601156069364162,0.250481695568401,0.11689145793192
YEM,Maghirib ans,2021,8500,17500,43500,17500,0,87000,61000,0.701149425287356,0.300766283524904,0.144955300127714
YEM,Mahliyah,2018,7432,5945,8422,2477,0,24276,10899,0.448961937716263,0.18366562311199,0.083896303619487
YEM,Mahliyah,2020,6193,10000,8500,3716,0,28409,12216,0.430004576014643,0.186936064862074,0.0913794924143757
YEM,Mahliyah,2021,2500,8500,10000,3500,0,24500,13500,0.551020408163265,0.231292517006803,0.108843537414966
YEM,Majz,2018,5443,38101,46809,18506,0,108859,65315,0.599996325522006,0.256665349978719,0.123332833196051
YEM,Majz,2020,16500,27000,43500,22000,0,109000,65500,0.600917431192661,0.267584097859327,0.134046890927625
YEM,Majz,2021,11000,27000,43500,27000,0,108500,70500,0.649769585253456,0.299539170506912,0.155145929339478
YEM,Majzar,2018,5557,9526,9526,2382,0,26991,11908,0.441184098403171,0.176478579279513,0.0784376685232526
YEM,Majzar,2020,5292,10585,10585,5500,0,31962,16085,0.503253863963457,0.225111069394906,0.113276877403027
YEM,Majzar,2021,1500,6500,12000,6500,0,26500,18500,0.69811320754717,0.314465408805031,0.159329140461216
YEM,Man'ar,2018,2977,3457,2497,960,0,9891,3457,0.349509655242139,0.148855862231658,0.0711870499556275
YEM,Man'ar,2020,1500,6000,1500,500,0,9500,2000,0.210526315789474,0.087719298245614,0.0409356725146199
YEM,Man'ar,2021,1500,6000,2000,500,0,10000,2500,0.25,0.1,0.0444444444444444
YEM,Manakhah,2018,15386,25644,43082,18464,0,102576,61546,0.600003899547652,0.260002339728592,0.126668139829113
YEM,Manakhah,2020,15500,36000,41000,10500,0,103000,51500,0.5,0.200647249190939,0.0895361380798274
YEM,Manakhah,2021,15500,31000,41000,15500,0,103000,56500,0.548543689320388,0.233009708737864,0.111111111111111
YEM,Manar,2020,3361,6241,1440,480,0,11522,1920,0.166637736504079,0.069432390210033,0.0324017820980154
YEM,Maqbanah,2018,26239,78716,110203,47230,0,262388,157433,0.60000076222998,0.260000457337988,0.126666954620215
YEM,Maqbanah,2019,39358,65597,104955,52477,0,262387,157432,0.599999237767115,0.266665904433782,0.133332740485534
YEM,Maqbanah,2020,26000,118000,92000,26000,0,262000,118000,0.450381679389313,0.183206106870229,0.0831212892281595
YEM,Maqbanah,2021,13000,92000,105000,52500,0,262500,157500,0.6,0.266666666666667,0.133333333333333
YEM,Marib,2017,82250,98700,98700,49350,0,329000,148050,0.45,0.2,0.1
YEM,Marib,2018,34248,25686,17124,8562,0,85620,25686,0.3,0.133333333333333,0.0666666666666667
YEM,Marib,2020,21405,34248,30000,13000,0,98653,43000,0.435871184860065,0.189215398078788,0.0923551347765513
YEM,Marib,2021,8500,21500,38500,17000,0,85500,55500,0.649122807017544,0.282651072124756,0.138401559454191
YEM,Marib city,2018,17509,23345,35017,40853,0,116724,75870,0.649994859668963,0.333330477593868,0.18888717544521
YEM,Marib city,2020,23345,52526,46690,17509,0,140070,64199,0.458335118155208,0.194445634325694,0.0925933858467591
YEM,Marib city,2021,6000,35000,52500,23500,0,117000,76000,0.64957264957265,0.283475783475783,0.139126305792972
YEM,Markhah al olya,2020,4567,15985,18269,9134,0,47955,27403,0.571431550411845,0.25396726097383,0.12698247199342
YEM,Markhah as sufla,2020,11649,23298,23298,5825,0,64070,29123,0.454549711253317,0.181821965558504,0.0808109186133222
YEM,Mashra'a wa hadnan,2018,3479,11829,12873,5914,0,34095,18787,0.55101921102801,0.241491909859706,0.119043196297926
YEM,Mashra'a wa hadnan,2020,8500,12000,8500,5000,0,34000,13500,0.397058823529412,0.181372549019608,0.0931372549019608
YEM,Mashra'a wa hadnan,2021,7000,10500,12000,5000,0,34500,17000,0.492753623188406,0.21256038647343,0.103059581320451
YEM,Mashrah wa hadnan,2020,10437,17396,8698,5219,0,41750,13917,0.333341317365269,0.152782435129741,0.0787065868263473
YEM,Maswar,2018,5220,7830,15659,20879,2610,52198,39148,0.749990421088931,0.41666347369631,0.26111047251704
YEM,Maswar,2019,7830,18269,18269,7830,0,52198,26099,0.5,0.216668582448881,0.105557471337769
YEM,Maswar,2020,8000,13000,21000,10500,0,52500,31500,0.6,0.266666666666667,0.133333333333333
YEM,Maswar,2021,5000,8000,26000,13000,0,52000,39000,0.75,0.333333333333333,0.166666666666667
YEM,Maswarah,2018,962,1538,4038,3461,0,9999,7499,0.74997499749975,0.365369870320365,0.198708759764865
YEM,Maswarah,2020,1442,2885,4000,2885,0,11212,6885,0.614074206207635,0.290462599595671,0.154001664882864
YEM,Maswarah,2021,1000,2000,4000,3000,0,10000,7000,0.7,0.333333333333333,0.177777777777778
YEM,Mawiyah,2018,37518,46897,71284,33766,0,189465,105050,0.554455968120761,0.244224526957486,0.121012089597316
YEM,Mawiyah,2020,28000,75000,56500,28000,0,187500,84500,0.450666666666667,0.2,0.0998518518518519
YEM,Mawiyah,2021,19000,65500,65500,37500,0,187500,103000,0.549333333333333,0.249777777777778,0.127703703703704
YEM,Mawza,2018,2016,4463,5039,2448,288,14254,7775,0.545460923249614,0.252537299471493,0.135813728699936
YEM,Mawza,2019,3024,5039,5039,0,0,13102,5039,0.384597771332621,0.128199257110874,0.0427330857036246
YEM,Mawza,2020,3600,6479,3600,2160,0,15839,5760,0.363659321926889,0.166677189216491,0.0858640065660711
YEM,Mawza,2021,2000,5000,5000,2000,0,14000,7000,0.5,0.214285714285714,0.103174603174603
YEM,Mayfa'a,2018,8840,17680,23573,8840,0,58933,32413,0.549997454736735,0.233332767719274,0.111111111111111
YEM,Mayfa'a,2020,17500,23500,12000,6000,0,59000,18000,0.305084745762712,0.135593220338983,0.0677966101694915
YEM,Mayfa'a,2021,17500,20500,14500,6000,0,58500,20500,0.35042735042735,0.150997150997151,0.0731244064577398
YEM,Mayfa'at anss,2018,18848,28272,35811,12251,0,95182,48062,0.504948414616209,0.211219908526122,0.0990091497225199
YEM,Mayfa'at anss,2020,19000,37500,28500,9500,0,94500,38000,0.402116402116402,0.167548500881834,0.0781893004115226
YEM,Mayfa'at anss,2021,19000,28500,33000,14000,0,94500,47000,0.497354497354497,0.215167548500882,0.104644326866549
YEM,Mayfaah,2020,17680,26519,11786,5893,0,61878,17679,0.285707359643169,0.126981048730297,0.0634905243651486
YEM,Mazhar,2018,24076,42133,38522,14446,0,119177,52968,0.444448173724796,0.188554279209355,0.0897880183816228
YEM,Mazhar,2020,18000,24000,54000,24000,0,120000,78000,0.65,0.283333333333333,0.138888888888889
YEM,Mazhar,2021,12000,18000,54000,36000,0,120000,90000,0.75,0.35,0.183333333333333
YEM,Medghal,2018,4505,6564,1544,515,0,13128,2059,0.156840341255332,0.0653564899451554,0.0305030807773038
YEM,Medghal,2020,1500,3000,7500,3000,0,15000,10500,0.7,0.3,0.144444444444444
YEM,Medghal,2021,1000,2500,8500,4000,0,16000,12500,0.78125,0.34375,0.170138888888889
YEM,Merkhah al ulya,2018,6851,15985,15985,6851,0,45672,22836,0.5,0.216668126350207,0.105557015239096
YEM,Merkhah al ulya,2020,4500,13500,18500,9000,0,45500,27500,0.604395604395604,0.267399267399267,0.133089133089133
YEM,Merkhah al ulya,2021,4500,13500,16000,11500,0,45500,27500,0.604395604395604,0.285714285714286,0.151404151404151
YEM,Merkhah as sufla,2018,11649,17474,20386,8737,0,58246,29123,0.5,0.216667238952031,0.10555612784092
YEM,Merkhah as sufla,2020,8500,20500,23500,6000,0,58500,29500,0.504273504273504,0.202279202279202,0.0902184235517569
YEM,Merkhah as sufla,2021,8500,20500,20500,8500,0,58000,29000,0.5,0.21551724137931,0.104406130268199
YEM,Midi,2018,2569,4111,8993,8993,1542,26208,19528,0.745115995115995,0.401976495726496,0.249470051553385
YEM,Midi,2020,2500,5000,11500,6500,0,25500,18000,0.705882352941177,0.320261437908497,0.163398692810458
YEM,Midi,2021,1500,4000,11500,9000,0,26000,20500,0.788461538461538,0.378205128205128,0.202991452991453
YEM,Milhan,2018,13893,20839,48624,48624,6946,138926,104194,0.749996400961663,0.39999712076933,0.244441885128294
YEM,Milhan,2019,20839,48624,48624,20839,0,138926,69463,0.5,0.216666906602556,0.105555795491445
YEM,Milhan,2020,21000,34500,62500,21000,0,139000,83500,0.600719424460432,0.250599520383693,0.117106314948042
YEM,Milhan,2021,21000,28000,55500,34500,0,139000,90000,0.647482014388489,0.298561151079137,0.154676258992806
YEM,Monabbih,2018,8475,18645,42374,15255,0,84749,57629,0.679996224144238,0.286666116021035,0.135555843988982
YEM,Monabbih,2020,12500,17000,38000,17000,0,84500,55000,0.650887573964497,0.284023668639053,0.139381985535832
YEM,Monabbih,2021,8500,12500,38000,25500,0,84500,63500,0.751479289940828,0.351084812623274,0.184089414858646
YEM,Mudhaykhirah,2018,17504,35008,46678,17504,0,116694,64182,0.550002570826264,0.233333904628059,0.111111111111111
YEM,Mudhaykhirah,2020,52500,46500,17500,0,0,116500,17500,0.150214592274678,0.050071530758226,0.016690510252742
YEM,Mudhaykhirah,2021,41000,35000,29000,11500,0,116500,40500,0.347639484978541,0.148783977110157,0.0715307582260372
YEM,Mudiyah,2018,16613,23733,4272,2373,0,46991,6645,0.141410057245004,0.0639696963248282,0.0325452391592716
YEM,Mudiyah,2020,9493,21359,16613,7120,0,54585,23733,0.434789777411377,0.188409514213306,0.091789563677445
YEM,Mudiyah,2021,7000,14000,19000,7000,0,47000,26000,0.553191489361702,0.234042553191489,0.111111111111111
YEM,Mukayras,2018,4944,12360,23731,8405,0,49440,32136,0.65,0.273334681769148,0.128890237324703
YEM,Mukayras,2020,15000,17500,12500,5000,0,50000,17500,0.35,0.15,0.0722222222222222
YEM,Mukayras,2021,12500,15000,15000,7500,0,50000,22500,0.45,0.2,0.1
YEM,Mustaba,2018,4497,13490,28778,42267,0,89032,71045,0.797971515859466,0.424236978464672,0.246909974940346
YEM,Mustaba,2019,8993,26979,35972,17986,0,89930,53958,0.6,0.266666666666667,0.133333333333333
YEM,Mustaba,2020,4500,13500,49500,22500,0,90000,72000,0.8,0.35,0.172222222222222
YEM,Mustaba,2021,4500,9000,40500,36000,0,90000,76500,0.85,0.416666666666667,0.227777777777778
YEM,Na'man,2018,1523,4442,4950,2031,0,12946,6981,0.539239919666306,0.232040784798393,0.112209691539214
YEM,Na'man,2020,2500,5000,4000,1500,0,13000,5500,0.423076923076923,0.17948717948718,0.0854700854700855
YEM,Na'man,2021,2000,4000,4500,2500,0,13000,7000,0.538461538461538,0.243589743589744,0.123931623931624
YEM,Najrah,2018,5481,14800,24666,9318,0,54265,33984,0.626260020270893,0.265990970238644,0.126822076845112
YEM,Najrah,2020,13500,19000,13500,8000,0,54000,21500,0.398148148148148,0.182098765432099,0.0936213991769547
YEM,Najrah,2021,11000,16500,16500,11000,0,55000,27500,0.5,0.233333333333333,0.122222222222222
YEM,Nati,2020,5201,7801,5201,2600,0,20803,7801,0.374993991251262,0.166658655001682,0.0833266569458465
YEM,Nati',2018,1560,5027,7974,2427,0,16988,10401,0.61225570991288,0.251707087355781,0.115650262930696
YEM,Nati',2020,4500,5000,6000,1500,0,17000,7500,0.441176470588235,0.176470588235294,0.0784313725490196
YEM,Nati',2021,2500,4500,7000,3500,0,17500,10500,0.6,0.266666666666667,0.133333333333333
YEM,Nihm,2018,8093,16185,19962,9711,0,53951,29673,0.549999073233119,0.243331912290782,0.121109896016756
YEM,Nihm,2020,8000,16000,24500,5500,0,54000,30000,0.555555555555556,0.219135802469136,0.095679012345679
YEM,Nihm,2021,8000,13500,27000,5500,0,54000,32500,0.601851851851852,0.234567901234568,0.10082304526749
YEM,Nisab,2018,5963,14907,20870,17888,0,59628,38758,0.649996645871067,0.316663312537734,0.172219613455275
YEM,Nisab,2020,17888,29814,21000,6000,0,74702,27000,0.36143610612835,0.14725174694118,0.0669326122459907
YEM,Nisab,2021,12000,21000,18000,9000,0,60000,27000,0.45,0.2,0.1
YEM,Numan,2020,4442,5077,4442,1904,0,15865,6346,0.4,0.173337535455405,0.0844486465665161
YEM,Old city,2018,24738,43291,43291,12369,0,123689,55660,0.449999595760334,0.183333468079889,0.0833335579109254
YEM,Old city,2020,24500,37000,55500,6000,0,123000,61500,0.5,0.182926829268293,0.0718157181571816
YEM,Old city,2021,24500,31000,55500,12500,0,123500,68000,0.550607287449393,0.217273954116059,0.0949167791273054
YEM,Osaylan,2020,6663,17767,17767,6663,0,48860,24430,0.5,0.212123072724792,0.101011961613681
YEM,Qa'atabah,2018,22559,45118,57149,27071,0,151897,84220,0.554454663357407,0.244224704898714,0.121012557485957
YEM,Qa'atabah,2020,30000,45000,45000,30000,0,150000,75000,0.5,0.233333333333333,0.122222222222222
YEM,Qa'atabah,2021,30000,30000,60000,30000,0,150000,90000,0.6,0.266666666666667,0.133333333333333
YEM,Qafl shamer,2018,15979,31958,23968,7989,0,79894,31957,0.399992490049315,0.166662494471842,0.0777752744608829
YEM,Qafl shamer,2020,16000,28000,28000,8000,0,80000,36000,0.45,0.183333333333333,0.0833333333333333
YEM,Qafl shamer,2021,12000,24000,28000,16000,0,80000,44000,0.55,0.25,0.127777777777778
YEM,Qarah,2018,2787,8361,19509,25083,0,55740,44592,0.8,0.416666666666667,0.238888888888889
YEM,Qarah,2020,3000,11000,25000,14000,3000,56000,42000,0.75,0.369047619047619,0.214285714285714
YEM,Qarah,2021,3000,5500,22500,19500,5500,56000,47500,0.848214285714286,0.464285714285714,0.297619047619048
YEM,Qatabah,2020,37598,67676,45118,30078,0,180470,75196,0.416667590181194,0.194444136606269,0.101851338788226
YEM,Qatabir,2018,4144,9418,18082,6404,0,38048,24486,0.64355550883095,0.270623072610036,0.12761073731427
YEM,Qatabir,2019,30078,45118,52637,22559,0,150392,75196,0.5,0.216667109952657,0.105555998841546
YEM,Qatabir,2020,4000,9500,19000,5500,0,38000,24500,0.644736842105263,0.263157894736842,0.119883040935673
YEM,Qatabir,2021,4000,9500,19000,5500,0,38000,24500,0.644736842105263,0.263157894736842,0.119883040935673
YEM,Qishn,2018,9038,9920,1984,1102,0,22044,3086,0.139992741789149,0.0633278896751951,0.0322183914998286
YEM,Qishn,2020,7716,13227,3500,0,0,24443,3500,0.143190279425602,0.0477300931418675,0.0159100310472892
YEM,Qishn,2021,4500,13000,4500,0,0,22000,4500,0.204545454545455,0.0681818181818182,0.0227272727272727
YEM,Qulensya wa abd al kuri,2018,2476,6034,4487,2476,0,15473,6963,0.450009694306211,0.203343458497598,0.103341304207329
YEM,Qulensya wa abd al kuri,2020,2500,5416,6189,2500,0,16605,8689,0.523276121650105,0.224611060925424,0.108327478336512
YEM,Qulensya wa abd al kuri,2021,2500,4500,6000,2500,0,15500,8500,0.548387096774194,0.236559139784946,0.114695340501792
YEM,Rada',2018,8237,20594,38716,14827,0,82374,53543,0.649998786024717,0.27666496710127,0.132220792429111
YEM,Rada',2020,33000,24500,16500,8000,0,82000,24500,0.298780487804878,0.132113821138211,0.0657181571815718
YEM,Rada',2021,29000,24500,20500,8000,0,82000,28500,0.347560975609756,0.148373983739837,0.0711382113821138
YEM,Radfan,2018,9318,15531,26713,11182,0,62744,37895,0.603962131837307,0.260726125207191,0.126512318132234
YEM,Radfan,2020,21743,25000,18637,6212,0,71592,24849,0.347091853838418,0.144620441762581,0.0674889186873766
YEM,Radfan,2021,15500,25000,15500,6000,0,62000,21500,0.346774193548387,0.147849462365591,0.0707885304659498
YEM,Radman al awad,2018,2626,8929,10505,3939,0,25999,14444,0.555559829224201,0.2356885521238,0.112230812296199
YEM,Radman al awad,2020,8000,8000,9000,1500,0,26500,10500,0.39622641509434,0.150943396226415,0.0628930817610063
YEM,Radman al awad,2021,6500,6500,10500,2500,0,26000,13000,0.5,0.198717948717949,0.0876068376068376
YEM,Radum,2020,9828,13104,9828,3276,0,36036,13104,0.363636363636364,0.151515151515152,0.0707070707070707
YEM,Raghwan,2018,1508,3520,3017,1006,0,9051,4023,0.444481272787537,0.185209737413914,0.0864361212389055
YEM,Raghwan,2020,1000,4190,2514,1676,0,9380,4190,0.446695095948827,0.208457711442786,0.109192134565269
YEM,Raghwan,2021,500,2500,3500,2000,0,8500,5500,0.647058823529412,0.294117647058824,0.150326797385621
YEM,Rahabah,2018,2429,4048,5506,4048,0,16031,9554,0.595970307529162,0.282827022643628,0.150389176526036
YEM,Rahabah,2020,4858,7500,5668,1500,0,19526,7168,0.367100276554338,0.147973641981631,0.066395802747334
YEM,Rahabah,2021,1500,5500,5500,3000,0,15500,8500,0.548387096774194,0.247311827956989,0.125448028673835
YEM,Rajuzah,2018,16151,37685,37685,16151,0,107672,53836,0.5,0.216667285831042,0.105556174719931
YEM,Rajuzah,2020,11000,21500,43000,27000,5500,108000,75500,0.699074074074074,0.350308641975309,0.206275720164609
YEM,Rajuzah,2021,5500,16000,43000,32500,11000,108000,86500,0.800925925925926,0.435185185185185,0.279835390946502
YEM,Rakhyah,2018,3942,6964,1445,526,0,12877,1971,0.153063601770599,0.0646372084595273,0.0306230747327276
YEM,Rakhyah,2020,4599,6570,2628,657,0,14454,3285,0.227272727272727,0.0909090909090909,0.0404040404040404
YEM,Rakhyah,2021,4500,5500,3500,0,0,13500,3500,0.259259259259259,0.0864197530864198,0.0288065843621399
YEM,Rasad,2018,11110,22220,28146,13332,0,74808,41478,0.554459416105229,0.244225216554379,0.121012012975439
YEM,Rasad,2020,15000,22000,29500,7500,0,74000,37000,0.5,0.20045045045045,0.0893393393393393
YEM,Rasad,2021,15000,22000,26000,11000,0,74000,37000,0.5,0.216216216216216,0.105105105105105
YEM,Rassd,2020,22220,29627,25924,11110,0,88881,37034,0.416669479416298,0.180556024347161,0.0879628066990946
YEM,Raydah,2018,9704,18115,25878,11645,0,65342,37523,0.57425545590891,0.250823870302919,0.123211546767606
YEM,Raydah,2020,13000,22500,22500,6500,0,64500,29000,0.449612403100775,0.183462532299742,0.0835486649440138
YEM,Raydah,2021,9500,19500,26000,9500,0,64500,35500,0.550387596899225,0.232558139534884,0.110249784668389
YEM,Raymah,2017,192440,113200,169800,90560,0,566000,260360,0.46,0.206666666666667,0.104444444444444
YEM,Razih,2018,8774,14623,25151,9943,0,58491,35094,0.599989742011592,0.256660568862446,0.123329515082092
YEM,Razih,2020,6000,14500,29000,9000,0,58500,38000,0.64957264957265,0.267806267806268,0.123456790123457
YEM,Razih,2021,6000,14500,26500,11500,0,58500,38000,0.64957264957265,0.282051282051282,0.137701804368471
YEM,Rudum,2018,6552,10156,11466,4914,0,33088,16380,0.495043520309478,0.214518858800774,0.10450918762089
YEM,Rudum,2020,6500,11500,11500,3500,0,33000,15000,0.454545454545455,0.186868686868687,0.0858585858585859
YEM,Rudum,2021,6500,10000,11500,5000,0,33000,16500,0.5,0.217171717171717,0.106060606060606
YEM,Rumah,2018,1479,2465,3549,2465,0,9958,6014,0.60393653344045,0.28382540001339,0.149617281471067
YEM,Rumah,2020,3500,6408,1479,0,0,11387,1479,0.129884956529376,0.0432949855097919,0.0144316618365973
YEM,Rumah,2021,2000,6500,1500,0,0,10000,1500,0.15,0.05,0.0166666666666667
YEM,Sa'ada,2017,107800,107800,377300,485100,0,1078000,862400,0.8,0.416666666666667,0.238888888888889
YEM,Sa'adah,2018,7506,18766,35280,12761,0,74313,48041,0.646468316445306,0.272729311605417,0.129069685728682
YEM,Sa'adah,2020,14000,23500,38000,19000,0,94500,57000,0.603174603174603,0.268077601410935,0.134038800705467
YEM,Sa'adah,2021,9500,14000,38000,33000,0,94500,71000,0.751322751322751,0.3668430335097,0.199882422104644
YEM,Sa'fan,2018,6524,10873,19571,6524,0,43492,26095,0.599995401453141,0.25,0.116667688565969
YEM,Sa'fan,2020,4500,8500,24000,6500,0,43500,30500,0.701149425287356,0.283524904214559,0.127713920817369
YEM,Sa'fan,2021,2000,8500,26000,6500,0,43000,32500,0.755813953488372,0.302325581395349,0.134366925064599
YEM,Sabah,2018,4183,14831,13690,5324,0,38028,19014,0.5,0.213334034571018,0.102222923459907
YEM,Sabah,2020,7500,9500,15000,5500,0,37500,20500,0.546666666666667,0.231111111111111,0.10962962962963
YEM,Sabah,2021,5500,9500,15000,7500,0,37500,22500,0.6,0.266666666666667,0.133333333333333
YEM,Sabir al mawadim,2018,14172,49600,56686,21257,0,141715,77943,0.549998235895988,0.233332157263992,0.111110327064884
YEM,Sabir al mawadim,2020,49600,56686,35500,14172,0,155958,49672,0.31849600533477,0.136455541449194,0.0656786513748003
YEM,Sabir al mawadim,2021,28500,42500,49500,21500,0,142000,71000,0.5,0.217136150234742,0.106025039123631
YEM,Sah,2018,5369,7159,12528,10380,0,35436,22908,0.646461225871995,0.313127892538661,0.169469842344885
YEM,Sah,2020,10738,23266,5500,0,0,39504,5500,0.13922640745241,0.0464088024841366,0.0154696008280455
YEM,Sah,2021,10500,18000,7000,0,0,35500,7000,0.197183098591549,0.0657276995305164,0.0219092331768388
YEM,Sahar,2018,35531,47374,111329,42637,0,236871,153966,0.649999366743924,0.276666765173167,0.132222461452295
YEM,Sahar,2020,35500,47500,106500,47500,0,237000,154000,0.649789029535865,0.283403656821378,0.139006094702297
YEM,Sahar,2021,23500,47500,106500,59000,0,236500,165500,0.699788583509514,0.316420014094433,0.160911439981207
YEM,Salah,2020,34657,38989,12996,12996,0,99638,25992,0.260864328870511,0.130432164435256,0.072462313575142
YEM,Salh,2018,8664,30325,32924,14729,0,86642,47653,0.54999884582535,0.23999907666028,0.117777110921314
YEM,Salh,2020,30500,30500,13000,13000,0,87000,26000,0.298850574712644,0.149425287356322,0.0830140485312899
YEM,Salh,2021,21500,26000,21500,17500,0,86500,39000,0.450867052023121,0.217726396917148,0.117533718689788
YEM,Sama,2018,9180,18361,24481,9180,0,61202,33661,0.549998366066468,0.233331154755291,0.111109295629409
YEM,Sama,2020,9000,24500,21500,6000,0,61000,27500,0.450819672131148,0.183060109289617,0.0828779599271403
YEM,Sama,2021,9000,18500,24500,9000,0,61000,33500,0.549180327868853,0.23224043715847,0.110200364298725
YEM,Sana'a,2017,287500,230000,460000,172500,0,1150000,632500,0.55,0.233333333333333,0.111111111111111
YEM,Sanhan,2018,53202,159606,88670,53202,0,354680,141872,0.4,0.183333333333333,0.0944444444444444
YEM,Sanhan,2020,71000,106500,142000,35500,0,355000,177500,0.5,0.2,0.0888888888888889
YEM,Sanhan,2021,53000,124000,142000,35500,0,354500,177500,0.500705218617772,0.200282087447109,0.0890142610876038
YEM,Saqayn,2018,5578,13944,26772,10040,0,56334,36812,0.653459722370149,0.27722748843209,0.132014216794279
YEM,Saqayn,2020,11000,14000,19500,11000,0,55500,30500,0.54954954954955,0.249249249249249,0.127127127127127
YEM,Saqayn,2021,11000,14000,16500,14000,0,55500,30500,0.54954954954955,0.267267267267267,0.145145145145145
YEM,Sarar,2018,3912,5971,7000,3088,0,19971,10088,0.505132442040959,0.21991888237945,0.10766722859257
YEM,Sarar,2019,3912,5971,7000,3088,0,19971,10088,0.505132442040959,0.21991888237945,0.10766722859257
YEM,Sarar,2020,6176,8235,7206,3088,0,24705,10294,0.416676786075693,0.180557242123727,0.0879624007735726
YEM,Sarar,2021,3000,6000,8000,3000,0,20000,11000,0.55,0.233333333333333,0.111111111111111
YEM,Sayhut,2018,6479,8422,4535,1944,0,21380,6479,0.303040224508887,0.131322107888993,0.0639798357759069
YEM,Sayhut,2020,7558,13000,3239,0,0,23797,3239,0.136109593646258,0.0453698645487527,0.0151232881829176
YEM,Sayhut,2021,4500,13000,4500,0,0,22000,4500,0.204545454545455,0.0681818181818182,0.0227272727272727
YEM,Sayun,2018,39785,47741,55698,15914,0,159138,71612,0.449999371614574,0.183333542795142,0.0833336824363481
YEM,Sayun,2020,47741,87526,47741,15914,0,198922,63655,0.319999798916158,0.13333366847307,0.062222602047257
YEM,Sayun,2021,40000,79500,40000,0,0,159500,40000,0.250783699059561,0.083594566353187,0.0278648554510623
YEM,Shabwah,2017,31600,126400,221200,252800,0,632000,474000,0.75,0.383333333333333,0.216666666666667
YEM,Shada'a,2018,1554,1943,3497,5051,1036,13081,9584,0.732665698341105,0.425731977677548,0.280517119826041
YEM,Shada'a,2020,1500,3000,6500,2000,0,13000,8500,0.653846153846154,0.269230769230769,0.123931623931624
YEM,Shada'a,2021,1500,3000,6000,2500,0,13000,8500,0.653846153846154,0.282051282051282,0.136752136752137
YEM,Shahan,2018,1993,2990,997,528,0,6508,1525,0.234326982175784,0.105152632657242,0.0530799699515127
YEM,Shahan,2020,1500,3000,1000,500,0,6000,1500,0.25,0.111111111111111,0.0555555555555556
YEM,Shahan,2021,1500,3000,1000,500,0,6000,1500,0.25,0.111111111111111,0.0555555555555556
YEM,Shaharah,2018,6095,17066,27427,10361,0,60949,37788,0.619993765279168,0.263329450305447,0.125553058021187
YEM,Shaharah,2020,9000,21500,24500,6000,0,61000,30500,0.5,0.199453551912568,0.0883424408014572
YEM,Shaharah,2021,6000,18500,27500,9000,0,61000,36500,0.598360655737705,0.248633879781421,0.115664845173042
YEM,Shahin,2020,1759,3225,879,293,0,6156,1172,0.190383365821962,0.0793264024258176,0.0370189877987149
YEM,Shara'b ar rawnah,2018,21397,64190,92006,38514,0,216107,130520,0.603960075333053,0.26072578244419,0.126512432370179
YEM,Shara'b ar rawnah,2020,53500,85500,53500,21500,0,214000,75000,0.350467289719626,0.150311526479751,0.0724299065420561
YEM,Shara'b ar rawnah,2021,43000,75000,64000,32000,0,214000,96000,0.448598130841121,0.199376947040498,0.0996884735202492
YEM,Shara'b as salam,2018,24148,48296,61175,27368,0,160987,88543,0.550000931752253,0.240000745401803,0.117778316123524
YEM,Shara'b as salam,2020,32000,56500,56500,16000,0,161000,72500,0.450310559006211,0.183229813664596,0.0831608005521049
YEM,Shara'b as salam,2021,24000,48500,64500,24000,0,161000,88500,0.549689440993789,0.232919254658385,0.110766045548654
YEM,Sharas,2018,3554,4502,11611,4028,0,23695,15639,0.660012660898924,0.276668776816487,0.129999296616726
YEM,Sharas,2020,4500,7000,9500,2500,0,23500,12000,0.51063829787234,0.205673758865248,0.0921985815602837
YEM,Sharas,2021,2500,6000,10500,4500,0,23500,15000,0.638297872340426,0.276595744680851,0.134751773049645
YEM,Shibam,2018,11387,30364,26569,7591,0,75911,34160,0.45000065866607,0.183333113777977,0.0833329674077392
YEM,Shibam,2020,30500,45546,11387,0,0,87433,11387,0.130236867086798,0.0434122890289326,0.0144707630096442
YEM,Shibam,2021,30500,34000,11500,0,0,76000,11500,0.151315789473684,0.0504385964912281,0.016812865497076
YEM,Shibam kawkaban,2018,8431,15738,22483,10117,0,56769,32600,0.574257076925787,0.250823512832708,0.123210829071422
YEM,Shibam kawkaban,2020,11000,22500,17000,5500,0,56000,22500,0.401785714285714,0.166666666666667,0.0773809523809524
YEM,Shibam kawkaban,2021,8500,19500,19500,8500,0,56000,28000,0.5,0.217261904761905,0.106150793650794
YEM,Shu'aub,2018,68639,137279,205918,45760,0,457596,251678,0.550000437066758,0.216667103733424,0.0944447843852559
YEM,Shu'aub,2020,114500,160000,160000,23000,0,457500,183000,0.4,0.150091074681239,0.0612021857923497
YEM,Shu'aub,2021,114500,137500,160000,46000,0,458000,206000,0.449781659388646,0.183406113537118,0.0834546336729743
YEM,Sibah,2018,3567,6465,8471,4013,0,22516,12484,0.554450168768875,0.244226327944573,0.121015179329267
YEM,Sibah,2020,3500,11146,9000,3500,0,27146,12500,0.460472997863405,0.196468479088386,0.0941411462298518
YEM,Sibah,2021,3500,5500,10000,3500,0,22500,13500,0.6,0.251851851851852,0.118518518518519
YEM,Sirwah,2018,492,1010,1010,492,0,3004,1502,0.5,0.221260541500222,0.110149430389111
YEM,Sirwah,2020,3000,5000,16000,8000,0,32000,24000,0.75,0.333333333333333,0.166666666666667
YEM,Sirwah,2021,1500,3000,18000,9500,0,32000,27500,0.859375,0.385416666666667,0.194444444444444
YEM,Socotra,2017,33000,23100,6600,3300,0,66000,9900,0.15,0.0666666666666667,0.0333333333333333
YEM,Suwayr,2018,3073,6147,7376,12601,1537,30734,21514,0.700006507451032,0.403342660679812,0.258898939285482
YEM,Suwayr,2019,3073,7376,12601,7376,0,30426,19977,0.656576612108066,0.299666951510769,0.153761037708977
YEM,Suwayr,2020,3000,7500,14000,6000,0,30500,20000,0.655737704918033,0.284153005464481,0.138433515482696
YEM,Suwayr,2021,1500,7500,14000,7500,0,30500,21500,0.704918032786885,0.316939890710382,0.160291438979964
YEM,Taizz,2017,159100,636400,1272800,1113700,0,3182000,2386500,0.75,0.366666666666667,0.2
YEM,Tarim,2018,46683,62244,38903,7781,0,155611,46684,0.300004498396643,0.116669130074352,0.050001463763987
YEM,Tarim,2020,46683,85586,54464,15561,0,202294,70025,0.346154606661592,0.141025767776932,0.0641025218521338
YEM,Tarim,2021,39000,78000,39000,0,0,156000,39000,0.25,0.0833333333333333,0.0277777777777778
YEM,Thamud,2018,2001,2484,1518,483,0,6486,2001,0.308510638297872,0.127659574468085,0.0591016548463357
YEM,Thamud,2020,2070,4484,1035,0,0,7589,1035,0.136381604954539,0.0454605349848465,0.0151535116616155
YEM,Thamud,2021,1500,4500,1000,0,0,7000,1000,0.142857142857143,0.0476190476190476,0.0158730158730159
YEM,Thula,2018,7951,14312,21203,9541,0,53007,30744,0.579998868074028,0.253331321020494,0.12444268367071
YEM,Thula,2020,10500,16000,24000,2500,0,53000,26500,0.5,0.182389937106918,0.0712788259958071
YEM,Thula,2021,8000,10500,26500,8000,0,53000,34500,0.650943396226415,0.267295597484277,0.122641509433962
YEM,Tuban,2018,21682,43363,57818,21682,0,144545,79500,0.550001729565187,0.233334486376792,0.11111187980675
YEM,Tuban,2020,50590,72272,57818,14454,0,195134,72272,0.370371129582748,0.148147768541959,0.0658430730791263
YEM,Tuban,2021,43500,65000,29000,7000,0,144500,36000,0.249134948096886,0.0991926182237601,0.0438292964244521
YEM,Tur al bahah,2018,13268,16586,26537,9951,0,66342,36488,0.549998492659251,0.233331323545667,0.111109436288056
YEM,Tur al bahah,2020,19903,30000,23220,9951,0,83074,33171,0.399294604810169,0.173026458338349,0.0842943239360891
YEM,Tur al bahah,2021,16500,26500,20000,3500,0,66500,23500,0.353383458646617,0.135338345864662,0.0568086883876358
YEM,Usaylan,2018,8883,11104,16434,7995,0,44416,24429,0.550004502881844,0.243335734870317,0.121112512007685
YEM,Usaylan,2020,4500,15500,18000,6500,0,44500,24500,0.550561797752809,0.232209737827715,0.109862671660424
YEM,Usaylan,2021,4500,13500,18000,9000,0,45000,27000,0.6,0.266666666666667,0.133333333333333
YEM,Utmah,2018,48624,72936,85092,36468,0,243120,121560,0.5,0.216666666666667,0.105555555555556
YEM,Utmah,2020,36500,85000,73000,48500,0,243000,121500,0.5,0.233196159122085,0.122085048010974
YEM,Utmah,2021,36500,61000,85000,61000,0,243500,146000,0.59958932238193,0.283367556468173,0.150125484827744
YEM,Wadhrah,2018,2450,4550,7525,2975,0,17500,10500,0.6,0.256666666666667,0.123333333333333
YEM,Wadhrah,2020,1500,4500,8000,3500,0,17500,11500,0.657142857142857,0.285714285714286,0.13968253968254
YEM,Wadhrah,2021,1000,3500,7000,6000,0,17500,13000,0.742857142857143,0.361904761904762,0.196825396825397
YEM,Wadi al ayn,2018,15081,21545,4309,2154,0,43089,6463,0.149991877277263,0.066660477925534,0.0333289496416977
YEM,Wadi al ayn,2020,15081,23699,8618,0,0,47398,8618,0.181822017806659,0.0606073392688862,0.0202024464229621
YEM,Wadi al ayn,2021,13000,21500,8500,0,0,43000,8500,0.197674418604651,0.0658914728682171,0.0219638242894057
YEM,Wald rabi',2018,2514,9052,9555,4526,0,25647,14081,0.549031075759348,0.241834652525961,0.119827746801662
YEM,Wald rabi',2019,4023,10058,7543,0,0,21624,7543,0.348825379208287,0.116275126402762,0.0387583754675875
YEM,Wald rabi',2020,5000,9000,9000,2500,0,25500,11500,0.450980392156863,0.183006535947712,0.0827886710239651
YEM,Wald rabi',2021,5000,7500,9000,4000,0,25500,13000,0.509803921568627,0.222222222222222,0.108932461873638
YEM,Washhah,2018,9795,14692,34282,39179,0,97948,73461,0.75,0.383332652700072,0.216665986033405
YEM,Washhah,2020,5000,14500,54000,24500,0,98000,78500,0.801020408163265,0.350340136054422,0.172335600907029
YEM,Washhah,2021,5000,10000,44000,34500,5000,98500,83500,0.847715736040609,0.433164128595601,0.256063169768754
YEM,Wusab al ali,2018,55027,68784,110055,41271,0,275137,151326,0.550002362459429,0.233334666002755,0.111111918789548
YEM,Wusab al ali,2020,55000,69000,96500,55000,0,275500,151500,0.549909255898367,0.249848759830611,0.127646702964307
YEM,Wusab al ali,2021,41500,55000,110000,69000,0,275500,179000,0.6497277676951,0.300060496067756,0.155676547691067
YEM,Wusab as safil,2018,26315,52629,105258,78944,0,263146,184202,0.699999239965647,0.333333333333333,0.177777946674301
YEM,Wusab as safil,2020,26500,79000,118500,39500,0,263500,158000,0.599620493358634,0.249841872232764,0.116592873708623
YEM,Wusab as safil,2021,26500,52500,118500,66000,0,263500,184500,0.700189753320683,0.316888045540797,0.161290322580645
YEM,Yabuth,2018,4520,6027,3014,1507,0,15068,4521,0.300039819485001,0.133351030882223,0.0666755154411114
YEM,Yabuth,2020,4520,9794,2500,0,0,16814,2500,0.148685619126918,0.049561873042306,0.0165206243474353
YEM,Yabuth,2021,4500,7500,3000,0,0,15000,3000,0.2,0.0666666666666667,0.0222222222222222
YEM,Yafa'a,2018,20976,36708,31464,15732,0,104880,47196,0.45,0.2,0.1
YEM,Yafa'a,2020,47000,31500,21000,5000,0,104500,26000,0.248803827751196,0.0988835725677831,0.0435938330675173
YEM,Yafa'a,2021,42000,36500,21000,5000,0,104500,26000,0.248803827751196,0.0988835725677831,0.0435938330675173
YEM,Yafi,2020,47196,41952,26220,10488,0,125856,36708,0.291666666666667,0.125,0.0601851851851852
YEM,Yahr,2018,10693,16039,21386,5346,0,53464,26732,0.5,0.19999750611003,0.0888863949989193
YEM,Yahr,2020,21386,26500,16039,8020,0,71945,24059,0.334408228507888,0.148627423726458,0.0743144840580382
YEM,Yahr,2021,16000,18500,16000,2500,0,53000,18500,0.349056603773585,0.132075471698113,0.0545073375262055
YEM,Yarim,2018,37473,74947,99929,37473,0,249822,137402,0.549999599714997,0.233332799619996,0.111110666349997
YEM,Yarim,2020,62500,75000,75000,37500,0,250000,112500,0.45,0.2,0.1
YEM,Yarim,2021,50000,62500,87500,50000,0,250000,137500,0.55,0.25,0.127777777777778
YEM,Yemen,2022,5784500,8557000,11715000,7140500,161000,33358000,19016500,0.570073145872055,0.264594200291784,0.138983818640872
YEM,Zabid,2018,42665,71109,122307,51198,0,287279,173505,0.603959913533534,0.260725636054149,0.126512321935586
YEM,Zabid,2020,71000,99500,85500,28500,0,284500,114000,0.400702987697715,0.166959578207381,0.0779144698301113
YEM,Zabid,2021,57000,71000,114000,42500,0,284500,156500,0.550087873462215,0.233157586408904,0.110915836750635
YEM,Zamakh wa manwakh,2018,500,500,705,295,0,2000,1000,0.5,0.215833333333333,0.104722222222222
YEM,Zamakh wa manwakh,2020,500,1500,500,0,0,2500,500,0.2,0.0666666666666667,0.0222222222222222
YEM,Zamakh wa manwakh,2021,500,1000,500,0,0,2000,500,0.25,0.0833333333333333,0.0277777777777778
YEM,Zamakh wa manwokh,2020,568,1250,455,114,0,2387,569,0.238374528697109,0.0953777405390309,0.0424056230507843
YEM,Zingibar,2018,4071,13026,16690,6920,0,40707,23610,0.57999852605203,0.249997952850042,0.121109391505147
YEM,Zingibar,2019,8141,13840,11805,6106,0,39892,17911,0.448987265617166,0.20068351214947,0.100908564234544
YEM,Zingibar,2020,8000,10000,14000,8000,0,40000,22000,0.55,0.25,0.127777777777778
YEM,Zingibar,2021,4000,10000,16500,10000,0,40500,26500,0.654320987654321,0.300411522633745,0.155006858710562
YEM,Zinjibar,2020,16283,16283,14247,8141,0,54954,22388,0.407395276049059,0.185179119506011,0.0946468359395535
ZAF,Alexandra,2020,124691,38367,19183,9592,0,191833,28775,0.150000260643372,0.0666673617156589,0.0333339704615762
ZAF,Alexandra,2021,86958,57972,38648,9662,0,193240,48310,0.25,0.1,0.0444444444444444
ZAF,Buffalo city,2020,401325,123485,92613,0,0,617423,92613,0.149999271164178,0.0499997570547259,0.0166665856849086
ZAF,Buffalo city,2021,310849,186509,124339,0,0,621697,124339,0.199999356599758,0.0666664521999195,0.0222221507333065
ZAF,City of Cape Town,2020,1601246,1801402,600467,0,0,4003115,600467,0.149999937548634,0.049999979182878,0.016666659727626
ZAF,City of Cape Town,2021,1437574,2053677,616103,0,0,4107354,616103,0.149999975653426,0.0499999918844752,0.0166666639614917
ZAF,City of Johannesburg,2020,2354676,724516,362258,181129,0,3622579,543387,0.150000041406964,0.066666685069762,0.033333342534881
ZAF,City of Johannesburg,2021,2056842,1121914,373971,186986,0,3739713,560957,0.15000001337001,0.0666667023200265,0.0333333660155799
ZAF,City of Tshwane,2020,1836468,1001710,500855,0,0,3339033,500855,0.150000014974395,0.0500000049914651,0.0166666683304884
ZAF,City of Tshwane,2021,1205482,1549905,516635,172212,0,3444234,688847,0.200000058068064,0.0833333817233866,0.0388889243749279
ZAF,Diepsloot,2020,98267,44667,26800,8933,0,178667,35733,0.199997761198207,0.0833319340822125,0.0388879871492777
ZAF,Diepsloot,2021,73528,64337,36764,9191,0,183820,45955,0.25,0.1,0.0444444444444444
ZAF,Eastern cape,2020,2777093,1157122,694273,0,0,4628488,694273,0.149999956789345,0.0499999855964482,0.0166666618654827
ZAF,Eastern cape,2021,2318710,1391226,927484,0,0,4637420,927484,0.2,0.0666666666666667,0.0222222222222222
ZAF,Ekurhuleni,2020,1743855,726606,290643,145321,0,2906425,435964,0.150000086016326,0.0666666666666667,0.0333333142185942
ZAF,Ekurhuleni,2021,1489618,1042733,297924,148962,0,2979237,446886,0.150000151045385,0.0666667337979489,0.0333333668989745
ZAF,Free state,2020,1102171,601184,300592,0,0,2003947,300592,0.14999997504924,0.0499999916830801,0.01666666389436
ZAF,Free state,2021,901777,701382,300592,100197,0,2003948,400789,0.199999700591033,0.0833331669950185,0.0388887890859
ZAF,Ga-rankuwa,2020,58663,19554,14666,4889,0,97772,19555,0.200006136726261,0.0833367426257006,0.0388909344643093
ZAF,Ga-rankuwa,2021,54209,24641,14784,4928,0,98562,19712,0.199995941640795,0.0833316423503311,0.0388880997634878
ZAF,Gauteng,2020,1136819,349790,174895,87448,0,1748952,262343,0.150000114354196,0.0666667810208628,0.0333334222754859
ZAF,Gauteng,2021,903668,632568,180734,90367,0,1807337,271101,0.150000248985109,0.0666667773267151,0.0333333886633576
ZAF,Katlehong,2020,233499,116749,93399,23350,0,466997,116749,0.249999464664655,0.099999928621954,0.0444444920298084
ZAF,Katlehong,2021,237074,118537,94830,23707,0,474148,118537,0.25,0.0999997187938506,0.044444163238295
ZAF,Khayelitsha,2020,229196,137517,68759,22920,0,458392,91679,0.200001308923367,0.0833340605129816,0.0388893251966779
ZAF,Khayelitsha,2021,233232,93293,116616,23323,0,466464,139939,0.299999571242368,0.116666380828245,0.0499998094410525
ZAF,Kwazulu-natal,2020,4390892,1463631,1097723,365908,0,7318154,1463631,0.200000027329296,0.083333356107747,0.0388889055901256
ZAF,Kwazulu-natal,2021,3690493,1845247,1476197,369049,0,7380986,1845246,0.249999932258373,0.0999999638711323,0.0444444233692716
ZAF,Limpopo,2020,3804159,1170511,877883,0,0,5852553,877883,0.15000000854328,0.0500000028477601,0.01666666761592
ZAF,Limpopo,2021,3520174,1173391,880043,293348,0,5866956,1173391,0.199999965910772,0.0833333333333333,0.0388888964642729
ZAF,Mamelodi,2020,276606,85109,63832,0,0,425547,63832,0.149999882504165,0.0499999608347217,0.0166666536115739
ZAF,Mamelodi,2021,262244,109268,65561,0,0,437073,65561,0.150000114397366,0.0500000381324554,0.0166666793774851
ZAF,Mangaung,2020,427378,233115,116558,0,0,777051,116558,0.150000450420886,0.0500001501402954,0.0166667167134318
ZAF,Mangaung,2021,394268,236561,118280,39427,0,788536,157707,0.199999746365416,0.0833333333333333,0.0388889452521297
ZAF,Mdantsane,2020,100082,41701,25020,0,0,166803,25020,0.149997302206795,0.0499991007355983,0.0166663669118661
ZAF,Mdantsane,2021,83975,50385,25192,8397,0,167949,33589,0.199995236649221,0.0833308524214692,0.0388874664994201
ZAF,Motherwell,2020,115445,32984,16492,0,0,164921,16492,0.0999993936490805,0.0333331312163602,0.0111110437387867
ZAF,Motherwell,2021,100743,41976,25186,0,0,167905,25186,0.150001488937197,0.0500004963123989,0.016666832104133
ZAF,Mpumalanga,2020,2807872,1169947,701968,0,0,4679787,701968,0.149999989315753,0.0499999964385844,0.0166666654795281
ZAF,Mpumalanga,2021,2641004,1440548,720274,0,0,4801826,720274,0.150000020825411,0.0500000069418037,0.0166666689806012
ZAF,Nelson Mandela Bay,2020,814168,217111,54278,0,0,1085557,54278,0.0500001381779124,0.0166667127259708,0.00555557090865693
ZAF,Nelson Mandela Bay,2021,550202,330121,165060,55020,0,1100403,220080,0.199999454745216,0.08333310614384,0.0388887828671253
ZAF,New Brighton,2020,33447,10291,7719,0,0,51457,7719,0.150008745165867,0.0500029150552889,0.016667638351763
ZAF,New Brighton,2021,28526,12967,10373,0,0,51866,10373,0.199996143909305,0.0666653813031016,0.0222217937677005
ZAF,North west,2020,2465290,1027204,616322,205441,0,4314257,821763,0.190476135288185,0.079365075685879,0.0370370456218379
ZAF,North west,2021,2063512,1031756,825405,206351,0,4127024,1031756,0.25,0.0999999838463099,0.0444444282907544
ZAF,Northern cape,2020,775672,387836,129279,64639,0,1357426,193918,0.142857142857143,0.0634919816377959,0.0317459498917641
ZAF,Northern cape,2021,668166,467716,200450,0,0,1336332,200450,0.150000149663407,0.0500000498878023,0.0166666832959341
ZAF,Orange Farm,2020,61050,25438,10175,5088,0,101751,15263,0.150003439769634,0.0666692874435305,0.0333351897169452
ZAF,Orange Farm,2021,52493,31496,15748,5249,0,104986,20997,0.199998094984093,0.0833317458200776,0.0388877247125014
ZAF,Philippi,2020,113432,75621,50414,12604,0,252071,63018,0.250000991784061,0.100000925665123,0.0444451497131099
ZAF,Philippi,2021,116347,64637,64637,12927,0,258548,77564,0.299998452898495,0.116665635265663,0.049999312399331
ZAF,Pontsane 2,2020,199,119,60,20,0,398,80,0.201005025125628,0.0837520938023451,0.0390843104410944
ZAF,Pontsane 2,2021,182,121,81,20,0,404,101,0.25,0.0998349834983498,0.0442794279427943
ZAF,Soweto,2020,1176971,362145,181072,90536,0,1810724,271608,0.149999668640831,0.0666665193959249,0.0333332596979624
ZAF,Soweto,2021,1035785,564974,188325,94162,0,1883246,282487,0.150000053099807,0.066666631266795,0.0333332861335045
ZAF,Tembisa,2020,298930,209251,59786,29893,0,597860,89679,0.15,0.0666666666666667,0.0333333333333333
ZAF,Tembisa,2021,307534,215274,61507,30753,0,615068,92260,0.149999674832701,0.0666663414993681,0.0333330804254344
ZAF,Thaba Nchu,2020,41516,18871,11323,3774,0,75484,15097,0.20000264956812,0.0833333333333333,0.0388883000959732
ZAF,Thaba Nchu,2021,38053,19026,15221,3805,0,76105,19026,0.249996715064713,0.0999978100431422,0.0444429844732059
ZAF,Umlazi,2020,251936,104974,62984,0,0,419894,62984,0.149999761844656,0.0499999206148854,0.0166666402049618
ZAF,Umlazi,2021,210802,126481,63241,21080,0,421604,84321,0.200000474378801,0.0833333333333333,0.0388887834713776
ZAF,Western cape,2020,1260691,687650,343825,0,0,2292166,343825,0.150000043626858,0.0500000145422859,0.0166666715140953
ZAF,Western cape,2021,1175366,705220,352610,117537,0,2350733,470147,0.200000170159691,0.08333343968314,0.0388889574254309
ZAF,Zwelitsha,2020,12579,3870,2903,0,0,19352,2903,0.150010334849111,0.0500034449497037,0.0166678149832346
ZAF,Zwelitsha,2021,11692,3897,3897,0,0,19486,3897,0.199989736220877,0.0666632454069588,0.0222210818023196
ZAF,eThekwini,2020,2024212,674737,506053,168684,0,3373686,674737,0.19999994071766,0.0833332839313835,0.0388888526607923
ZAF,eThekwini,2021,1705151,852576,682060,170515,0,3410302,852575,0.249999853385419,0.0999999413541675,0.04444441837963
ZMB,Chadiza,2018,103344,33517,17429,6703,0,160993,24132,0.149894715919326,0.0638433555082105,0.0305334186372492
ZMB,Chadiza,2019,46478,27112,7778,3889,0,85257,11667,0.136845068440128,0.0608200304178347,0.0304100152089174
ZMB,Chama,2018,110314,23292,20187,7764,0,161557,27951,0.173010145026214,0.0736891623389887,0.0352424634442746
ZMB,Chama,2019,71799,44873,37394,7479,0,161545,44873,0.277773994862113,0.108023564125579,0.0462960097117762
ZMB,Chama,2020,63038,57345,49153,8192,0,177728,57345,0.322655968671228,0.122916291561637,0.0512149651902533
ZMB,Chama,2021,134562,52475,24576,0,0,211613,24576,0.116136532254635,0.0387121774182116,0.0129040591394039
ZMB,Chasefu,2019,27947,22104,12631,3158,0,65840,15789,0.239808626974484,0.095924463345484,0.0426336573511543
ZMB,Chasefu,2020,64931,46655,33325,6665,0,151576,39990,0.263828046656463,0.102599795921958,0.0439713411094105
ZMB,Chasefu,2021,73663,55242,33325,6665,0,168895,39990,0.236774327244738,0.0920789050396203,0.039462387874123
ZMB,Chavuma,2018,27751,12242,5305,2040,0,47338,7345,0.155160758798428,0.0660850338699002,0.0316048652480272
ZMB,Chavuma,2019,22434,11437,9531,3812,0,47214,13343,0.282606853899267,0.12111520594174,0.0583136828530144
ZMB,Chavuma,2020,16064,20653,11753,2351,0,50821,14104,0.277523071171366,0.107927825111666,0.0462560315180295
ZMB,Chavuma,2021,18880,18805,11753,2351,0,51789,14104,0.272335824209774,0.105910521539323,0.0453914494927065
ZMB,Chembe,2020,10556,15476,7738,0,0,33770,7738,0.229138288421676,0.076379429473892,0.0254598098246307
ZMB,Chembe,2021,12380,15476,3095,0,0,30951,3095,0.0999967690866208,0.0333322563622069,0.0111107521207356
ZMB,Chibombo,2018,90146,34184,14813,5697,0,144840,20510,0.141604529135598,0.0603125287673755,0.0288448556261315
ZMB,Chibombo,2019,117790,84419,48239,12060,0,262508,60299,0.229703475703598,0.0918816442419533,0.0408364274189316
ZMB,Chibombo,2021,339587,59927,19976,0,0,419490,19976,0.0476197287182054,0.0158732429060685,0.00529108096868949
ZMB,Chiengi,2019,70105,57482,28741,0,0,156328,28741,0.183850621769613,0.0612835405898709,0.0204278468632903
ZMB,Chifunabuli,2020,64880,42368,35389,0,0,142637,35389,0.248105330314014,0.082701776771338,0.0275672589237793
ZMB,Chifunabuli,2021,48420,42368,30263,0,0,121051,30263,0.250002065245227,0.0833340217484091,0.0277780072494697
ZMB,Chikankanta,2019,30048,23643,16693,3378,0,73762,20071,0.272104877850384,0.105966938712797,0.0454991880793784
ZMB,Chikankanta,2021,52756,35534,8884,0,0,97174,8884,0.0914236318356762,0.0304745439452254,0.0101581813150751
ZMB,Chikankata,2018,46496,17043,8862,3409,0,75810,12271,0.161865189289012,0.0689442905509388,0.0329742484867139
ZMB,Chilanga,2019,64331,59870,13304,6652,0,144157,19956,0.138432403560008,0.0615255126933367,0.0307627563466683
ZMB,Chilanga,2021,89876,59382,25449,0,0,174707,25449,0.145666744892878,0.0485555816309593,0.0161851938769864
ZMB,Chililabombwe,2020,69322,48525,20796,0,0,138643,20796,0.149996754253731,0.0499989180845769,0.0166663060281923
ZMB,Chililabombwe,2021,69322,64415,21472,0,0,155209,21472,0.138342493025533,0.0461141643418444,0.0153713881139481
ZMB,Chilubi,2019,47527,37000,13875,4753,0,103155,18628,0.180582618389802,0.0755529704490007,0.0354234996957114
ZMB,Chilubi,2020,33269,39812,34124,11375,0,118580,45499,0.383698768763704,0.15987518974532,0.0746087966867188
ZMB,Chilubi,2021,30007,60013,34124,11375,0,135519,45499,0.335738900080432,0.139891823286772,0.0652831788244535
ZMB,Chinsali,2019,70166,62370,23389,0,0,155925,23389,0.150001603334937,0.0500005344449789,0.016666844814993
ZMB,Chinsali,2020,98662,27353,20515,6838,0,153368,27353,0.178348808095561,0.0743114600177351,0.0346783915520549
ZMB,Chinsali,2021,68382,41029,20515,6838,0,136764,27353,0.200001462373139,0.0833333333333333,0.0388885639170802
ZMB,Chipili,2019,19987,16388,6145,0,0,42520,6145,0.144520225776105,0.0481734085920351,0.0160578028640117
ZMB,Chipili,2020,20992,15079,8616,0,0,44687,8616,0.192807751695124,0.0642692505650413,0.0214230835216804
ZMB,Chipili,2021,19387,15079,8616,0,0,43082,8616,0.199990715379973,0.0666635717933244,0.0222211905977748
ZMB,Chirundu,2018,38945,21002,16102,13301,0,89350,29403,0.329076664801343,0.159313560902817,0.0861854131691849
ZMB,Chirundu,2019,15749,20998,19157,8210,0,64114,27367,0.426849050129457,0.184967401815516,0.0901120573423035
ZMB,Chisamba,2019,62673,44917,25667,6417,0,139674,32084,0.229706316136146,0.091883003756366,0.0408371557261114
ZMB,Chitambo,2018,38649,12883,7975,1840,0,61347,9815,0.159991523627887,0.0633282801114969,0.0277746081941886
ZMB,Chitambo,2020,38520,19777,13184,0,0,71481,13184,0.184440620584491,0.061480206861497,0.0204934022871657
ZMB,Chitambo,2021,32961,23073,9888,0,0,65922,9888,0.149995449167198,0.0499984830557325,0.0166661610185775
ZMB,Choma,2018,246021,38769,8947,8947,0,302684,17894,0.0591177597758719,0.0295588798879359,0.0164215999377422
ZMB,Choma,2019,83959,54403,23315,0,0,161677,23315,0.144207277472986,0.0480690924909954,0.0160230308303318
ZMB,Choma,2021,138965,172731,15703,0,0,327399,15703,0.0479628832097838,0.0159876277365946,0.00532920924553153
ZMB,Chongwe,2018,120378,37618,24452,5643,0,188091,30095,0.160002339293214,0.063334591589532,0.0277785161910399
ZMB,Chongwe,2019,94275,61538,35165,8791,0,199769,43956,0.220034139431043,0.0880133220536386,0.039116846624518
ZMB,Gwembe,2018,42193,22291,10349,4777,0,79610,15126,0.190001256123603,0.0833354268726709,0.0411129255118704
ZMB,Gwembe,2019,25867,23153,19294,15435,0,83749,34729,0.414679578263621,0.199660095443926,0.10750907805201
ZMB,Gwembe,2020,29562,23822,31762,3970,0,89116,35732,0.400960545805467,0.148503074644284,0.0594007311319578
ZMB,Gwembe,2021,43349,34679,19852,3970,0,101850,23822,0.233892979872361,0.0909572901325479,0.0389810723831342
ZMB,Ikelenge,2019,18424,16809,6303,2101,0,43637,8404,0.192588858079153,0.0802453575329804,0.0374478335153909
ZMB,Isoka,2019,44860,33660,8415,0,0,86935,8415,0.096796457123138,0.0322654857077127,0.0107551619025709
ZMB,Isoka,2020,60226,34153,22769,5692,0,122840,28461,0.231691631390427,0.0926761098447846,0.041189080646912
ZMB,Isoka,2021,58018,43459,22769,5692,0,129938,28461,0.219035232187659,0.087613579809858,0.0389390837681561
ZMB,Itezhi-tezhi,2018,74140,17826,6291,12583,0,110840,18874,0.17028148682786,0.0946018284614459,0.0567614980552548
ZMB,Itezhi-tezhi,2019,34584,41306,12969,4323,0,93182,17292,0.185572320834496,0.0773218003477066,0.0360835068289298
ZMB,Itezhi-tezhi,2021,91764,17985,17985,0,0,127734,17985,0.140800413359012,0.0469334711196706,0.0156444903732235
ZMB,Kabompo,2019,20031,13706,11422,2284,0,47443,13706,0.288894041270577,0.112345340724659,0.048146664886753
ZMB,Kafue,2018,102962,63074,14709,4903,0,185648,19612,0.105640782556235,0.0440169927317648,0.0205412632748236
ZMB,Kafue,2019,37112,29848,17056,4264,0,88280,21320,0.241504304485727,0.0966017217942909,0.0429340985752404
ZMB,Kafue,2021,173295,143094,53660,0,0,370049,53660,0.145007823288267,0.0483359410960891,0.016111980365363
ZMB,Kalabo,2018,45249,37348,14939,2801,0,100337,17740,0.176804169947278,0.0682400310952091,0.0289502155513697
ZMB,Kalabo,2019,21651,26270,35026,13135,0,96082,48161,0.501248933202889,0.212651693345268,0.101263041522403
ZMB,Kalabo,2020,17321,40604,30453,15227,0,103605,45680,0.440905361710342,0.195959010987243,0.0979800417182783
ZMB,Kalabo,2021,25378,55771,30942,5076,0,117167,36018,0.307407375796939,0.116910051465003,0.0485973012879053
ZMB,Kalomo,2018,171195,69662,44584,8359,0,293800,52943,0.180200816882233,0.0695507147719537,0.0295060887981242
ZMB,Kalomo,2019,126499,92243,79065,13178,0,310985,92243,0.296615592391916,0.112996875519184,0.0470822994320912
ZMB,Kalomo,2021,260113,45902,15301,0,0,321316,15301,0.0476197886193031,0.015873262873101,0.00529108762436701
ZMB,Kanchibiya,2019,70914,49258,12315,0,0,132487,12315,0.0929525160959188,0.030984172031973,0.010328057343991
ZMB,Kanchibiya,2020,78130,40613,27076,6769,0,152588,33845,0.221806433009149,0.0887225732036595,0.039432254757182
ZMB,Kanchibiya,2021,60920,74198,27076,6769,0,168963,33845,0.20031012706924,0.080124050827696,0.0356106892567538
ZMB,Kaoma,2018,127213,76589,39389,6565,0,249756,45954,0.183995579685773,0.0700937448282857,0.0292058382314472
ZMB,Kaoma,2019,37622,37622,28636,4773,0,108653,33409,0.307483456508334,0.117137431394746,0.048807774392894
ZMB,Kapiri mposhi,2019,152524,78370,65309,0,0,296203,65309,0.220487300938883,0.0734957669796277,0.0244985889932092
ZMB,Kapiri mposhi,2021,139010,196307,53538,0,0,388855,53538,0.137681140785126,0.0458937135950419,0.0152979045316806
ZMB,Kaputa,2019,36996,33904,16952,0,0,87852,16952,0.192960888767473,0.0643202962558242,0.0214400987519414
ZMB,Kaputa,2020,43358,34734,19848,4962,0,102902,24810,0.241103185555188,0.0964412742220754,0.0428627885431446
ZMB,Kaputa,2021,39696,34734,19848,4962,0,99240,24810,0.25,0.1,0.0444444444444444
ZMB,Kasama,2019,163624,42123,10531,0,0,216278,10531,0.0486919612720665,0.0162306537573555,0.0054102179191185
ZMB,Kasama,2020,129826,113597,64913,16228,0,324564,81141,0.25,0.0999997945962378,0.0444442390406823
ZMB,Kasama,2021,129826,113597,64913,16228,0,324564,81141,0.25,0.0999997945962378,0.0444442390406823
ZMB,Kasempa,2021,43397,44577,14859,0,0,102833,14859,0.144496416519989,0.0481654721733296,0.0160551573911099
ZMB,Katete,2018,133024,91708,30569,6114,0,261415,36683,0.140324770958055,0.0545709567800879,0.0233876743449645
ZMB,Katete,2019,160174,93435,41073,13691,0,308373,54764,0.177590126243218,0.0739958859346744,0.0345314134361814
ZMB,Kawambwa,2019,44960,39964,14987,0,0,99911,14987,0.150003503117775,0.0500011677059249,0.016667055901975
ZMB,Kawambwa,2020,51704,40214,29476,5895,0,127289,35371,0.277879471124763,0.108063802318608,0.0463128087353276
ZMB,Kawambwa,2021,47162,35372,29476,5895,0,117905,35371,0.29999575929774,0.116664546315537,0.0499988220271499
ZMB,Kazungula,2018,106947,23249,20149,4650,0,154995,24799,0.159998709635795,0.0633332258029829,0.0277779569950285
ZMB,Kazungula,2019,59459,54248,46499,7750,0,167956,54249,0.32299530829503,0.123046115252407,0.0512693800757341
ZMB,Kazungula,2020,68436,60832,62638,7830,0,199736,70468,0.352805703528658,0.130669149944594,0.0522678824937807
ZMB,Kazungula,2021,92564,78869,39149,7830,0,218412,46979,0.215093493031518,0.0836477238735357,0.0358491698665316
ZMB,Kitwe,2021,236497,610843,40723,0,0,888063,40723,0.0458559809382893,0.0152853269794298,0.00509510899314325
ZMB,Lavushimanda,2019,21979,13986,5753,0,0,41718,5753,0.137902104607124,0.0459673682023747,0.0153224560674582
ZMB,Lavushimanda,2020,21754,14392,8224,2056,0,46426,10280,0.221427648300521,0.0885710593202085,0.039364915253426
ZMB,Lavushimanda,2021,18504,14392,8224,0,0,41120,8224,0.2,0.0666666666666667,0.0222222222222222
ZMB,Limulunga,2018,19359,27655,22124,5531,0,74669,27655,0.370367890289143,0.148147156115657,0.0658431804958476
ZMB,Limulunga,2019,12346,19947,17453,4938,0,54684,22391,0.409461634116012,0.166587423499866,0.0755959492518632
ZMB,Limulunga,2020,18191,21607,24693,3087,0,67578,27780,0.411080529166297,0.152253692029951,0.0609024633263291
ZMB,Limulunga,2021,18817,33916,21607,3087,0,77427,24694,0.3189326720653,0.119600828307094,0.0487269011814713
ZMB,Livingstone,2021,40299,137141,30224,0,0,207664,30224,0.145542799907543,0.0485142666358477,0.0161714222119492
ZMB,Luampa,2018,36953,12670,6588,1520,0,57731,8108,0.140444475238607,0.0555911613055955,0.0243812779192385
ZMB,Luampa,2019,22472,17738,15204,0,0,55414,15204,0.274371097556574,0.091457032518858,0.030485677506286
ZMB,Luangwa,2018,15049,10328,5311,3836,0,34524,9147,0.264946124435176,0.125352411848762,0.0664754953076121
ZMB,Luangwa,2019,10280,7841,6534,3920,0,28575,10454,0.365844269466317,0.167675707203266,0.0863769806551959
ZMB,Luangwa,2020,14709,12499,9193,1839,0,38240,11032,0.288493723849372,0.112194909344491,0.0480851929335193
ZMB,Luangwa,2021,10841,16548,11005,1839,0,40233,12844,0.319240424527129,0.121649723692823,0.0507074071312383
ZMB,Luano,2018,85206,21830,8732,3275,0,119043,12007,0.100862713473283,0.0427912603008997,0.0203773239735035
ZMB,Luano,2019,17387,14433,7216,1804,0,40840,9020,0.220861900097943,0.0883447600391773,0.0392643377951899
ZMB,Luano,2020,18463,8617,6894,1723,0,35697,8617,0.24139283413172,0.0965533985115463,0.0429105464822752
ZMB,Luano,2021,17409,16247,8617,0,0,42273,8617,0.203841695644974,0.0679472318816581,0.022649077293886
ZMB,Lufwanyama,2021,44042,59183,11011,0,0,114236,11011,0.0963881788578031,0.0321293929526011,0.010709797650867
ZMB,Lukulu,2018,29712,32557,15917,5788,0,83974,21705,0.258472860647343,0.109132985606656,0.0516945721294686
ZMB,Lukulu,2019,30910,18967,12645,6322,0,68844,18967,0.275506943233978,0.122445916371313,0.0612221512082066
ZMB,Lukulu,2020,13991,28732,25141,7183,0,75047,32324,0.430716750836143,0.175476701267206,0.0797618677480631
ZMB,Lukulu,2021,28457,36182,21549,3592,0,89780,25141,0.280028959679216,0.106679290116581,0.0444506324100889
ZMB,Lumezi,2019,58814,35074,20042,0,0,113930,20042,0.175915035548144,0.0586383451827145,0.0195461150609048
ZMB,Lumezi,2020,60956,37541,31285,6257,0,136039,37542,0.275964980630554,0.10731971468966,0.0459941634384258
ZMB,Lumezi,2021,62868,51862,31285,6257,0,152272,37542,0.246545655143428,0.0958788658891107,0.0410909425239046
ZMB,Lundazi,2018,290917,171510,41560,34302,0,538289,75862,0.140931729981478,0.0682186211000658,0.0369004588819595
ZMB,Lundazi,2019,242761,125230,62615,20872,0,451478,83487,0.184919309468014,0.0770498968572851,0.0359567169755042
ZMB,Lundazi,2020,110196,43505,26103,8701,0,188505,34804,0.184631707381767,0.0769298780757363,0.0359006097686769
ZMB,Lundazi,2021,95711,43505,26103,8701,0,174020,34804,0.2,0.0833333333333333,0.0388888888888889
ZMB,Lunga,2018,15505,4307,5168,3733,0,28713,8901,0.309998955177097,0.146669917226808,0.0777812605207862
ZMB,Lunga,2019,5635,8614,11485,5743,0,31477,17228,0.547320265590749,0.243256981287925,0.121630255601091
ZMB,Lunga,2020,4764,9862,11116,6352,0,32094,17468,0.544276188695706,0.247398267588957,0.126448003434356
ZMB,Lunga,2021,11116,14186,9631,4764,0,39697,14395,0.362621860594,0.160876976429789,0.0802943407422335
ZMB,Lunte district,2020,37301,29881,21344,4269,0,92795,25613,0.27601702677946,0.10734055354994,0.0460034364878376
ZMB,Lunte district,2021,29881,29881,21344,4269,0,85375,25613,0.300005856515373,0.116669594924353,0.0500016268098259
ZMB,Lupososhi,2020,46694,36317,32062,5344,0,120417,37406,0.310637202388367,0.118338772764643,0.0493082833450057
ZMB,Lupososhi,2021,37406,32062,32062,5344,0,106874,37406,0.35000093568127,0.133334580908359,0.0555565952014106
ZMB,Lusaka,2021,1471025,1110762,416536,0,0,2998323,416536,0.138922991285462,0.0463076637618206,0.0154358879206069
ZMB,Lusangazi,2021,24035,15701,6729,0,0,46465,6729,0.144818680727429,0.0482728935758098,0.0160909645252699
ZMB,Luwingu,2019,118746,30606,7652,0,0,157004,7652,0.0487376117805916,0.0162458705935305,0.00541529019784351
ZMB,Luwingu,2020,28016,25650,12825,6412,0,72903,19237,0.263871171282389,0.117274552030323,0.0586365139675703
ZMB,Luwingu,2021,19237,25650,12825,6412,0,64124,19237,0.299996881042979,0.133330214376313,0.0666642408112061
ZMB,Mafinga,2019,51939,43802,16426,5475,0,117642,21901,0.186166505159722,0.0775686687860912,0.0361983343061529
ZMB,Mafinga,2021,60741,57528,19176,0,0,137445,19176,0.139517625231911,0.0465058750773037,0.0155019583591012
ZMB,Mambwe,2018,45463,24081,19264,12522,0,101330,31786,0.313687950261522,0.145754794565611,0.0760463611741614
ZMB,Mambwe,2019,46892,22128,22128,4426,0,95574,26554,0.27783706865884,0.108048911489178,0.0463073406761021
ZMB,Mambwe,2020,35864,32212,23009,9203,0,100288,32212,0.321194958519464,0.137653557753669,0.0662769003048997
ZMB,Mambwe,2021,36814,32212,18407,4602,0,92035,23009,0.250002716357907,0.100001810905272,0.0444456517146255
ZMB,Mansa,2019,78889,70123,26296,0,0,175308,26296,0.149998859150752,0.0499996197169173,0.0166665399056391
ZMB,Mansa,2020,122046,108486,40682,0,0,271214,40682,0.14999963128747,0.0499998770958235,0.0166666256986078
ZMB,Mansa,2021,122046,108486,40682,0,0,271214,40682,0.14999963128747,0.0499998770958235,0.0166666256986078
ZMB,Manyinga,2019,25754,14418,7209,2403,0,49784,9612,0.193074080025711,0.0804475333440463,0.0375421822272216
ZMB,Masaiti,2021,62175,49274,18652,0,0,130101,18652,0.143365539081175,0.0477885130270585,0.0159295043423528
ZMB,Mazabuka,2018,155855,48663,5840,5840,0,216198,11680,0.0540245515684697,0.0270122757842348,0.0150068198801305
ZMB,Mazabuka,2019,54949,49412,30883,6177,0,141421,37060,0.262054433217132,0.101910843038398,0.0436765245457024
ZMB,Mazabuka,2020,161463,76735,51156,0,0,289354,51156,0.176793823482654,0.0589312744942182,0.0196437581647394
ZMB,Mazabuka,2021,153589,76735,51156,0,0,281480,51156,0.181739377575671,0.0605797925252238,0.0201932641750746
ZMB,Mbala,2019,203915,37059,12353,0,0,253327,12353,0.0487630611817927,0.0162543537272642,0.00541811790908808
ZMB,Mbala,2020,65665,56671,21888,7296,0,151520,29184,0.192608236536431,0.0802534318901795,0.0374516015487504
ZMB,Mbala,2021,242144,58369,29319,0,0,329832,29319,0.0888907079967984,0.0296302359989328,0.0098767453329776
ZMB,Milengi,2019,24535,21809,8178,0,0,54522,8178,0.149994497633983,0.0499981658779942,0.0166660552926647
ZMB,Milengi,2020,27937,20068,14334,0,0,62339,14334,0.229936315949887,0.0766454386499623,0.0255484795499874
ZMB,Milengi,2021,31795,36901,11467,2867,0,83030,14334,0.172636396483199,0.0690553615159179,0.0306917178529849
ZMB,Mitete,2018,30386,32557,15917,5788,0,84648,21705,0.256414800113411,0.108264026714551,0.0512829600226822
ZMB,Mitete,2019,9959,13580,10185,1698,0,35422,11883,0.335469482242674,0.127801931003331,0.0532531571716259
ZMB,Mitete,2020,6565,15038,11489,3342,0,36434,14831,0.407064829554811,0.166264112276079,0.0758052612638988
ZMB,Mitete,2021,10187,16709,10025,1671,0,38592,11696,0.303067993366501,0.115455707573245,0.0481072646029114
ZMB,Mkushi,2018,85166,21820,8728,3273,0,118987,12001,0.100859757788666,0.0427889881527674,0.0203757086441749
ZMB,Mkushi,2020,118635,43506,26103,0,0,188244,26103,0.138665774207943,0.046221924735981,0.015407308245327
ZMB,Mkushi,2021,87012,60908,26103,0,0,174023,26103,0.149997414134913,0.0499991380449711,0.0166663793483237
ZMB,Mongu,2019,23287,37623,32920,4703,0,98533,37623,0.381831467630134,0.143187223231472,0.0583357859803315
ZMB,Mongu,2020,46193,54866,54866,15676,0,171601,70542,0.41108152050396,0.167477656501613,0.0761262075007333
ZMB,Mongu,2021,39190,62704,47028,7838,0,156760,54866,0.35,0.133333333333333,0.0555555555555556
ZMB,Monze,2018,90283,45198,14689,3390,0,153560,18079,0.117732482417296,0.0466028479638795,0.0204400740933692
ZMB,Monze,2019,63903,63903,63903,18258,0,209967,82161,0.391304347826087,0.159420289855072,0.072463768115942
ZMB,Monze,2021,115599,105474,23439,0,0,244512,23439,0.0958603258735768,0.0319534419578589,0.0106511473192863
ZMB,Mpika,2019,47864,31736,13601,0,0,93201,13601,0.145931910601818,0.0486439702006059,0.0162146567335353
ZMB,Mpika,2020,76304,43271,28847,7212,0,155634,36059,0.231691018672013,0.0926768358242201,0.0411899427859951
ZMB,Mpika,2021,64906,50482,28847,0,0,144235,28847,0.2,0.0666666666666667,0.0222222222222222
ZMB,Mpongwe,2021,67913,78403,15681,0,0,161997,15681,0.0967980888534973,0.0322660296178324,0.0107553432059441
ZMB,Mporokoso,2019,90590,23349,5837,0,0,119776,5837,0.0487326342506011,0.016244211416867,0.00541473713895568
ZMB,Mporokoso,2020,18555,20589,13254,2651,0,55049,15905,0.288924412795873,0.112360503066965,0.0481550780012151
ZMB,Mporokoso,2021,18555,18555,13254,2651,0,53015,15905,0.30000943129303,0.116671382313182,0.0500026198036195
ZMB,Mpulungu,2019,46826,41623,15609,0,0,104058,15609,0.150002883007554,0.0500009610025178,0.0166669870008393
ZMB,Mpulungu,2020,39995,54924,41193,6866,0,142978,48059,0.336128635174642,0.128050003030769,0.0533547507697377
ZMB,Mpulungu,2021,34328,54924,41193,6866,0,137311,48059,0.350001092410659,0.133334789880879,0.0555567693451767
ZMB,Mufumbwe,2019,32499,20013,13342,6671,0,72525,20013,0.275946225439504,0.122642766862002,0.0613213834310008
ZMB,Mulobezi,2018,21412,9288,6688,4830,0,42218,11518,0.27282201904401,0.129076065501287,0.0684489501581737
ZMB,Mulobezi,2019,16719,13313,9510,3804,0,43346,13314,0.307156369676556,0.131638444147095,0.0633814731078608
ZMB,Mulobezi,2020,3709,16691,14572,3709,0,38681,18281,0.472609291383367,0.189498720301957,0.0844744333278756
ZMB,Mulobezi,2021,14836,20377,7418,1855,0,44486,9273,0.208447601492604,0.083382037794662,0.0370603485740832
ZMB,Mumbwa,2018,177071,94931,41137,15822,0,328961,56959,0.173148184739224,0.0737483572014109,0.0352709828149166
ZMB,Mumbwa,2019,114500,86311,32367,10789,0,243967,43156,0.176892776482065,0.0737053235341938,0.0343958176492905
ZMB,Mumbwa,2021,288776,52786,17595,0,0,359157,17595,0.0489897175886869,0.0163299058628956,0.00544330195429854
ZMB,Mungwi,2018,116366,49308,25640,5917,0,197231,31557,0.160000202807875,0.0633335192405521,0.0277779186165799
ZMB,Mungwi,2019,149499,38532,9633,0,0,197664,9633,0.0487342156386595,0.0162447385462198,0.00541491284873995
ZMB,Mungwi,2020,63447,82135,63447,10575,0,219604,74022,0.337070363017067,0.128408407861423,0.0535038827465195
ZMB,Mungwi,2021,114625,96375,63447,10575,0,285022,74022,0.259706268288062,0.0989362224670376,0.0412237184030239
ZMB,Mushindano,2021,24353,24840,7452,0,0,56645,7452,0.131556183246535,0.0438520610821785,0.0146173536940595
ZMB,Mwandi,2018,27557,10222,3271,1227,0,42277,4498,0.106393547318873,0.0451388067586,0.0214957962432949
ZMB,Mwandi,2019,12558,18399,8372,4186,0,43515,12558,0.288590141330576,0.128262285035811,0.0641311425179057
ZMB,Mwandi,2020,5989,13476,10670,3049,0,33184,13719,0.413422131147541,0.168434586949534,0.0765630022500804
ZMB,Mwandi,2021,21318,10670,9146,1524,0,42658,10670,0.250128932439402,0.095284979761514,0.0397007725527581
ZMB,Mwansabombwe,2020,32118,17978,14982,0,0,65078,14982,0.230216048434187,0.0767386828113956,0.0255795609371319
ZMB,Mwansabombwe,2021,26967,17978,11985,2996,0,59926,14981,0.249991656376197,0.0999955500673052,0.0444418486503725
ZMB,Mwense,2019,38030,33804,12677,0,0,84511,12677,0.150004141472708,0.0500013804909026,0.0166671268303009
ZMB,Mwense,2020,61888,40415,17321,0,0,119624,17321,0.144795358790878,0.0482651195969594,0.0160883731989865
ZMB,Mwense,2021,57735,40415,17321,0,0,115471,17321,0.150003031064077,0.0500010103546922,0.0166670034515641
ZMB,Mwinilunga,2019,58653,54180,18060,0,0,130893,18060,0.137975292796406,0.0459917642654687,0.0153305880884896
ZMB,Nakonde,2019,74018,56057,14014,0,0,144089,14014,0.0972593327734942,0.0324197775911647,0.0108065925303882
ZMB,Nakonde,2020,80747,40763,27175,6794,0,155479,33969,0.218479666064227,0.0873922952081417,0.0388412583049801
ZMB,Nakonde,2021,47556,61144,20381,0,0,129081,20381,0.157893105879254,0.0526310352930847,0.0175436784310282
ZMB,Nalolo,2018,32089,22339,11489,5106,0,71023,16595,0.233656702758261,0.101849635564066,0.049925923840008
ZMB,Nalolo,2019,18876,19148,22339,9574,0,69937,31913,0.456310679611651,0.197735104451149,0.0963327312041154
ZMB,Nalolo,2020,9961,30423,26563,6761,0,73708,33324,0.45210831931405,0.181278377742805,0.0808098623396827
ZMB,Nalolo,2021,23637,34347,20282,3380,0,81646,23662,0.28981211571908,0.110403449036083,0.0460007566540648
ZMB,Namwala,2018,240641,132935,49376,11394,0,434346,60770,0.139911499127424,0.0553813472822742,0.0242899030317356
ZMB,Namwala,2019,70212,41821,17923,0,0,129956,17923,0.137915910000308,0.0459719700001026,0.0153239900000342
ZMB,Namwala,2021,66009,53857,20196,0,0,140062,20196,0.144193285830561,0.0480644286101869,0.0160214762033956
ZMB,Nchelenge,2019,71001,63112,23667,0,0,157780,23667,0.15,0.05,0.0166666666666667
ZMB,Nchelenge,2021,86545,111526,33458,0,0,231529,33458,0.14450889521399,0.0481696317379968,0.0160565439126656
ZMB,Ndola,2021,209196,358622,59770,0,0,627588,59770,0.0952376399803693,0.0317458799934564,0.0105819599978188
ZMB,Ngabwe,2018,23060,3582,827,827,0,28296,1654,0.0584534916595985,0.0292267458297993,0.0162370810165551
ZMB,Ngabwe,2019,12066,11022,5511,1378,0,29977,6889,0.229809520632485,0.0919260321802271,0.0408572498174526
ZMB,Nkeyema,2018,39079,20118,7472,3449,0,70118,10921,0.155751732793291,0.0683134145297926,0.0337019183535057
ZMB,Nkeyema,2019,20118,20118,17244,5664,0,63144,22908,0.362789813759027,0.150829849233498,0.0702098906203809
ZMB,Nsama,2020,33055,27236,13618,3405,0,77314,17023,0.220180045011253,0.0880737425735744,0.0391448436821849
ZMB,Nsama,2021,30993,32283,13618,3405,0,80299,17023,0.211995168059378,0.084799727684446,0.0376896903379176
ZMB,Nyimba,2018,68420,25262,13136,8084,0,114902,21220,0.184679117856956,0.0850115750813737,0.0439717711131612
ZMB,Nyimba,2019,52100,38612,19306,4827,0,114845,24133,0.210135399886804,0.0840553209398174,0.0373585654094166
ZMB,Nyimba,2020,66367,34062,22708,5677,0,128814,28385,0.220356482990979,0.0881425931963917,0.039174485865063
ZMB,Nyimba,2021,73413,45416,22708,0,0,141537,22708,0.16043861322481,0.0534795377416035,0.0178265125805345
ZMB,Pemba,2018,66688,10509,2425,2425,0,82047,4850,0.0591124599315027,0.0295562299657513,0.0164201277587507
ZMB,Pemba,2019,23160,31444,31444,3930,0,89978,35374,0.39314054546667,0.145605962939089,0.0582413972798289
ZMB,Petauke,2018,213582,97927,50922,31337,0,393768,82259,0.208902196217062,0.0961615299702702,0.049738819699812
ZMB,Petauke,2019,231748,91544,54926,18309,0,396527,73235,0.184691080304746,0.0769548269516746,0.035912364661731
ZMB,Petauke,2020,63232,75719,25240,8413,0,172604,33653,0.194972306551413,0.081237978262381,0.0379107990287337
ZMB,Petauke,2021,58892,75719,25240,8413,0,168264,33653,0.200001188608377,0.0833333333333333,0.0388886247536939
ZMB,Rufunsa,2018,42358,20367,12220,5431,0,80376,17651,0.219605354832288,0.0957250920672838,0.046923902104553
ZMB,Rufunsa,2019,33093,20367,16973,3395,0,73828,20368,0.275884488270033,0.107289917104622,0.0459822530446142
ZMB,Rufunsa,2020,30867,27009,19292,0,0,77168,19292,0.25,0.0833333333333333,0.0277777777777778
ZMB,Rufunsa,2021,46063,27009,19292,0,0,92364,19292,0.20886925642025,0.0696230854734168,0.0232076951578056
ZMB,Samfya,2018,106752,94144,27197,10460,0,238553,37657,0.157855906234673,0.0672345348832335,0.0321554446088617
ZMB,Samfya,2019,47827,68235,77982,19496,0,213540,97478,0.456485904280229,0.182594986107209,0.0811536740449356
ZMB,Samfya,2020,22071,43015,44141,5518,0,114745,49659,0.432777027321452,0.160288756227577,0.0641160834894767
ZMB,Samfya,2021,75385,131603,33106,5518,0,245612,38624,0.15725616012247,0.0599074963763986,0.0249616830158498
ZMB,Senanga,2018,45981,24549,14729,4910,0,90169,19639,0.217802127116858,0.0907518104891925,0.0423513377965573
ZMB,Senanga,2019,13026,22796,29732,9911,0,75465,39643,0.525316371828,0.21888292585967,0.102145954342337
ZMB,Senanga,2021,38795,43845,13154,0,0,95794,13154,0.137315489487859,0.0457718298292865,0.0152572766097622
ZMB,Senga hill,2020,73944,55389,27695,6924,0,163952,34619,0.21115326437006,0.0844617123711005,0.0375387647333095
ZMB,Senga hill,2021,48466,55389,27695,6924,0,138474,34619,0.25000361078614,0.100001925752608,0.0444455678001326
ZMB,Serenje,2019,80736,47903,34217,6843,0,169699,41060,0.241957819433232,0.0940940528032968,0.0403256484848009
ZMB,Serenje,2020,92932,39760,31808,7952,0,172452,39760,0.230556908589057,0.0922227634356227,0.0409878948602767
ZMB,Serenje,2021,175435,55664,23856,0,0,254955,23856,0.0935694534329588,0.0311898178109863,0.0103966059369954
ZMB,Sesheke,2018,59356,55809,22324,9922,0,147411,32246,0.218748940038396,0.0953524499528529,0.0467415743887649
ZMB,Sesheke,2019,9008,13198,7507,3003,0,32716,10510,0.321249541508742,0.137679830460121,0.0662910434581788
ZMB,Sesheke,2020,8004,26206,18675,5336,0,58221,24011,0.412411329245461,0.168020702724676,0.0763737406701286
ZMB,Sesheke,2021,29315,24397,18675,5336,0,77723,24011,0.308930432433128,0.125861499599003,0.0572102923916415
ZMB,Shang'ombo,2018,41940,16338,8496,3921,0,70695,12417,0.175641841714407,0.077035151000778,0.0380036306197987
ZMB,Shang'ombo,2019,15886,28595,26140,13070,0,83691,39210,0.468509158690899,0.208226292751511,0.104113146375755
ZMB,Shang'ombo,2020,9110,27823,24292,9274,0,70499,33566,0.476120228655726,0.20255606462503,0.0967515693682022
ZMB,Shang'ombo,2021,9274,27823,21640,3091,0,61828,24731,0.399996765219642,0.149996765219642,0.0611085951708323
ZMB,Shangombo,2021,18528,30881,21987,0,0,71396,21987,0.307958429043644,0.102652809681215,0.0342176032270715
ZMB,Shibuyunji,2018,34285,18338,7946,3056,0,63625,11002,0.172919449901768,0.0736502946954813,0.0352237502728662
ZMB,Shibuyunji,2019,28015,19577,16314,3263,0,67169,19577,0.291458857508672,0.113345938354499,0.0485773033525717
ZMB,Shiwang'andu,2018,50575,18695,7478,5982,0,82730,13460,0.162697933035175,0.0783351464603731,0.0421800502303343
ZMB,Shiwang'andu,2019,47934,30504,8715,4185,0,91338,12900,0.141233659594035,0.0623508287897699,0.0309655711022065
ZMB,Shiwang'andu,2020,49886,23575,23575,4715,0,101751,28290,0.278031665536457,0.1081234254864,0.0463386109227428
ZMB,Shiwang'andu,2021,42434,23575,23575,4715,0,94299,28290,0.300003181369898,0.116667903866071,0.0500005302283163
ZMB,Siavonga,2018,29792,22187,10776,2536,0,65291,13312,0.203887212632675,0.0809095689553946,0.0356012994814667
ZMB,Siavonga,2019,9280,8467,7257,2419,0,27423,9676,0.352842504467053,0.147017710194606,0.0686082647574826
ZMB,Siavonga,2020,24901,22435,19230,3205,0,69771,22435,0.32155193418469,0.122495974927501,0.0510399895531254
ZMB,Siavonga,2021,57930,67864,30162,3205,0,159161,33367,0.209643065826427,0.0765933027982148,0.0300059548367865
ZMB,Sikongo,2018,24653,20348,8139,1526,0,54666,9665,0.176800936596788,0.0682386370565495,0.0289495400350411
ZMB,Sikongo,2019,9930,14732,19860,7448,0,51970,27308,0.525456994419858,0.222923481495735,0.106155260513544
ZMB,Sikongo,2021,13809,30901,14046,0,0,58756,14046,0.239056436789434,0.0796854789298114,0.0265618263099371
ZMB,Sinazongwe,2018,68322,38116,20328,5082,0,131848,25410,0.192721922213458,0.0770887688853832,0.0342616750601703
ZMB,Sinazongwe,2019,40372,40372,41292,11798,0,133834,53090,0.396685446149708,0.161613142649352,0.0734608212827499
ZMB,Sinazongwe,2020,30379,66381,68353,7595,0,172708,75948,0.439748013988929,0.16124132447059,0.0635195435841613
ZMB,Sinazongwe,2021,59735,68353,30379,7595,0,166062,37974,0.228673627922101,0.0914698526253247,0.0406534908648577
ZMB,Sinda,2018,103387,47376,24635,15160,0,190558,39795,0.208834055773045,0.0961299621812431,0.0497223942316775
ZMB,Sinda,2019,111586,52854,17618,8809,0,190867,26427,0.138457669476651,0.0615367419896228,0.0307683709948114
ZMB,Sinda,2020,68954,25119,15071,5024,0,114168,20095,0.176012542919207,0.0733392894681522,0.0342253910416618
ZMB,Sinda,2021,35166,45214,15071,5024,0,100475,20095,0.2,0.0833341627270465,0.0388897182826021
ZMB,Sioma,2018,34694,18973,5421,4337,0,63425,9758,0.153851005124162,0.0740769938247274,0.0398878815749135
ZMB,Sioma,2019,10842,21684,24750,8250,0,65526,33000,0.50361688490065,0.209840368708604,0.0979255053973486
ZMB,Sioma,2020,10155,23261,20309,5169,0,58894,25478,0.432607735932353,0.173458530014376,0.0773234775849643
ZMB,Sioma,2021,25817,23261,18092,2585,0,69755,20677,0.296423195469859,0.111160490287435,0.0452886690719104
ZMB,Solwezi,2018,136764,23638,5065,3377,0,168844,8442,0.0499988154746393,0.0233331753966186,0.0122223275133654
ZMB,Solwezi,2020,34996,113738,26247,0,0,174981,26247,0.149999142764072,0.0499997142546905,0.0166665714182302
ZMB,Solwezi,2021,34996,113738,26247,0,0,174981,26247,0.149999142764072,0.0499997142546905,0.0166665714182302
ZMB,Vubwi,2018,42930,13924,7240,2785,0,66879,10025,0.14989757621974,0.0638466484247671,0.0305360759314915
ZMB,Vubwi,2019,33030,19268,5651,2826,0,60775,8477,0.139481694775812,0.0619936925819279,0.0309977604095251
ZMB,Vubwi,2020,34804,20840,11909,2977,0,70530,14886,0.211059123777116,0.084422704286592,0.0375206767805662
ZMB,Vubwi,2021,29772,14886,11909,2977,0,59544,14886,0.25,0.0999988803797752,0.0444433248242196
ZMB,Zambezi,2018,71707,15588,8314,8314,0,103923,16628,0.160003079202871,0.0800015396014357,0.0444452997785754
ZMB,Zambezi,2019,40483,27670,23059,9223,0,100435,32282,0.321421815104296,0.137750784089212,0.066323714066035
ZMB,Zambezi,2020,36818,47338,26938,5388,0,116482,32326,0.277519273364125,0.107925115754652,0.0462541661181794
ZMB,Zambezi,2021,50999,45899,26938,5388,0,129224,32326,0.250154770011763,0.0972832703935286,0.0416933215020258
ZMB,Zimba,2018,78664,20233,6070,3035,0,108002,9105,0.0843039943704746,0.0374684419424332,0.0187342209712166
ZMB,Zimba,2019,47630,34732,24808,4962,0,112132,29770,0.265490671708344,0.103247363226673,0.0442494361803747
ZMB,Zimba,2021,73900,38440,15836,0,0,128176,15836,0.123548870303333,0.0411829567677776,0.0137276522559259
ZWE,Beitbridge,2019,38255,29754,25503,8501,0,102013,34004,0.333330065775931,0.138887527406638,0.0648141794564309
ZWE,Beitbridge,2020,26276,30655,35034,13138,0,105103,48172,0.458331351150776,0.194444180153437,0.0925927687865977
ZWE,Beitbridge,2021,21897,26276,26276,13138,0,87587,39414,0.449998287417082,0.199999238852037,0.0999996194260183
ZWE,Bikita,2019,101683,60320,25852,17234,0,205089,43086,0.210084402381405,0.0980387376537341,0.0513533149023107
ZWE,Bikita,2020,79905,53270,53270,26635,0,213080,79905,0.375,0.166666666666667,0.0833333333333333
ZWE,Bikita,2021,71026,44392,53270,8878,0,177566,62148,0.349999436829123,0.13333258243883,0.0555549298101363
ZWE,Bindura,2019,86399,39877,33231,13292,0,172799,46523,0.269231882128948,0.115384541191404,0.0555552340516374
ZWE,Bindura,2020,82170,34238,61628,6848,0,184884,68476,0.370372774280089,0.135804071742282,0.0534990107911507
ZWE,Bindura,2021,41085,47933,41085,6848,0,136951,47933,0.350001095282254,0.133334793709672,0.0555567725358381
ZWE,Binga,2019,66442,51677,36912,36912,0,191943,73824,0.384614182335381,0.19230709116769,0.106837272870939
ZWE,Binga,2020,45637,45637,45637,30425,0,167336,76062,0.454546541090979,0.212122117575816,0.111111775111154
ZWE,Binga,2021,45637,38031,53243,15212,0,152123,68455,0.449997699230228,0.183331909047284,0.0833324203294556
ZWE,Bubi,2019,32845,22992,9854,6569,0,72260,16423,0.227276501522281,0.106061444782729,0.0555555555555556
ZWE,Bubi,2020,30456,23688,16920,6768,0,77832,23688,0.304347826086957,0.130434782608696,0.0628019323671498
ZWE,Bubi,2021,23688,16920,20304,6768,0,67680,27072,0.4,0.166666666666667,0.0777777777777778
ZWE,Buhera,2019,78301,78301,91351,65251,0,313204,156602,0.5,0.236111288489291,0.12500017737818
ZWE,Buhera,2020,53783,94120,121011,40337,0,309251,161348,0.521738005697637,0.217390835707349,0.101449056663429
ZWE,Buhera,2021,53783,67228,107565,40337,0,268913,147902,0.549999442198778,0.233333209377506,0.111111111111111
ZWE,Bulilima,2019,38453,38453,19226,14420,0,110552,33646,0.304345466386859,0.144927274042984,0.0772949481792379
ZWE,Bulilima,2020,49523,34666,39618,9905,0,133712,49523,0.370370647361493,0.14814925611264,0.065844667810086
ZWE,Bulilima,2021,49523,29714,14857,4952,0,99046,19809,0.199997980736224,0.0833316506135196,0.0388876548943589
ZWE,Chegutu,2019,97865,73399,65243,8155,0,244662,73398,0.299997547637148,0.111109748687305,0.0444436269901606
ZWE,Chegutu,2020,92428,42013,50415,16805,0,201661,67220,0.333331680394325,0.138888200164302,0.0648144934100077
ZWE,Chegutu,2021,67220,42013,50415,8403,0,168051,58818,0.350000892586179,0.133334523448239,0.0555565473179769
ZWE,Chikomba,2019,81626,51016,16580,12754,0,161976,29334,0.181100903837606,0.0866136546978153,0.0463690094005696
ZWE,Chikomba,2020,59132,52562,39422,19711,0,170827,59133,0.346157223389745,0.153847654839887,0.0769238274199434
ZWE,Chikomba,2021,59132,45992,19711,6570,0,131405,26281,0.2,0.083332699161625,0.0388882547171806
ZWE,Chimanimani,2019,71621,50135,42973,21486,0,186215,64459,0.346153639610128,0.153845465367094,0.0769224343426207
ZWE,Chimanimani,2020,59033,44275,44275,14758,0,162341,59033,0.363635803647877,0.151514404863836,0.0707064484976411
ZWE,Chimanimani,2021,44275,44275,44275,14758,0,147583,59033,0.399998644830367,0.166665537358639,0.0777769496185574
ZWE,Chipinge,2019,142752,111029,126890,31723,0,412394,158613,0.384615198087266,0.153846402550312,0.0683763585309195
ZWE,Chipinge,2020,114393,130735,98051,32684,0,375863,130735,0.347826202632342,0.144927806142132,0.0676330944460556
ZWE,Chipinge,2021,81710,98051,114393,32684,0,326838,147077,0.449999694038025,0.183333435320658,0.0833335033122084
ZWE,Chiredzi,2019,152216,81963,73181,43909,0,351269,117090,0.333334282273699,0.15277844994387,0.0787041649941593
ZWE,Chiredzi,2020,105558,105558,120638,45239,0,376993,165877,0.440000212205532,0.186666595931489,0.0888887709969269
ZWE,Chiredzi,2021,75399,105558,90478,30159,0,301594,120637,0.399998010570502,0.166665561428057,0.0777771146346118
ZWE,Chirumhanzu,2019,55441,38382,17059,12794,0,123676,29853,0.24138070442123,0.114942807550913,0.0613026510128616
ZWE,Chirumhanzu,2020,30758,30758,26364,4394,0,92274,30758,0.333333333333333,0.126984126984127,0.0529100529100529
ZWE,Chirumhanzu,2021,21970,26364,30758,8788,0,87880,39546,0.45,0.183333333333333,0.0833333333333333
ZWE,Chivi,2019,65218,70506,40541,44066,0,220331,84607,0.383999527982898,0.194666206752568,0.109332978311924
ZWE,Chivi,2020,45401,72642,72642,18161,0,208846,90803,0.434784482345843,0.173914431367291,0.0772956575126595
ZWE,Chivi,2021,36321,72642,45401,27241,0,181605,72642,0.4,0.183333792204693,0.0944449033158044
ZWE,Gokwenorth,2019,63785,89298,127569,51028,0,331680,178597,0.53846177038109,0.230769617301817,0.111111446106019
ZWE,Gokwenorth,2020,105148,92004,118291,26287,0,341730,144578,0.423076697977936,0.166666666666667,0.0726496226715698
ZWE,Gokwenorth,2021,78861,78861,78861,26287,0,262870,105148,0.4,0.166666666666667,0.0777777777777778
ZWE,Gokwesouth,2019,194884,129922,113682,61713,0,500201,175395,0.350649039086287,0.158008480590803,0.0800864719049609
ZWE,Gokwesouth,2020,117127,133859,100394,33465,0,384845,133859,0.347825748028427,0.144927611549238,0.0676330008762547
ZWE,Gokwesouth,2021,100394,133859,83662,16732,0,334647,100394,0.299999701177659,0.116666218433155,0.049999618171453
ZWE,Goromonzi,2019,179121,107473,47766,35824,0,370184,83590,0.22580662589415,0.107526707439183,0.0573474572404834
ZWE,Goromonzi,2020,123033,86123,86123,36910,0,332189,123033,0.37037048186424,0.160493975818987,0.0781894242935999
ZWE,Goromonzi,2021,73820,110729,49213,12303,0,246065,61516,0.249998984008291,0.0999993226721937,0.0444439928925735
ZWE,Guruve,2019,85587,32918,19751,13167,0,151423,32918,0.217391017216671,0.101448701100009,0.053139586162971
ZWE,Guruve,2020,101747,47482,33916,13566,0,196711,47482,0.241379485641372,0.103447866836798,0.0498079811387151
ZWE,Guruve,2021,67831,40699,27132,0,0,135662,27132,0.199997051495629,0.0666656838318763,0.0222218946106254
ZWE,Gutu,2019,142281,75452,43115,17246,0,278094,60361,0.217052507425547,0.0930225031823772,0.0447886126433668
ZWE,Gutu,2020,66633,77738,77738,22211,0,244320,99949,0.409090537000655,0.166666666666667,0.0757576584442989
ZWE,Gutu,2021,44422,88844,77738,11105,0,222109,88843,0.399997298623649,0.149998424197128,0.0611101356140954
ZWE,Gwanda,2019,61451,43015,30725,12290,0,147481,43015,0.291664689010788,0.124999152433195,0.0601847770974642
ZWE,Gwanda,2020,50650,44319,50650,18994,0,164613,69644,0.423077156725168,0.179487646783668,0.0854705008447422
ZWE,Gwanda,2021,37988,31656,44319,12663,0,126626,56982,0.450002369181685,0.183335176030199,0.0833346495453804
ZWE,Gweru,2019,53600,41905,29236,17542,0,142283,46778,0.328767315842371,0.150685605448297,0.0776262019277699
ZWE,Gweru,2020,35142,45183,30122,5020,0,115467,35142,0.304346696458728,0.115940773843032,0.0483081746299809
ZWE,Gweru,2021,25102,30122,35142,10041,0,100407,45183,0.449998506080253,0.183333831306582,0.0833341632887481
ZWE,Hurungwe,2019,234131,104835,87362,52417,0,478745,139779,0.291969628925628,0.133819326224469,0.0689371864632181
ZWE,Hurungwe,2020,198021,90010,108011,54006,0,450048,162017,0.359999377844141,0.159999970373531,0.0800001086303881
ZWE,Hurungwe,2021,162017,108011,72008,18002,0,360038,90010,0.250001388742299,0.10000055549692,0.0444446913319643
ZWE,Hwange,2019,33263,19958,19958,11975,0,85154,31933,0.375002935857388,0.171876834910867,0.0885428491647812
ZWE,Hwange,2020,27416,17135,17135,13708,0,75394,30843,0.409090909090909,0.196969696969697,0.106060606060606
ZWE,Hwange,2021,17135,17135,23989,10281,0,68540,34270,0.5,0.216666666666667,0.105555555555556
ZWE,Hwedza,2019,45200,30134,15067,7533,0,97934,22600,0.230767659852554,0.102562269827979,0.051280567638523
ZWE,Hwedza,2020,38809,27166,11643,0,0,77618,11643,0.150003865082842,0.0500012883609472,0.0166670961203157
ZWE,Hwedza,2021,27166,34928,15523,0,0,77617,15523,0.199994846489815,0.0666649488299385,0.0222216496099795
ZWE,Insiza,2019,47928,37277,26627,10651,0,122483,37278,0.304352440746879,0.130437149100964,0.062803273379435
ZWE,Insiza,2020,60353,38407,43893,10973,0,153626,54866,0.357140067436502,0.142855593020279,0.063491133589945
ZWE,Insiza,2021,43893,32920,21947,10973,0,109733,32920,0.30000091130289,0.133332725798074,0.0666658566196536
ZWE,Kariba,2019,10979,17566,17566,8783,0,54894,26349,0.47999781396874,0.213332361763884,0.106666180881942
ZWE,Kariba,2020,18098,13574,13574,9049,0,54295,22623,0.41666820149185,0.19444393283605,0.101850999171194
ZWE,Kariba,2021,9049,15836,11311,9049,0,45245,20360,0.449994474527572,0.216664824842524,0.116666052725286
ZWE,Kwekwe,2019,83464,83464,55643,18548,0,241119,74191,0.307694540869861,0.128206404306587,0.0598298396688403
ZWE,Kwekwe,2020,85993,76438,66884,9555,0,238870,76439,0.320002511826517,0.120001116367341,0.0488894470725592
ZWE,Kwekwe,2021,76438,66884,38219,9555,0,191096,47774,0.25,0.100000348864794,0.0444447933092384
ZWE,Lupane,2019,63794,21265,26581,15948,0,127588,42529,0.333330720757438,0.152775600631198,0.0787021071295455
ZWE,Lupane,2020,38341,38341,32864,16432,0,125978,49296,0.391306418581022,0.173913963813788,0.0869569819068938
ZWE,Lupane,2021,32864,27386,32864,16432,0,109546,49296,0.450002738575576,0.2000012171447,0.10000060857235
ZWE,Makonde,2019,97792,57045,24448,16299,0,195584,40747,0.20833503763089,0.0972233584205934,0.0509266833915067
ZWE,Makonde,2020,100754,41981,33585,16792,0,193112,50377,0.260869340072083,0.115941353549581,0.0579703890891181
ZWE,Makonde,2021,83962,50377,25189,8396,0,167924,33585,0.200001191014983,0.0833333333333333,0.0388886242188927
ZWE,Makoni,2019,159002,101183,57819,43364,0,361368,101183,0.279999889309513,0.133333148849188,0.0711109512248517
ZWE,Makoni,2020,163820,59571,134034,14893,0,372318,148927,0.39999946282479,0.146666738290028,0.0577779687734082
ZWE,Makoni,2021,119142,89356,74464,14893,0,297855,89357,0.300001678669151,0.116667506001242,0.0500004662969864
ZWE,Mangwe,2019,38661,21088,24602,7029,0,91380,31631,0.34614795360035,0.141022835047786,0.0641010675810413
ZWE,Mangwe,2020,25348,32590,14484,7242,0,79664,21726,0.272720425788311,0.121209078128138,0.0606045390640691
ZWE,Mangwe,2021,25348,32590,10863,3621,0,72422,14484,0.199994476816437,0.0833310320068487,0.0388878149365294
ZWE,Marondera,2019,72026,37255,31046,6209,0,146536,37255,0.254237866462849,0.0988699022765737,0.0423725986181629
ZWE,Marondera,2020,63973,44781,44781,0,0,153535,44781,0.291666395284463,0.0972221317614876,0.0324073772538292
ZWE,Marondera,2021,44781,57575,25589,0,0,127945,25589,0.2,0.0666666666666667,0.0222222222222222
ZWE,Masvingo,2019,123315,67263,56052,33631,0,280261,89683,0.319998144586653,0.146665667597941,0.0755549688009074
ZWE,Masvingo,2020,57751,103951,92401,23100,0,277203,115501,0.416665764800525,0.166666065422572,0.0740736732446779
ZWE,Masvingo,2021,69301,80851,69301,11550,0,231003,80851,0.349999783552595,0.133333044736793,0.0555553150584384
ZWE,Matobo,2019,64817,34902,19944,14958,0,134621,34902,0.25926118510485,0.123457707192786,0.065844110502819
ZWE,Matobo,2020,51371,30822,35959,15411,0,133563,51370,0.384612504960206,0.166665418816089,0.0811959732693768
ZWE,Matobo,2021,41096,30822,20548,10274,0,102740,30822,0.3,0.133333333333333,0.0666666666666667
ZWE,Mazowe,2019,136297,49562,74344,37172,0,297375,111516,0.375001261034048,0.166667227126244,0.0833336135631218
ZWE,Mazowe,2020,153193,76596,102128,12766,0,344683,114894,0.333332366261173,0.123456431948583,0.0493825727794331
ZWE,Mazowe,2021,76596,89362,76596,12766,0,255320,89362,0.35,0.133333333333333,0.0555555555555556
ZWE,Mberengwa,2019,88733,88733,59156,29578,0,266200,88734,0.333335837716003,0.148149261207112,0.0740746306035562
ZWE,Mberengwa,2020,81264,60948,81264,20316,0,243792,101580,0.416666666666667,0.166666666666667,0.0740740740740741
ZWE,Mberengwa,2021,40632,60948,81264,20316,0,203160,101580,0.5,0.2,0.0888888888888889
ZWE,Mbire,2019,48096,26234,30607,17490,0,122427,48097,0.392862685518717,0.178574443001408,0.0912716239972483
ZWE,Mbire,2020,45049,22525,40544,9010,0,117128,49554,0.423075609589509,0.166666666666667,0.0726498645356647
ZWE,Mbire,2021,18020,27029,31534,13515,0,90098,45049,0.5,0.216667776569217,0.105556665458106
ZWE,Mhondoro-ngezi,2019,60919,33228,33228,16614,0,143989,49842,0.346151442124051,0.153845085388467,0.0769225426942336
ZWE,Mhondoro-ngezi,2020,57059,34235,28529,17118,0,136941,45647,0.333333333333333,0.152778690579641,0.0787046165055673
ZWE,Mhondoro-ngezi,2021,45647,39941,22823,5706,0,114117,28529,0.249997809265929,0.0999997079021238,0.0444446391763619
ZWE,Mount Darwin,2019,101615,56453,79034,33872,0,270974,112906,0.416667281731827,0.180556068109856,0.0879633388361163
ZWE,Mount Darwin,2020,104694,93062,69796,23265,0,290817,93061,0.319998487021048,0.133332416376392,0.0622216414828264
ZWE,Mount Darwin,2021,93062,58164,58164,23265,0,232655,81429,0.349998925447551,0.149998925447551,0.0722213864592064
ZWE,Mudzi,2019,42435,70725,42435,28290,0,183885,70725,0.384615384615385,0.17948717948718,0.094017094017094
ZWE,Mudzi,2020,36434,51008,51008,21860,0,160310,72868,0.454544320379265,0.196968373775809,0.0959585248026393
ZWE,Mudzi,2021,29147,51008,51008,14574,0,145737,65582,0.450002401586419,0.183334820029688,0.0833342863438172
ZWE,Murehwa,2019,148321,80517,31783,16951,0,277572,48734,0.175572464081392,0.0788804346259709,0.0398643314967728
ZWE,Murehwa,2020,87323,98238,76407,10915,0,272883,87322,0.319997947838451,0.119998925058236,0.0488882699830249
ZWE,Murehwa,2021,76407,87323,43661,10915,0,218306,54576,0.249997709636932,0.0999987784730302,0.0444437318870454
ZWE,Mutare,2019,125213,111300,111300,27825,0,375638,139125,0.370369877381948,0.148147950952779,0.0658435337567907
ZWE,Mutare,2020,157675,86004,114672,43002,0,401353,157674,0.392856164025185,0.166666251404624,0.0793648816212495
ZWE,Mutare,2021,114672,71670,71670,28668,0,286680,100338,0.35,0.15,0.0722222222222222
ZWE,Mutasa,2019,89564,98520,44782,8956,0,241822,53738,0.222221303272655,0.0864189362423601,0.0370364244039923
ZWE,Mutasa,2020,92278,64595,73822,18456,0,249151,92278,0.370369775758476,0.148148445454095,0.0658440508411008
ZWE,Mutasa,2021,73822,64595,36911,9228,0,184556,46139,0.25,0.100000361227306,0.0444448056717503
ZWE,Mutoko,2019,85314,38779,46535,15512,0,186140,62047,0.33333512410014,0.138890082733426,0.0648156107111732
ZWE,Mutoko,2020,63927,63927,55936,23973,0,207763,79909,0.384616125104085,0.166667468862759,0.0811972188396287
ZWE,Mutoko,2021,55936,55936,39954,7991,0,159817,47945,0.299999374284338,0.11666677095261,0.0500002433338687
ZWE,Muzarabani,2019,65173,26069,39104,19552,0,149898,58656,0.391306088139935,0.173913816951082,0.0869569084755412
ZWE,Muzarabani,2020,94007,33574,67148,6715,0,201444,73863,0.366667659498421,0.13333399522117,0.0518522931104095
ZWE,Muzarabani,2021,60433,33574,26859,13430,0,134296,40289,0.300001489247632,0.133334822580965,0.0666678249703805
ZWE,Mwenezi,2019,70906,70906,44317,44317,0,230446,88634,0.38461939022591,0.192309695112955,0.106838719507197
ZWE,Mwenezi,2020,63923,45660,73055,36528,0,219166,109583,0.5,0.222222729194614,0.111111618083502
ZWE,Mwenezi,2021,54791,45660,45660,36528,0,182639,82188,0.450002463876828,0.216667852977732,0.116667305449548
ZWE,Nkayi,2019,57925,40547,34755,17377,0,150604,52132,0.346152824626172,0.153844962063867,0.0769221121469402
ZWE,Nkayi,2020,35808,47744,35808,17904,0,137264,53712,0.391304347826087,0.173913043478261,0.0869565217391304
ZWE,Nkayi,2021,35808,35808,35808,11936,0,119360,47744,0.4,0.166666666666667,0.0777777777777778
ZWE,Nyanga,2019,53755,67194,33597,25534,0,180080,59131,0.328359617947579,0.156717384865986,0.0837485808776346
ZWE,Nyanga,2020,48461,48461,41538,20769,0,159229,62307,0.391304347826087,0.173913043478261,0.0869565217391304
ZWE,Nyanga,2021,34615,55384,34615,13846,0,138460,48461,0.35,0.15,0.0722222222222222
ZWE,Rushinga,2019,43227,23579,27508,11789,0,106103,39297,0.370366530635326,0.160491849115168,0.0781881756406511
ZWE,Rushinga,2020,48586,24293,40488,8098,0,121465,48586,0.4,0.155556470313808,0.0666675814249189
ZWE,Rushinga,2021,28342,20244,24293,8098,0,80977,32391,0.400002469837114,0.166668724864262,0.0777792871226809
ZWE,Sanyati,2019,55127,40746,47937,17976,0,161786,65913,0.407408552037877,0.172839429864142,0.0823041960779466
ZWE,Sanyati,2020,49390,43216,24695,12347,0,129648,37042,0.285712081944959,0.126982290509688,0.0634907167441414
ZWE,Sanyati,2021,30869,37042,37042,18521,0,123474,55563,0.449997570338695,0.199998920150531,0.0999994600752655
ZWE,Seke,2019,79147,38504,21391,5348,0,144390,26739,0.185185954706005,0.0740748435948935,0.0329224092157813
ZWE,Seke,2020,55098,38568,33059,11020,0,137745,44079,0.320004355874986,0.133335753263881,0.062223674180551
ZWE,Seke,2021,55098,33059,22039,0,0,110196,22039,0.199998185052089,0.0666660616840297,0.0222220205613432
ZWE,Shamva,2019,72191,32814,32814,22314,0,160133,55128,0.344263830690738,0.161203499590965,0.0847004261041343
ZWE,Shamva,2020,87902,40570,47332,6762,0,182566,54094,0.296298324989319,0.111112328326925,0.045268256107076
ZWE,Shamva,2021,60855,33809,33809,6762,0,135235,40571,0.300003697267719,0.116668515300526,0.0500010270188109
ZWE,Shurugwi,2019,41171,45288,16468,4117,0,107044,20585,0.192304099248907,0.0769216396995628,0.0341873954220279
ZWE,Shurugwi,2020,46660,29693,16967,4242,0,97562,21209,0.217389967405342,0.0869566702882953,0.0386477886426637
ZWE,Shurugwi,2021,29693,29693,16967,8484,0,84837,25451,0.299998821269022,0.133334119153986,0.0666677144275362
ZWE,Tsholotsho,2019,54990,36660,28106,15886,0,135642,43992,0.324324324324324,0.147147147147147,0.0750750750750751
ZWE,Tsholotsho,2020,31476,50362,37771,18886,0,138495,56657,0.409090580887397,0.181818838225207,0.0909098202502296
ZWE,Tsholotsho,2021,31476,44066,37771,12590,0,125903,50361,0.399998411475501,0.166665342896251,0.0777768070128062
ZWE,Umguza,2019,47603,23801,28562,14281,0,114247,42843,0.3750032823619,0.166668125494178,0.0833340627470889
ZWE,Umguza,2020,39236,34331,29427,9809,0,112803,39236,0.347827628697818,0.144928178624091,0.0676331500245758
ZWE,Umguza,2021,29427,24522,34331,9809,0,98089,44140,0.449999490258847,0.183333503247051,0.083333616522863
ZWE,Umzingwane,2019,30089,20060,16716,6687,0,73552,23403,0.31818305416576,0.136366108331521,0.0656587629613516
ZWE,Umzingwane,2020,34446,27556,20667,6889,0,89558,27556,0.3076888720159,0.128203696673292,0.0598283917808695
ZWE,Umzingwane,2021,20667,20667,17223,10334,0,68891,27557,0.400008709410518,0.183337929966662,0.0944471056532139
ZWE,Uzumbamarambapfungwe,2019,60965,35862,35862,29885,0,162574,65747,0.404412759727878,0.196078913807456,0.106209411645705
ZWE,Uzumbamarambapfungwe,2020,55422,36948,30790,18474,0,141634,49264,0.347826086956522,0.159420289855072,0.0821256038647343
ZWE,Uzumbamarambapfungwe,2021,43106,36948,36948,6158,0,123160,43106,0.35,0.133333333333333,0.0555555555555556
ZWE,Zaka,2019,86605,76982,48114,19246,0,230947,67360,0.291668651248988,0.125001262916023,0.0601860070829142
ZWE,Zaka,2020,79314,59486,89229,19829,0,247858,109058,0.440001936592727,0.173334463012424,0.0755562548807068
ZWE,Zaka,2021,59486,69400,59486,9914,0,198286,69400,0.34999949567796,0.133332660903947,0.0555549951977335
ZWE,Zvimba,2019,153561,83760,78176,27920,0,343417,106096,0.30894218981588,0.130080922027739,0.0614271020686545
ZWE,Zvimba,2020,158214,71915,71915,28766,0,330810,100681,0.304346906079018,0.130434388319579,0.0628017425242419
ZWE,Zvimba,2021,129447,86298,57532,14383,0,287660,71915,0.25,0.1,0.0444444444444444
ZWE,Zvishavane,2019,42336,26941,30790,3849,0,103916,34639,0.333336541052389,0.123458690994008,0.0493839040934772
ZWE,Zvishavane,2020,31722,27757,27757,3965,0,91201,31722,0.347825133496343,0.130433511328458,0.0531390372181592
ZWE,Zvishavane,2021,19827,27757,27757,3965,0,79306,31722,0.399994956245429,0.149997057809834,0.0611092897552938
